COD_DEPT;COD_SP;COD_COM;COD_LV;NUMERO_BV;INSCRITS;POP_HOM;POP_FEM
022;001;007;019;02;448;223;225
022;001;007;019;03;448;221;227
022;001;007;019;04;446;221;225
022;001;008;001;01;325;176;149
022;001;008;001;02;320;174;146
022;001;008;002;01;448;243;205
022;001;008;002;02;448;261;187
022;001;008;002;03;448;261;187
022;001;008;002;04;448;254;194
022;001;008;002;05;448;243;205
022;001;008;002;06;448;242;206
022;001;008;002;07;448;248;200
022;001;008;002;08;448;238;210
022;001;008;002;09;448;236;212
022;001;008;002;10;448;263;185
022;001;008;002;11;448;252;196
022;001;008;002;12;448;222;226
022;001;008;002;13;446;245;201
022;001;008;002;14;440;252;188
022;001;008;002;15;440;216;224
022;001;008;002;16;440;288;152
022;001;008;003;01;364;202;162
022;001;008;003;02;360;180;180
022;001;008;004;01;368;203;165
022;001;008;004;02;368;210;158
022;001;008;004;03;364;200;164
022;001;008;004;04;360;210;150
022;001;008;004;05;360;218;142
022;001;008;005;01;413;213;200
022;001;008;005;02;408;219;189
022;001;008;005;03;408;214;194
022;001;008;005;04;408;211;197
022;001;008;005;05;408;230;178
022;001;008;006;01;367;201;166
022;001;008;006;02;360;204;156
022;001;008;006;03;360;177;183
022;001;008;006;04;360;189;171
022;001;008;006;05;360;188;172
022;001;008;007;01;392;161;231
022;001;008;007;02;392;205;187
022;001;008;007;03;392;194;198
022;001;008;007;04;384;183;201
022;001;008;007;05;384;193;191
022;001;008;007;06;384;196;188
022;001;008;007;07;384;179;205
022;001;008;008;01;441;224;217
022;001;008;008;02;440;255;185
022;001;008;008;03;440;235;205
022;001;008;008;04;440;229;211
022;001;008;008;05;440;251;189
022;001;008;008;06;440;254;186
022;001;008;008;07;440;268;172
022;001;008;009;01;416;197;219
022;001;008;009;02;416;223;193
022;001;008;009;03;416;245;171
022;001;008;009;04;410;223;187
022;001;008;009;05;408;203;205
022;001;008;009;06;408;212;196
022;001;008;009;07;408;208;200
022;001;008;009;08;408;223;185
022;001;008;009;09;408;216;192
022;001;008;010;01;432;230;202
022;001;008;010;02;432;232;200
022;001;008;010;03;432;211;221
022;001;008;010;04;432;243;189
022;001;008;010;05;430;219;211
022;001;008;010;06;424;221;203
022;001;008;010;07;424;216;208
022;001;008;010;08;424;243;181
022;001;008;010;09;424;237;187
022;001;008;011;01;439;213;226
022;001;008;011;02;432;235;197
022;001;008;011;03;432;232;200
022;001;008;011;04;432;200;232
022;001;008;011;05;432;225;207
022;001;008;011;06;432;214;218
022;001;008;011;07;432;207;225
022;001;008;011;08;432;202;230
022;001;008;011;09;432;220;212
022;001;008;011;10;432;223;209
022;001;008;011;11;432;215;217
022;001;008;012;01;424;211;213
022;001;008;012;02;424;193;231
022;001;008;012;03;424;247;177
022;001;008;012;04;424;234;190
022;001;008;012;05;419;206;213
022;001;008;012;06;416;202;214
022;001;008;012;07;416;202;214
022;001;008;012;08;416;207;209
022;001;008;012;09;416;211;205
022;001;008;013;01;408;193;215
022;001;008;013;02;408;227;181
022;001;008;013;03;406;203;203
022;001;008;013;04;400;204;196
022;001;008;013;05;400;225;175
022;001;008;013;06;400;200;200
022;001;008;013;07;400;219;181
022;001;008;013;08;400;192;208
022;001;008;014;01;448;213;235
022;001;008;014;02;448;222;226
022;001;008;014;03;448;202;246
022;001;008;014;04;448;208;240
022;001;008;014;05;448;225;223
022;001;008;014;06;448;232;216
022;001;008;014;07;441;222;219
022;001;008;014;08;440;215;225
022;001;008;015;01;424;201;223
022;001;008;015;02;422;197;225
022;001;008;015;03;416;204;212
022;001;008;015;04;416;200;216
022;001;008;015;05;416;210;206
022;001;008;015;06;416;203;213
022;001;008;015;07;416;213;203
022;001;008;016;01;432;212;220
022;001;008;016;02;432;204;228
022;001;008;016;03;432;221;211
022;001;008;016;04;431;209;222
022;001;008;016;05;424;220;204
022;001;008;016;06;424;205;219
022;001;008;016;07;424;217;207
022;001;008;016;08;424;220;204
022;001;008;017;01;432;206;226
022;001;008;017;02;432;199;233
022;001;008;017;03;432;220;212
022;001;008;017;04;432;228;204
022;001;008;017;05;432;198;234
022;001;008;017;06;431;209;222
022;001;008;017;07;424;239;185
022;001;008;017;08;424;206;218
022;001;008;018;01;393;207;186
022;001;008;018;02;392;202;190
022;001;008;018;03;392;204;188
022;001;008;018;04;392;206;186
022;001;008;018;05;392;206;186
022;001;008;018;06;392;201;191
022;001;008;019;01;400;206;194
022;001;008;019;02;395;239;156
022;001;008;019;03;392;196;196
022;001;008;019;04;392;197;195
022;001;008;019;05;392;195;197
022;001;008;019;06;392;202;190
022;001;008;020;01;416;210;206
022;001;008;020;02;416;228;188
022;001;008;020;03;416;187;229
022;001;008;020;04;416;214;202
022;001;008;020;05;416;185;231
022;001;008;020;06;416;201;215
022;001;008;020;07;416;204;212
022;001;008;020;08;408;205;203
022;001;008;021;01;450;264;186
022;001;008;021;02;450;268;182
022;001;008;021;03;450;284;166
022;001;008;021;04;448;271;177
022;001;008;021;05;448;276;172
022;001;008;021;06;448;280;168
022;001;008;021;07;448;273;175
022;001;008;022;01;376;220;156
022;001;008;022;02;376;201;175
022;001;008;022;03;371;214;157
022;001;008;022;04;368;217;151
022;001;008;022;05;368;207;161
022;001;008;023;01;448;206;242
022;001;008;023;02;440;184;256
022;001;008;023;03;440;216;224
022;001;008;023;04;440;218;222
022;001;008;024;01;408;219;189
022;001;008;024;02;406;228;178
022;001;008;024;03;400;201;199
022;001;008;024;04;400;222;178
022;001;008;024;05;400;205;195
022;001;008;024;06;400;208;192
022;001;008;025;01;388;192;196
022;001;008;025;02;384;176;208
022;001;008;025;03;384;178;206
022;001;008;025;04;384;199;185
022;001;008;025;05;384;212;172
022;001;008;026;01;440;218;222
022;001;008;026;02;440;216;224
022;001;008;026;03;438;231;207
022;001;008;026;04;432;202;230
022;001;008;027;01;448;220;228
022;001;008;027;02;448;228;220
022;001;008;027;03;448;216;232
022;001;008;027;04;443;226;217
022;001;008;027;05;440;234;206
022;001;008;027;06;440;215;225
022;001;008;028;01;432;194;238
022;001;008;028;02;432;216;216
022;001;008;028;03;432;240;192
022;001;008;028;04;432;224;208
022;001;008;028;05;432;231;201
022;001;008;028;06;432;231;201
022;001;008;028;07;432;201;231
022;001;008;028;08;432;213;219
022;001;008;028;09;431;196;235
022;001;008;028;10;424;209;215
022;001;008;028;11;424;213;211
022;001;008;028;12;424;234;190
022;001;008;028;13;424;209;215
022;001;008;028;14;424;205;219
022;001;008;029;01;424;219;205
022;001;008;029;02;424;226;198
022;001;008;029;03;424;218;206
022;001;008;029;04;418;214;204
022;001;008;029;05;416;195;221
022;001;008;029;06;416;208;208
022;001;008;030;01;416;195;221
022;001;008;030;02;416;217;199
022;001;008;030;03;416;226;190
022;001;008;030;04;416;199;217
022;001;008;030;05;416;232;184
022;001;008;030;06;416;225;191
022;001;008;030;07;414;190;224
022;001;008;030;08;408;221;187
022;001;008;030;09;408;200;208
022;001;008;031;01;447;218;229
022;001;008;031;02;440;216;224
022;001;008;031;03;440;213;227
022;001;008;031;04;440;219;221
022;001;008;031;05;440;214;226
022;001;008;031;06;440;234;206
022;001;008;031;07;440;184;256
022;001;008;031;08;440;240;200
022;001;008;031;09;440;209;231
022;001;008;031;10;440;235;205
022;001;008;031;11;440;226;214
022;001;008;031;12;440;227;213
022;001;008;032;01;424;224;200
022;001;008;032;02;424;236;188
022;001;008;032;03;424;239;185
022;001;008;032;04;418;237;181
022;001;008;032;05;416;245;171
022;001;008;032;06;416;244;172
022;001;008;032;07;416;235;181
022;001;008;033;01;328;193;135
022;001;008;033;02;328;194;134
022;001;008;033;03;328;191;137
022;001;008;034;01;345;178;167
022;001;008;034;02;344;192;152
022;001;008;035;01;276;147;129
022;001;008;036;01;392;225;167
022;001;008;036;02;389;211;178
022;001;008;036;03;384;219;165
022;001;008;036;04;384;234;150
022;001;008;037;01;328;167;161
022;001;008;037;02;323;179;144
022;001;008;038;01;150;87;63
022;001;008;039;01;394;217;177
022;001;008;039;02;392;206;186
022;001;008;039;03;392;182;210
022;001;008;040;01;342;194;148
022;001;008;041;01;432;240;192
022;001;008;041;02;429;248;181
022;001;008;042;01;440;226;214
022;001;008;042;02;440;233;207
022;001;008;042;03;438;230;208
022;001;008;042;04;432;237;195
022;001;008;042;05;432;244;188
022;001;008;042;06;432;241;191
022;001;008;043;01;440;208;232
022;001;008;043;02;440;242;198
022;001;008;043;03;437;236;201
022;001;008;043;04;432;235;197
022;001;008;043;05;432;219;213
022;001;008;043;06;432;218;214
022;001;008;043;07;432;210;222
022;001;008;043;08;432;214;218
022;001;008;043;09;432;224;208
022;001;008;043;10;432;242;190
022;001;008;043;11;432;221;211
022;001;008;044;01;432;226;206
022;001;008;044;02;432;215;217
022;001;008;044;03;432;233;199
022;001;008;044;04;432;183;249
022;001;008;044;05;430;228;202
022;001;008;044;06;424;241;183
022;001;008;044;07;424;218;206
022;001;008;044;08;424;229;195
022;001;008;045;01;432;220;212
022;001;008;045;02;432;215;217
022;001;008;045;03;432;219;213
022;001;008;045;04;432;218;214
022;001;008;045;05;432;227;205
022;001;008;045;06;432;210;222
022;001;008;045;07;432;210;222
022;001;008;045;08;432;188;244
022;001;008;045;09;432;232;200
022;001;008;045;10;431;222;209
022;001;008;045;11;424;227;197
022;001;008;045;12;424;215;209
022;001;008;045;13;424;203;221
022;001;008;045;14;424;259;165
022;001;008;046;01;424;201;223
022;001;008;046;02;424;221;203
022;001;008;046;03;424;216;208
022;001;008;046;04;418;200;218
022;001;008;046;05;416;192;224
022;001;008;046;06;416;203;213
022;001;008;046;07;416;214;202
022;001;008;047;01;426;219;207
022;001;008;047;02;424;236;188
022;001;008;047;03;424;224;200
022;001;008;047;04;424;227;197
022;001;008;047;05;424;195;229
022;001;008;047;06;424;219;205
022;001;008;047;07;424;233;191
022;001;008;047;08;424;215;209
022;001;008;048;01;376;178;198
022;001;008;048;02;369;203;166
022;001;008;048;03;368;178;190
022;001;008;048;04;368;180;188
022;001;008;048;05;368;191;177
022;001;008;049;01;448;226;222
022;001;008;049;02;445;231;214
022;001;008;049;03;440;248;192
022;001;008;049;04;440;233;207
022;001;008;049;05;440;212;228
022;001;008;049;06;440;226;214
022;001;008;049;07;440;238;202
022;001;008;050;01;416;209;207
022;001;008;050;02;416;228;188
022;001;008;050;03;416;214;202
022;001;008;050;04;416;231;185
022;001;008;050;05;416;184;232
022;001;008;050;06;416;206;210
022;001;008;050;07;416;218;198
022;001;008;050;08;416;217;199
022;001;008;050;09;416;233;183
022;001;008;050;10;410;216;194
022;001;008;051;01;448;212;236
022;001;008;051;02;448;223;225
022;001;008;051;03;448;252;196
022;001;008;051;04;448;238;210
022;001;008;051;05;448;223;225
022;001;008;051;06;448;175;273
022;001;008;051;07;443;240;203
022;001;008;051;08;440;209;231
022;001;008;051;09;440;241;199
022;001;008;051;10;440;223;217
022;001;008;052;01;312;177;135
022;001;008;052;02;309;171;138
022;001;008;052;03;304;160;144
022;001;008;053;01;408;212;196
022;001;008;053;02;408;240;168
022;001;008;053;03;408;246;162
022;001;008;053;04;408;219;189
022;001;008;053;05;408;236;172
022;001;008;053;06;404;222;182
022;001;008;053;07;400;234;166
022;001;008;054;01;94;61;33
022;001;008;055;01;190;94;96
022;001;008;056;01;403;218;185
022;001;008;056;02;400;216;184
022;001;008;057;01;309;173;136
022;001;008;057;02;304;177;127
022;001;009;001;01;448;222;226
022;001;009;001;02;448;223;225
022;001;009;001;03;448;234;214
022;001;009;001;04;448;229;219
022;001;009;001;05;448;240;208
022;001;009;001;06;448;220;228
022;001;009;001;07;448;222;226
022;001;009;001;08;448;213;235
022;001;009;001;09;446;259;187
022;001;009;001;10;440;270;170
022;001;009;001;11;440;244;196
022;001;009;002;01;448;230;218
022;001;009;002;02;448;228;220
022;001;009;002;03;440;233;207
022;001;009;002;04;440;206;234
022;001;009;002;05;440;230;210
022;001;009;002;06;440;199;241
022;001;009;002;07;440;217;223
022;001;009;002;08;440;216;224
022;001;009;002;09;440;253;187
022;001;009;002;10;440;233;207
022;001;009;003;01;412;223;189
022;001;009;003;02;408;225;183
022;001;009;003;03;408;237;171
022;001;009;003;04;408;223;185
022;001;009;003;05;408;217;191
022;001;009;003;06;408;197;211
022;001;009;003;07;408;206;202
022;001;009;003;08;408;219;189
022;001;009;003;09;408;209;199
022;001;009;004;01;448;232;216
022;001;009;004;02;448;253;195
022;001;009;004;03;440;244;196
022;001;009;004;04;440;263;177
022;001;009;004;05;440;253;187
022;001;009;004;06;440;234;206
022;001;009;005;01;424;213;211
022;001;009;005;02;424;223;201
022;001;009;005;03;424;219;205
022;001;009;005;04;424;211;213
022;001;009;005;05;424;215;209
022;001;009;005;06;424;218;206
022;001;009;005;07;424;242;182
022;001;009;005;08;424;218;206
022;001;009;005;09;424;206;218
022;001;009;005;10;419;225;194
022;001;009;005;11;416;239;177
022;001;009;005;12;416;214;202
022;001;009;005;13;416;222;194
022;001;009;006;01;400;204;196
022;001;009;006;02;400;197;203
022;001;009;006;03;400;228;172
022;001;009;006;04;400;202;198
022;001;009;006;05;400;209;191
022;001;009;006;06;398;205;193
022;001;009;006;07;392;226;166
022;001;009;006;08;392;208;184
022;001;009;007;01;400;209;191
022;001;009;007;02;400;203;197
022;001;009;007;03;400;215;185
022;001;009;007;04;400;234;166
022;001;009;007;05;396;231;165
022;001;009;008;01;424;217;207
022;001;009;008;02;424;229;195
022;001;009;008;03;418;203;215
022;001;009;008;04;416;206;210
022;001;009;008;05;416;205;211
022;001;009;008;06;416;186;230
022;001;009;008;07;416;194;222
022;001;009;008;08;416;216;200
022;001;009;008;09;416;214;202
022;001;009;008;10;416;207;209
022;001;009;008;11;416;197;219
022;001;009;009;01;400;191;209
022;001;009;009;02;400;193;207
022;001;009;009;03;400;221;179
022;001;009;009;04;398;195;203
022;001;009;009;05;392;193;199
022;001;009;009;06;392;203;189
022;001;009;009;07;392;199;193
022;001;009;010;01;437;204;233
022;001;009;010;02;432;226;206
022;001;009;010;03;432;218;214
022;001;009;010;04;432;209;223
022;001;009;010;05;432;197;235
022;001;009;010;06;432;215;217
022;001;009;010;07;432;240;192
022;001;009;011;01;416;182;234
022;001;009;011;02;416;189;227
022;001;009;011;03;416;206;210
022;001;009;011;04;416;192;224
022;001;009;011;05;416;185;231
022;001;009;011;06;416;194;222
022;001;009;011;07;415;172;243
022;001;009;012;01;448;218;230
022;001;009;012;02;448;230;218
022;001;009;012;03;448;230;218
022;001;009;012;04;448;227;221
022;001;009;012;05;448;201;247
022;001;009;012;06;448;223;225
022;001;009;012;07;448;233;215
022;001;009;012;08;447;227;220
022;001;009;013;01;440;204;236
022;001;009;013;02;439;226;213
022;001;009;013;03;432;227;205
022;001;009;013;04;432;228;204
022;001;009;013;05;432;187;245
022;001;009;013;06;432;217;215
022;001;009;013;07;432;210;222
022;001;009;013;08;432;238;194
022;001;009;013;09;432;205;227
022;001;009;014;01;424;198;226
022;001;009;014;02;424;230;194
022;001;009;014;03;424;214;210
022;001;009;014;04;424;198;226
022;001;009;014;05;424;218;206
022;001;009;014;06;424;198;226
022;001;009;014;07;424;197;227
022;001;009;014;08;424;217;207
022;001;009;014;09;424;209;215
022;001;009;014;10;424;201;223
022;001;009;014;11;424;210;214
022;001;009;014;12;423;194;229
022;001;009;015;01;408;218;190
022;001;009;015;02;405;226;179
022;001;009;015;03;400;215;185
022;001;009;015;04;400;208;192
022;001;009;015;05;400;177;223
022;001;009;015;06;400;212;188
022;001;009;015;07;400;206;194
022;001;009;015;08;400;247;153
022;001;009;015;09;400;220;180
022;001;009;016;01;440;244;196
022;001;009;016;02;440;262;178
022;001;009;016;03;440;258;182
022;001;009;016;04;438;246;192
022;001;009;016;05;432;241;191
022;001;009;017;01;384;216;168
022;001;009;017;02;384;258;126
022;001;009;017;03;384;229;155
022;001;009;017;04;384;238;146
022;001;009;017;05;384;234;150
022;001;009;017;06;379;252;127
022;001;009;018;01;403;235;168
022;001;009;018;02;400;241;159
022;001;009;018;03;400;234;166
022;001;009;018;04;400;232;168
022;001;009;018;05;400;228;172
022;001;009;018;06;400;222;178
022;001;009;018;07;400;219;181
022;001;009;018;08;400;225;175
022;001;010;001;01;440;226;214
022;001;010;001;02;440;245;195
022;001;010;001;03;440;235;205
022;001;010;001;04;440;246;194
022;001;010;001;05;440;230;210
022;001;010;001;06;439;215;224
022;001;010;001;07;432;243;189
022;001;010;001;08;432;225;207
022;001;010;002;01;440;214;226
022;001;010;002;02;440;211;229
022;001;010;002;03;440;215;225
022;001;010;002;04;440;223;217
022;001;010;002;05;440;204;236
022;001;010;002;06;437;193;244
022;001;010;002;07;432;214;218
022;001;010;002;08;432;168;264
022;001;010;002;09;432;216;216
022;001;010;002;10;432;221;211
022;001;010;002;11;432;191;241
022;001;010;003;01;450;222;228
022;001;010;003;02;450;225;225
022;001;010;003;03;450;242;208
022;001;010;003;04;450;233;217
022;001;010;003;05;450;223;227
022;001;010;003;06;449;228;221
022;001;010;003;07;448;199;249
022;001;010;003;08;448;219;229
022;001;010;003;09;448;240;208
022;001;010;003;10;448;212;236
022;001;010;003;11;448;220;228
022;001;010;004;01;424;210;214
022;001;010;004;02;424;234;190
022;001;010;004;03;424;213;211
022;001;010;004;04;424;210;214
022;001;010;004;05;424;206;218
022;001;010;004;06;424;231;193
022;001;010;004;07;421;220;201
022;001;010;004;08;416;232;184
022;001;010;004;09;416;209;207
022;001;010;005;01;424;197;227
022;001;010;005;02;424;208;216
022;001;010;005;03;424;216;208
022;001;010;005;04;424;211;213
022;001;010;005;05;424;222;202
022;001;010;005;06;418;192;226
022;001;010;005;07;416;206;210
022;001;010;005;08;416;209;207
022;001;010;005;09;416;211;205
022;001;010;005;10;416;199;217
022;001;010;006;01;424;214;210
022;001;010;006;02;424;245;179
022;001;010;006;03;424;236;188
022;001;010;006;04;422;244;178
022;001;010;006;05;416;229;187
022;001;010;006;06;416;225;191
022;001;010;006;07;416;217;199
022;001;010;006;08;416;199;217
022;001;010;006;09;416;217;199
022;001;010;007;01;424;213;211
022;001;010;007;02;424;223;201
022;001;010;007;03;424;201;223
022;001;010;007;04;421;210;211
022;001;010;007;05;416;186;230
022;001;010;007;06;416;192;224
022;001;010;007;07;416;213;203
022;001;010;007;08;416;203;213
022;001;010;008;01;384;213;171
022;001;010;008;02;384;218;166
022;001;010;008;03;377;197;180
022;001;010;008;04;376;188;188
022;001;010;008;05;376;190;186
022;001;010;009;01;432;214;218
022;001;010;009;02;432;230;202
022;001;010;009;03;428;247;181
022;001;010;009;04;424;218;206
022;001;010;009;05;424;226;198
022;001;010;009;06;424;221;203
022;001;010;009;07;424;224;200
022;001;010;009;08;424;228;196
022;001;010;010;01;408;208;200
022;001;010;010;02;408;215;193
022;001;010;010;03;408;215;193
022;001;010;010;04;408;204;204
022;001;010;010;05;401;218;183
022;001;010;010;06;400;199;201
022;001;010;010;07;400;197;203
022;001;010;010;08;400;207;193
022;001;010;011;01;432;210;222
022;001;010;011;02;432;236;196
022;001;010;011;03;432;220;212
022;001;010;011;04;432;211;221
022;001;010;011;05;431;192;239
022;001;010;011;06;424;228;196
022;001;010;011;07;424;203;221
022;001;010;011;08;424;213;211
022;001;010;011;09;424;231;193
022;001;010;012;01;440;236;204
022;001;010;012;02;440;242;198
022;001;010;012;03;440;221;219
022;001;010;012;04;440;240;200
022;001;010;012;05;440;215;225
022;001;010;012;06;440;221;219
022;001;010;012;07;440;219;221
022;001;010;012;08;440;220;220
022;001;010;012;09;440;221;219
022;001;010;012;10;440;246;194
022;001;010;012;11;439;240;199
022;001;010;013;01;408;175;233
022;001;010;013;02;408;187;221
022;001;010;013;03;408;195;213
022;001;010;013;04;408;172;236
022;001;010;013;05;408;198;210
022;001;010;013;06;408;161;247
022;001;010;013;07;406;212;194
022;001;010;013;08;400;210;190
022;001;010;014;01;432;218;214
022;001;010;014;02;432;224;208
022;001;010;014;03;432;202;230
022;001;010;014;04;432;221;211
022;001;010;014;05;425;179;246
022;001;010;014;06;424;215;209
022;001;010;014;07;424;199;225
022;001;010;014;08;424;209;215
022;001;010;014;09;424;218;206
022;001;010;015;01;440;212;228
022;001;010;015;02;440;212;228
022;001;010;015;03;440;208;232
022;001;010;015;04;436;208;228
022;001;010;015;05;432;208;224
022;001;010;015;06;432;198;234
022;001;010;015;07;432;216;216
022;001;010;016;01;424;200;224
022;001;010;016;02;424;220;204
022;001;010;016;03;424;237;187
022;001;010;016;04;424;232;192
022;001;010;016;05;424;228;196
022;001;010;016;06;424;216;208
022;001;010;016;07;424;220;204
022;001;010;016;08;424;211;213
022;001;010;016;09;424;223;201
022;001;010;016;10;420;221;199
022;001;010;017;01;416;191;225
022;001;010;017;02;416;195;221
022;001;010;017;03;409;189;220
022;001;010;017;04;408;210;198
022;001;010;017;05;408;215;193
022;001;010;017;06;408;178;230
022;001;010;017;07;408;198;210
022;001;010;017;08;408;189;219
022;001;010;017;09;408;198;210
022;001;010;017;10;408;197;211
022;001;010;018;01;432;206;226
022;001;010;018;02;432;207;225
022;001;010;018;03;432;212;220
022;001;010;018;04;426;217;209
022;001;010;018;05;424;216;208
022;001;010;018;06;424;206;218
022;001;010;018;07;424;223;201
022;001;010;018;08;424;220;204
022;001;010;018;09;424;226;198
022;001;010;018;10;424;204;220
022;001;010;018;11;424;224;200
022;001;010;019;01;432;199;233
022;001;010;019;02;432;222;210
022;001;010;019;03;432;195;237
022;001;010;019;04;432;200;232
022;001;010;019;05;429;204;225
022;001;010;019;06;424;199;225
022;001;010;019;07;424;228;196
022;001;010;019;08;424;188;236
022;001;010;019;09;424;217;207
022;001;010;019;10;424;186;238
022;001;010;019;11;424;199;225
022;001;010;019;12;424;221;203
022;001;010;019;13;424;207;217
022;001;010;020;01;400;161;239
022;001;010;020;02;400;167;233
022;001;010;020;03;400;182;218
022;001;010;020;04;400;149;251
022;001;010;020;05;400;180;220
022;001;010;020;06;400;173;227
022;001;010;020;07;395;190;205
022;001;010;021;01;416;195;221
022;001;010;021;02;416;217;199
022;001;010;021;03;416;198;218
022;001;010;021;04;416;202;214
022;001;010;021;05;416;185;231
022;001;010;021;06;416;218;198
022;001;010;021;07;416;200;216
022;001;010;021;08;416;186;230
022;001;010;021;09;416;216;200
022;001;010;021;10;409;204;205
022;001;010;021;11;408;214;194
022;001;010;022;01;424;216;208
022;001;010;022;02;424;207;217
022;001;010;022;03;424;199;225
022;001;010;022;04;424;211;213
022;001;010;022;05;421;222;199
022;001;010;022;06;416;221;195
022;001;010;022;07;416;187;229
022;001;010;022;08;416;189;227
022;001;010;022;09;416;220;196
022;001;010;022;10;416;203;213
022;001;010;023;01;440;204;236
022;001;010;023;02;440;207;233
022;001;010;023;03;440;210;230
022;001;010;023;04;440;208;232
022;001;010;023;05;440;200;240
022;001;010;023;06;440;186;254
022;001;010;023;07;440;207;233
022;001;010;023;08;434;189;245
022;001;010;024;01;424;193;231
022;001;010;024;02;424;209;215
022;001;010;024;03;424;209;215
022;001;010;024;04;424;196;228
022;001;010;024;05;417;208;209
022;001;010;024;06;416;171;245
022;001;010;024;07;416;212;204
022;001;010;024;08;416;206;210
022;001;010;024;09;416;174;242
022;001;010;024;10;416;221;195
022;001;010;024;11;416;214;202
022;001;010;024;12;416;200;216
022;001;010;025;01;440;208;232
022;001;010;025;02;440;199;241
022;001;010;025;03;440;231;209
022;001;010;025;04;440;225;215
022;001;010;025;05;440;198;242
022;001;010;025;06;440;214;226
022;001;010;025;07;440;215;225
022;001;010;025;08;434;241;193
022;001;010;025;09;432;230;202
022;001;010;026;01;448;201;247
022;001;010;026;02;448;227;221
022;001;010;026;03;448;223;225
022;001;010;026;04;448;226;222
022;001;010;026;05;448;240;208
022;001;010;026;06;448;239;209
022;001;010;026;07;448;203;245
022;001;010;026;08;448;211;237
022;001;010;026;09;448;241;207
022;001;010;026;10;448;207;241
022;001;010;026;11;448;220;228
022;001;010;026;12;444;213;231
022;001;010;026;13;440;213;227
022;001;010;026;14;440;249;191
022;001;010;027;01;424;217;207
022;001;010;027;02;424;240;184
022;001;010;027;03;424;224;200
022;001;010;027;04;424;244;180
022;001;010;027;05;424;205;219
022;001;010;027;06;424;222;202
022;001;010;027;07;424;197;227
022;001;010;027;08;424;228;196
022;001;010;027;09;424;219;205
022;001;010;027;10;424;226;198
022;001;010;027;11;418;214;204
022;001;010;028;01;392;199;193
022;001;010;028;02;392;222;170
022;001;010;028;03;392;208;184
022;001;010;028;04;392;189;203
022;001;010;028;05;391;220;171
022;001;010;029;01;448;241;207
022;001;010;029;02;441;226;215
022;001;010;029;03;440;243;197
022;001;010;029;04;440;252;188
022;001;010;029;05;440;219;221
022;001;010;029;06;440;220;220
022;001;010;029;07;440;241;199
022;001;010;029;08;440;240;200
022;001;010;030;01;432;260;172
022;001;010;030;02;425;247;178
022;001;010;030;03;424;244;180
022;001;010;030;04;424;232;192
022;001;010;030;05;424;247;177
022;001;010;031;01;396;227;169
022;001;010;031;02;392;222;170
022;001;010;031;03;392;224;168
022;001;010;031;04;392;209;183
022;001;010;031;05;392;238;154
022;001;010;031;06;392;231;161
022;001;010;032;01;424;254;170
022;001;010;032;02;418;236;182
022;001;010;032;03;416;227;189
022;001;010;032;04;416;229;187
022;001;010;032;05;416;235;181
022;001;010;033;01;424;205;219
022;001;010;033;02;424;218;206
022;001;010;033;03;424;216;208
022;001;010;033;04;423;225;198
022;001;010;033;05;416;205;211
022;001;010;034;01;432;259;173
022;001;010;034;02;432;258;174
022;001;010;034;03;432;246;186
022;001;010;034;04;432;254;178
022;001;010;034;05;432;280;152
022;001;010;034;06;432;262;170
022;001;010;034;07;432;235;197
022;001;010;034;08;432;229;203
022;001;010;034;09;432;245;187
022;001;010;034;10;427;270;157
022;001;010;034;11;424;268;156
022;001;010;034;12;424;271;153
022;001;010;035;01;416;224;192
022;001;010;035;02;409;221;188
022;001;010;035;03;408;199;209
022;001;010;035;04;408;200;208
022;001;010;035;05;408;220;188
022;001;010;035;06;408;216;192
022;001;010;036;01;432;237;195
022;001;010;036;02;432;250;182
022;001;010;036;03;428;248;180
022;001;010;036;04;424;259;165
022;001;010;036;05;424;216;208
022;001;010;036;06;424;220;204
022;001;010;036;07;424;230;194
022;001;010;036;08;424;262;162
022;001;010;036;09;424;240;184
022;001;010;037;01;414;218;196
022;001;010;037;02;408;245;163
022;001;010;037;03;408;221;187
022;001;010;037;04;408;222;186
022;001;010;037;05;408;209;199
022;001;010;038;01;424;216;208
022;001;010;038;02;424;223;201
022;001;010;038;03;424;208;216
022;001;010;038;04;424;245;179
022;001;010;038;05;424;223;201
022;001;010;038;06;424;212;212
022;001;010;038;07;424;274;150
022;001;010;038;08;424;207;217
022;001;010;038;09;423;238;185
022;001;010;038;10;416;204;212
022;001;010;038;11;416;222;194
022;001;010;038;12;416;214;202
022;001;010;038;13;416;225;191
022;001;010;038;14;416;223;193
022;001;010;039;01;445;234;211
022;001;010;039;02;440;227;213
022;001;010;039;03;440;214;226
022;001;010;039;04;440;241;199
022;001;010;039;05;440;229;211
022;001;010;039;06;440;203;237
022;001;010;039;07;440;247;193
022;001;010;039;08;440;251;189
022;001;010;040;01;448;227;221
022;001;010;040;02;443;231;212
022;001;010;040;03;440;226;214
022;001;010;040;04;440;215;225
022;001;010;040;05;440;236;204
022;001;010;040;06;440;202;238
022;001;010;040;07;440;247;193
022;001;010;040;08;440;223;217
022;001;010;041;01;424;199;225
022;001;010;041;02;424;232;192
022;001;010;041;03;417;189;228
022;001;010;041;04;416;189;227
022;001;010;041;05;416;214;202
022;001;010;041;06;416;183;233
022;001;010;041;07;416;194;222
022;001;010;042;01;432;190;242
022;001;010;042;02;432;232;200
022;001;010;042;03;432;224;208
022;001;010;042;04;432;215;217
022;001;010;042;05;432;222;210
022;001;010;042;06;432;201;231
022;001;010;042;07;432;183;249
022;001;010;042;08;432;229;203
022;001;010;042;09;432;208;224
022;001;010;042;10;432;216;216
022;001;010;042;11;429;223;206
022;001;010;043;01;440;206;234
022;001;010;043;02;440;237;203
022;001;010;043;03;440;244;196
022;001;010;043;04;440;242;198
022;001;010;043;05;440;232;208
022;001;010;043;06;439;203;236
022;001;010;043;07;432;223;209
022;001;010;043;08;432;199;233
022;001;010;043;09;432;216;216
022;001;010;043;10;432;225;207
022;001;010;044;01;408;209;199
022;001;010;044;02;408;231;177
022;001;010;044;03;408;232;176
022;001;010;044;04;408;215;193
022;001;010;044;05;408;226;182
022;001;010;044;06;408;212;196
022;001;010;044;07;408;228;180
022;001;010;044;08;408;224;184
022;001;010;044;09;404;225;179
022;001;010;045;01;424;187;237
022;001;010;045;02;424;194;230
022;001;010;045;03;424;222;202
022;001;010;045;04;424;204;220
022;001;010;045;05;424;207;217
022;001;010;045;06;424;205;219
022;001;010;045;07;424;205;219
022;001;010;045;08;416;208;208
022;001;010;046;01;448;232;216
022;001;010;046;02;448;253;195
022;001;010;046;03;448;223;225
022;001;010;046;04;448;263;185
022;001;010;046;05;448;243;205
022;001;010;046;06;448;237;211
022;001;010;046;07;441;235;206
022;001;010;046;08;440;239;201
022;001;010;046;09;440;237;203
022;001;010;046;10;440;233;207
022;001;010;046;11;440;219;221
022;001;010;046;12;440;247;193
022;001;010;046;13;440;260;180
022;001;010;046;14;440;232;208
022;001;010;047;01;424;213;211
022;001;010;047;02;419;229;190
022;001;010;047;03;416;226;190
022;001;010;047;04;416;213;203
022;001;010;047;05;416;236;180
022;001;010;047;06;416;197;219
022;001;010;047;07;416;202;214
022;001;010;047;08;416;212;204
022;001;010;047;09;416;205;211
022;001;010;048;01;432;230;202
022;001;010;048;02;432;231;201
022;001;010;048;03;432;232;200
022;001;010;048;04;432;250;182
022;001;010;048;05;432;245;187
022;001;010;048;06;432;244;188
022;001;010;048;07;426;244;182
022;001;010;048;08;424;226;198
022;001;010;048;09;424;231;193
022;001;010;048;10;424;213;211
022;001;010;048;11;424;242;182
022;001;010;048;12;424;244;180
022;001;010;048;13;424;233;191
022;001;010;049;01;416;260;156
022;001;010;049;02;416;265;151
022;001;010;049;03;416;237;179
022;001;010;049;04;410;234;176
022;001;010;049;05;408;214;194
022;001;010;049;06;408;240;168
022;001;010;049;07;408;238;170
022;001;010;050;01;425;218;207
022;001;010;050;02;424;218;206
022;001;010;050;03;424;233;191
022;001;010;050;04;424;210;214
022;001;010;050;05;424;242;182
022;001;010;050;06;424;223;201
022;001;010;050;07;424;224;200
022;001;010;050;08;424;206;218
022;001;010;050;09;424;192;232
022;001;010;050;10;424;210;214
022;001;010;050;11;424;201;223
022;001;010;050;12;424;231;193
022;001;010;050;13;424;218;206
022;001;010;050;14;424;215;209
022;001;010;051;01;448;212;236
022;001;010;051;02;448;219;229
022;001;010;051;03;448;225;223
022;001;010;051;04;448;236;212
022;001;010;051;05;448;192;256
022;001;010;051;06;448;210;238
022;001;010;051;07;440;202;238
022;001;010;051;08;440;191;249
022;001;010;052;01;392;175;217
022;001;010;052;02;386;203;183
022;001;010;052;03;384;182;202
022;001;010;052;04;384;172;212
022;001;010;052;05;384;185;199
022;001;010;052;06;384;172;212
022;001;010;053;01;448;209;239
022;001;010;053;02;448;205;243
022;001;010;053;03;448;211;237
022;001;010;053;04;440;217;223
022;001;010;053;05;440;235;205
022;001;010;053;06;440;195;245
022;001;010;053;07;440;215;225
022;001;010;053;08;440;206;234
022;001;010;053;09;440;203;237
022;001;010;053;10;440;181;259
022;001;010;053;11;440;200;240
022;001;010;054;01;448;250;198
022;001;010;054;02;440;236;204
022;001;010;054;03;440;243;197
022;001;010;054;04;440;226;214
022;001;010;054;05;440;235;205
022;001;010;055;01;432;190;242
022;001;010;055;02;432;181;251
022;001;010;055;03;432;190;242
022;001;010;055;04;432;207;225
022;001;010;055;05;432;193;239
022;001;010;055;06;429;197;232
022;001;010;055;07;424;193;231
022;001;010;055;08;424;207;217
022;001;010;056;01;400;196;204
022;001;010;056;02;400;206;194
022;001;010;056;03;399;203;196
022;001;010;056;04;392;190;202
022;001;010;056;05;392;163;229
022;001;010;056;06;392;203;189
022;001;010;056;07;392;188;204
022;001;010;057;01;424;212;212
022;001;010;057;02;424;214;210
022;001;010;057;03;424;228;196
022;001;010;057;04;424;214;210
022;001;010;057;05;416;209;207
022;001;010;057;06;416;200;216
022;001;010;057;07;416;229;187
022;001;010;057;08;416;204;212
022;001;010;058;01;440;221;219
022;001;010;058;02;440;228;212
022;001;010;058;03;440;231;209
022;001;010;058;04;440;239;201
022;001;010;058;05;440;196;244
022;001;010;058;06;440;206;234
022;001;010;058;07;432;211;221
022;001;010;058;08;432;222;210
022;001;010;058;09;432;219;213
022;001;010;059;01;432;231;201
022;001;010;059;02;432;226;206
022;001;010;059;03;432;224;208
022;001;010;059;04;432;232;200
022;001;010;059;05;432;225;207
022;001;010;059;06;432;234;198
022;001;010;059;07;432;201;231
022;001;010;059;08;426;223;203
022;001;010;059;09;424;226;198
022;001;010;059;10;424;228;196
022;001;010;060;01;424;217;207
022;001;010;060;02;424;219;205
022;001;010;060;03;424;222;202
022;001;010;060;04;421;186;235
022;001;010;060;05;416;210;206
022;001;010;061;01;416;206;210
022;001;010;061;02;416;219;197
022;001;010;061;03;416;232;184
022;001;010;061;04;416;204;212
022;001;010;061;05;416;197;219
022;001;010;061;06;416;214;202
022;001;010;061;07;416;215;201
022;001;010;061;08;416;197;219
022;001;010;061;09;410;222;188
022;001;010;061;10;408;206;202
022;001;010;062;01;400;203;197
022;001;010;062;02;393;203;190
022;001;010;062;03;392;206;186
022;001;010;062;04;392;190;202
022;001;010;062;05;392;198;194
022;001;010;062;06;392;213;179
022;001;010;062;07;392;198;194
022;001;010;063;01;424;201;223
022;001;010;063;02;417;217;200
022;001;010;063;03;416;215;201
022;001;010;063;04;416;212;204
022;001;010;063;05;416;236;180
022;001;010;063;06;416;222;194
022;001;010;063;07;416;190;226
022;001;010;063;08;416;221;195
022;001;010;063;09;416;198;218
022;001;010;064;01;432;231;201
022;001;010;064;02;432;248;184
022;001;010;064;03;432;258;174
022;001;010;064;04;432;248;184
022;001;010;064;05;432;225;207
022;001;010;064;06;432;227;205
022;001;010;064;07;428;253;175
022;001;010;065;01;440;248;192
022;001;010;065;02;440;253;187
022;001;010;065;03;432;241;191
022;001;010;065;04;432;229;203
022;001;010;065;05;432;232;200
022;001;010;065;06;432;259;173
022;001;010;065;07;432;245;187
022;001;010;066;01;423;240;183
022;001;010;066;02;416;251;165
022;001;010;066;03;416;245;171
022;001;010;066;04;416;249;167
022;001;010;066;05;416;227;189
022;001;010;066;06;416;237;179
022;001;010;066;07;416;256;160
022;001;010;066;08;416;233;183
022;001;010;066;09;416;253;163
022;001;010;066;10;416;231;185
022;001;010;066;11;416;252;164
022;001;010;067;01;416;246;170
022;001;010;067;02;416;250;166
022;001;010;067;03;416;252;164
022;001;010;067;04;416;240;176
022;001;010;067;05;416;232;184
022;001;010;067;06;416;233;183
022;001;010;067;07;416;264;152
022;001;010;067;08;412;224;188
022;001;010;067;09;408;201;207
022;001;010;067;10;408;238;170
022;001;010;067;11;408;245;163
022;001;010;067;12;408;256;152
022;001;010;068;01;416;228;188
022;001;010;068;02;416;220;196
022;001;010;068;03;416;212;204
022;001;010;068;04;409;210;199
022;001;010;069;01;440;216;224
022;001;010;069;02;440;225;215
022;001;010;069;03;440;248;192
022;001;010;069;04;436;233;203
022;001;010;069;05;432;233;199
022;001;010;069;06;432;239;193
022;001;010;069;07;432;234;198
022;001;010;070;01;408;232;176
022;001;010;070;02;408;233;175
022;001;010;070;03;408;209;199
022;001;010;070;04;405;227;178
022;001;010;070;05;400;201;199
022;001;010;070;06;400;226;174
022;001;010;071;01;400;205;195
022;001;010;071;02;400;202;198
022;001;010;071;03;400;214;186
022;001;010;071;04;399;202;197
022;001;010;071;05;392;193;199
022;001;010;071;06;392;196;196
022;001;010;072;01;408;197;211
022;001;010;072;02;408;215;193
022;001;010;072;03;402;235;167
022;001;010;072;04;400;211;189
022;001;010;072;05;400;199;201
022;001;010;072;06;400;231;169
022;001;010;072;07;400;217;183
022;001;010;073;01;416;211;205
022;001;010;073;02;416;202;214
022;001;010;073;03;416;200;216
022;001;010;073;04;416;222;194
022;001;010;073;05;416;222;194
022;001;010;073;06;416;204;212
022;001;010;073;07;415;209;206
022;001;010;073;08;408;241;167
022;001;010;074;01;432;214;218
022;001;010;074;02;432;229;203
022;001;010;074;03;432;226;206
022;001;010;074;04;432;220;212
022;001;010;074;05;425;184;241
022;001;010;074;06;424;202;222
022;001;010;074;07;424;232;192
022;001;010;074;08;424;218;206
022;001;010;075;01;448;242;206
022;001;010;075;02;448;248;200
022;001;010;075;03;448;292;156
022;001;010;075;04;448;252;196
022;001;010;075;05;448;253;195
022;001;010;075;06;441;244;197
022;001;010;075;07;440;248;192
022;001;010;075;08;440;226;214
022;001;010;075;09;440;244;196
022;001;010;075;10;440;254;186
022;001;010;075;11;440;255;185
022;001;010;076;01;432;222;210
022;001;010;076;02;432;232;200
022;001;010;076;03;432;195;237
022;001;010;076;04;432;239;193
022;001;010;076;05;424;231;193
022;001;010;076;06;424;242;182
022;001;010;076;07;424;234;190
022;001;010;077;01;432;251;181
022;001;010;077;02;432;217;215
022;001;010;077;03;432;224;208
022;001;010;077;04;432;246;186
022;001;010;077;05;432;229;203
022;001;010;077;06;424;219;205
022;001;010;077;07;424;260;164
022;001;010;077;08;424;245;179
022;001;010;078;01;440;249;191
022;001;010;078;02;440;250;190
022;001;010;078;03;440;235;205
022;001;010;078;04;434;234;200
022;001;010;078;05;432;207;225
022;001;010;078;06;432;216;216
022;001;010;078;07;432;253;179
022;001;010;079;01;432;230;202
022;001;010;079;02;432;221;211
022;001;010;079;03;432;223;209
022;001;010;079;04;432;233;199
022;001;010;079;05;425;217;208
022;001;010;079;06;424;222;202
022;001;010;079;07;424;220;204
022;001;010;079;08;424;207;217
022;001;010;079;09;424;228;196
022;001;010;079;10;424;242;182
022;001;010;079;11;424;209;215
022;001;010;080;01;432;244;188
022;001;010;080;02;430;215;215
022;001;010;080;03;424;233;191
022;001;010;080;04;424;224;200
022;001;010;080;05;424;185;239
022;001;010;080;06;424;215;209
022;001;010;080;07;424;213;211
022;001;010;080;08;424;224;200
022;001;010;080;09;424;219;205
022;001;010;081;01;416;219;197
022;001;010;081;02;416;220;196
022;001;010;081;03;416;233;183
022;001;010;081;04;416;207;209
022;001;010;081;05;416;209;207
022;001;010;081;06;416;230;186
022;001;010;081;07;416;228;188
022;001;010;081;08;416;210;206
022;001;010;081;09;410;244;166
022;001;010;081;10;408;214;194
022;001;010;082;01;432;231;201
022;001;010;082;02;432;272;160
022;001;010;082;03;432;250;182
022;001;010;082;04;432;258;174
022;001;010;082;05;432;238;194
022;001;010;082;06;428;248;180
022;001;010;083;01;440;236;204
022;001;010;083;02;440;231;209
022;001;010;083;03;440;241;199
022;001;010;083;04;440;230;210
022;001;010;083;05;440;212;228
022;001;010;083;06;440;244;196
022;001;010;083;07;440;251;189
022;001;010;083;08;434;226;208
022;001;010;084;01;432;211;221
022;001;010;084;02;426;210;216
022;001;010;084;03;424;212;212
022;001;010;084;04;424;209;215
022;001;010;085;01;448;225;223
022;001;010;085;02;448;242;206
022;001;010;085;03;448;246;202
022;001;010;085;04;447;221;226
022;001;010;085;05;440;226;214
022;001;010;085;06;440;239;201
022;001;010;085;07;440;238;202
022;001;010;086;01;372;190;182
022;001;010;086;02;368;195;173
022;001;010;086;03;368;196;172
022;001;010;086;04;368;179;189
022;001;010;086;05;368;193;175
022;001;010;087;01;445;239;206
022;001;010;087;02;440;232;208
022;001;010;087;03;440;240;200
022;001;010;087;04;440;221;219
022;001;010;087;05;440;195;245
022;001;010;087;06;440;211;229
022;001;010;087;07;440;211;229
022;001;010;087;08;440;238;202
022;001;010;088;01;416;203;213
022;001;010;088;02;412;197;215
022;001;010;088;03;408;204;204
022;001;010;088;04;408;168;240
022;001;010;088;05;408;215;193
022;001;010;088;06;408;179;229
022;001;010;088;07;408;213;195
022;001;010;089;01;448;234;214
022;001;010;089;02;448;243;205
022;001;010;089;03;448;230;218
022;001;010;089;04;448;256;192
022;001;010;089;05;448;243;205
022;001;010;089;06;448;215;233
022;001;010;089;07;447;248;199
022;001;010;089;08;440;230;210
022;001;010;090;01;424;184;240
022;001;010;090;02;424;236;188
022;001;010;090;03;421;205;216
022;001;010;090;04;416;193;223
022;001;010;090;05;416;193;223
022;001;010;090;06;416;193;223
022;001;010;090;07;416;235;181
022;001;010;090;08;416;215;201
022;001;010;091;01;408;181;227
022;001;010;091;02;408;181;227
022;001;010;091;03;405;204;201
022;001;010;091;04;400;178;222
022;001;010;091;05;400;153;247
022;001;010;091;06;400;217;183
022;001;010;091;07;400;188;212
022;001;010;091;08;400;181;219
022;001;010;092;01;392;193;199
022;001;010;092;02;392;187;205
022;001;010;092;03;392;193;199
022;001;010;092;04;392;215;177
022;001;010;092;05;392;179;213
022;001;010;092;06;391;194;197
022;001;010;093;01;440;206;234
022;001;010;093;02;440;223;217
022;001;010;093;03;440;227;213
022;001;010;093;04;440;194;246
022;001;010;093;05;440;219;221
022;001;010;093;06;440;215;225
022;001;010;093;07;440;213;227
022;001;010;093;08;432;221;211
022;001;010;094;01;408;191;217
022;001;010;094;02;408;217;191
022;001;010;094;03;408;194;214
022;001;010;094;04;408;196;212
022;001;010;094;05;408;189;219
022;001;010;094;06;408;216;192
022;001;010;094;07;408;204;204
022;001;010;094;08;400;190;210
022;001;010;094;09;400;204;196
022;001;010;095;01;400;209;191
022;001;010;095;02;393;208;185
022;001;010;095;03;392;206;186
022;001;010;095;04;392;200;192
022;001;010;095;05;392;210;182
022;001;010;096;01;424;220;204
022;001;010;096;02;424;207;217
022;001;010;096;03;416;211;205
022;001;010;096;04;416;196;220
022;001;010;096;05;416;201;215
022;001;010;096;06;416;216;200
022;001;010;096;07;416;211;205
022;001;010;097;01;440;219;221
022;001;010;097;02;440;228;212
022;001;010;097;03;440;256;184
022;001;010;097;04;440;211;229
022;001;010;097;05;440;227;213
022;001;010;097;06;440;224;216
022;001;010;097;07;435;223;212
022;001;010;097;08;432;205;227
022;001;010;097;09;432;235;197
022;001;010;097;10;432;224;208
022;001;010;098;01;448;253;195
022;001;010;098;02;440;216;224
022;001;010;098;03;440;226;214
022;001;010;098;04;440;214;226
022;001;010;098;05;440;215;225
022;001;010;098;06;440;224;216
022;001;010;098;07;440;235;205
022;001;010;099;01;424;205;219
022;001;010;099;02;424;223;201
022;001;010;099;03;424;218;206
022;001;010;099;04;417;190;227
022;001;010;099;05;416;190;226
022;001;010;099;06;416;205;211
022;001;010;099;07;416;207;209
022;001;010;100;01;432;181;251
022;001;010;100;02;432;222;210
022;001;010;100;03;432;236;196
022;001;010;100;04;432;236;196
022;001;010;100;05;432;219;213
022;001;010;100;06;432;202;230
022;001;010;100;07;432;209;223
022;001;010;100;08;432;201;231
022;001;010;100;09;432;224;208
022;001;010;100;10;431;223;208
022;001;010;100;11;424;194;230
022;001;010;100;12;424;216;208
022;001;010;100;13;424;233;191
022;001;010;100;14;424;221;203
022;001;010;100;15;424;239;185
022;001;010;101;01;416;197;219
022;001;010;101;02;416;218;198
022;001;010;101;03;416;198;218
022;001;010;101;04;416;192;224
022;001;010;101;05;416;199;217
022;001;010;101;06;416;220;196
022;001;010;101;07;413;197;216
022;001;010;102;01;376;190;186
022;001;010;102;02;376;199;177
022;001;010;102;03;376;165;211
022;001;010;102;04;369;171;198
022;001;010;102;05;368;193;175
022;001;010;103;01;400;198;202
022;001;010;103;02;400;205;195
022;001;010;103;03;400;189;211
022;001;010;103;04;400;200;200
022;001;010;103;05;400;211;189
022;001;010;103;06;392;213;179
022;001;010;104;01;400;204;196
022;001;010;104;02;400;232;168
022;001;010;104;03;400;210;190
022;001;010;104;04;400;223;177
022;001;010;104;05;400;213;187
022;001;010;104;06;398;220;178
022;001;010;105;01;440;205;235
022;001;010;105;02;440;231;209
022;001;010;105;03;439;227;212
022;001;010;105;04;432;211;221
022;001;010;105;05;432;182;250
022;001;010;105;06;432;195;237
022;001;010;105;07;432;200;232
022;001;010;105;08;432;223;209
022;001;010;106;01;448;227;221
022;001;010;106;02;448;243;205
022;001;010;106;03;448;259;189
022;001;010;106;04;446;242;204
022;001;010;106;05;440;240;200
022;001;010;106;06;440;252;188
022;001;010;107;01;408;200;208
022;001;010;107;02;406;215;191
022;001;010;107;03;400;190;210
022;001;010;107;04;400;181;219
022;001;010;107;05;400;194;206
022;001;010;107;06;400;207;193
022;001;010;108;01;424;238;186
022;001;010;108;02;423;225;198
022;001;010;108;03;416;223;193
022;001;010;108;04;416;230;186
022;001;010;108;05;416;216;200
022;001;010;108;06;416;213;203
022;001;010;108;07;416;192;224
022;001;010;108;08;416;227;189
022;001;010;108;09;416;206;210
022;001;010;108;10;416;231;185
022;001;010;108;11;416;235;181
022;001;010;109;01;400;206;194
022;001;010;109;02;400;208;192
022;001;010;109;03;400;213;187
022;001;010;109;04;400;217;183
022;001;010;109;05;400;201;199
022;001;010;109;06;397;203;194
022;001;010;109;07;392;195;197
022;001;010;109;08;392;202;190
022;001;010;110;01;432;202;230
022;001;010;110;02;432;230;202
022;001;010;110;03;432;217;215
022;001;010;110;04;432;212;220
022;001;010;110;05;432;218;214
022;001;010;110;06;426;216;210
022;001;010;111;01;440;222;218
022;001;010;111;02;440;234;206
022;001;010;111;03;436;218;218
022;001;010;111;04;432;214;218
022;001;010;111;05;432;225;207
022;001;010;112;01;424;196;228
022;001;010;112;02;424;199;225
022;001;010;112;03;424;208;216
022;001;010;112;04;424;197;227
022;001;010;112;05;424;204;220
022;001;010;112;06;424;197;227
022;001;010;112;07;421;217;204
022;001;010;113;01;392;195;197
022;001;010;113;02;392;190;202
022;001;010;113;03;392;193;199
022;001;010;113;04;392;202;190
022;001;010;113;05;392;211;181
022;001;010;113;06;384;191;193
022;001;010;114;01;448;243;205
022;001;010;114;02;448;261;187
022;001;010;114;03;442;235;207
022;001;010;114;04;440;242;198
022;001;010;114;05;440;242;198
022;001;010;114;06;440;230;210
022;001;010;115;01;416;172;244
022;001;010;115;02;416;208;208
022;001;010;115;03;416;205;211
022;001;010;115;04;416;217;199
022;001;010;115;05;416;210;206
022;001;010;115;06;414;202;212
022;001;010;115;07;408;211;197
022;001;010;115;08;408;220;188
022;001;010;115;09;408;242;166
022;001;010;116;01;400;167;233
022;001;010;116;02;393;209;184
022;001;010;116;03;392;211;181
022;001;010;116;04;392;198;194
022;001;010;116;05;392;210;182
022;001;010;116;06;392;206;186
022;001;010;116;07;392;203;189
022;001;010;117;01;416;197;219
022;001;010;117;02;416;215;201
022;001;010;117;03;416;219;197
022;001;010;117;04;416;222;194
022;001;010;117;05;416;220;196
022;001;010;117;06;416;216;200
022;001;010;117;07;416;208;208
022;001;010;117;08;413;217;196
022;001;010;117;09;408;196;212
022;001;010;117;10;408;213;195
022;001;010;117;11;408;209;199
022;001;010;117;12;408;197;211
022;001;010;118;01;424;189;235
022;001;010;118;02;424;226;198
022;001;010;118;03;424;193;231
022;001;010;118;04;424;187;237
022;001;010;118;05;424;210;214
022;001;010;118;06;423;207;216
022;001;010;118;07;416;218;198
022;001;010;119;01;448;223;225
022;001;010;119;02;440;223;217
022;001;010;119;03;440;215;225
022;001;010;119;04;440;232;208
022;001;010;119;05;440;215;225
022;001;010;119;06;440;220;220
022;001;010;120;01;416;199;217
022;001;010;120;02;416;226;190
022;001;010;120;03;416;204;212
022;001;010;120;04;416;196;220
022;001;010;120;05;416;214;202
022;001;010;120;06;416;210;206
022;001;010;120;07;416;190;226
022;001;010;120;08;416;233;183
022;001;010;120;09;416;195;221
022;001;010;120;10;416;224;192
022;001;010;120;11;416;203;213
022;001;010;120;12;407;200;207
022;001;010;121;01;440;184;256
022;001;010;121;02;440;206;234
022;001;010;121;03;440;222;218
022;001;010;121;04;440;224;216
022;001;010;121;05;440;210;230
022;001;010;121;06;440;217;223
022;001;010;121;07;438;218;220
022;001;010;121;08;432;204;228
022;001;010;122;01;408;213;195
022;001;010;122;02;408;211;197
022;001;010;122;03;405;195;210
022;001;010;122;04;400;194;206
022;001;010;122;05;400;205;195
022;001;010;122;06;400;218;182
022;001;010;122;07;400;209;191
022;001;010;122;08;400;214;186
022;001;010;123;01;424;224;200
022;001;010;123;02;424;227;197
022;001;010;123;03;424;221;203
022;001;010;123;04;424;205;219
022;001;010;123;05;424;201;223
022;001;010;123;06;424;223;201
022;001;010;123;07;424;185;239
022;001;010;123;08;422;238;184
022;001;010;123;09;416;198;218
022;001;010;123;10;416;189;227
022;001;010;123;11;416;220;196
022;001;010;123;12;416;235;181
022;001;010;124;01;440;210;230
022;001;010;124;02;440;202;238
022;001;010;124;03;440;202;238
022;001;010;124;04;440;218;222
022;001;010;124;05;436;217;219
022;001;010;124;06;432;217;215
022;001;010;124;07;432;199;233
022;001;010;124;08;432;212;220
022;001;010;124;09;432;221;211
022;001;010;124;10;432;206;226
022;001;010;124;11;432;222;210
022;001;010;125;01;416;198;218
022;001;010;125;02;416;196;220
022;001;010;125;03;416;203;213
022;001;010;125;04;408;203;205
022;001;010;125;05;408;180;228
022;001;010;125;06;408;197;211
022;001;010;126;01;440;247;193
022;001;010;126;02;440;212;228
022;001;010;126;03;433;210;223
022;001;010;126;04;432;221;211
022;001;010;126;05;432;205;227
022;001;010;126;06;432;230;202
022;001;010;126;07;432;225;207
022;001;010;126;08;432;208;224
022;001;010;127;01;408;190;218
022;001;010;127;02;408;209;199
022;001;010;127;03;408;203;205
022;001;010;127;04;408;207;201
022;001;010;127;05;408;176;232
022;001;010;127;06;408;191;217
022;001;010;127;07;408;196;212
022;001;010;127;08;407;200;207
022;001;010;127;09;400;205;195
022;001;010;127;10;400;204;196
022;001;010;128;01;432;204;228
022;001;010;128;02;432;235;197
022;001;010;128;03;432;198;234
022;001;010;128;04;432;224;208
022;001;010;128;05;432;230;202
022;001;010;128;06;428;206;222
022;001;010;128;07;424;225;199
022;001;010;128;08;424;224;200
022;001;010;129;01;426;221;205
022;001;010;129;02;424;225;199
022;001;010;129;03;424;226;198
022;001;010;129;04;424;203;221
022;001;010;129;05;424;199;225
022;001;010;129;06;424;218;206
022;001;010;130;01;424;193;231
022;001;010;130;02;424;195;229
022;001;010;130;03;424;193;231
022;001;010;130;04;416;197;219
022;001;010;130;05;416;184;232
022;001;010;130;06;416;191;225
022;001;010;130;07;416;191;225
022;001;010;130;08;416;197;219
022;001;010;130;09;416;186;230
022;001;010;130;10;416;199;217
022;001;010;131;01;416;188;228
022;001;010;131;02;414;204;210
022;001;010;131;03;408;203;205
022;001;010;131;04;408;196;212
022;001;010;131;05;408;196;212
022;001;010;131;06;408;185;223
022;001;010;131;07;408;187;221
022;001;010;131;08;408;216;192
022;001;010;131;09;408;185;223
022;001;010;131;10;408;222;186
022;001;010;131;11;408;223;185
022;001;010;132;01;400;202;198
022;001;010;132;02;400;200;200
022;001;010;132;03;399;203;196
022;001;010;132;04;392;212;180
022;001;010;132;05;392;215;177
022;001;010;133;01;232;135;97
022;001;010;133;02;224;139;85
022;001;010;134;01;333;157;176
022;001;010;134;02;328;182;146
022;001;010;135;01;168;99;69
022;001;010;136;01;424;271;153
022;001;010;136;02;424;258;166
022;001;010;136;03;424;264;160
022;001;010;136;04;424;281;143
022;001;010;136;05;424;260;164
022;001;010;136;06;424;243;181
022;001;010;136;07;424;237;187
022;001;010;136;08;424;242;182
022;001;010;136;09;424;259;165
022;001;010;136;10;421;263;158
022;001;010;137;01;432;250;182
022;001;010;137;02;432;262;170
022;001;010;137;03;431;265;166
022;001;010;137;04;424;241;183
022;001;010;137;05;424;256;168
022;001;010;137;06;424;248;176
022;001;010;137;07;424;266;158
022;001;010;137;08;424;267;157
022;001;010;137;09;424;267;157
022;001;010;137;10;424;226;198
022;001;010;137;11;424;237;187
022;001;010;137;12;424;280;144
022;001;010;137;13;424;242;182
022;001;010;137;14;424;246;178
022;001;010;137;15;424;247;177
022;001;010;137;16;424;257;167
022;001;010;137;17;424;264;160
022;001;010;137;18;424;276;148
022;001;010;138;01;440;237;203
022;001;010;138;02;440;271;169
022;001;010;138;03;432;240;192
022;001;010;138;04;432;267;165
022;001;010;138;05;432;225;207
022;001;010;138;06;432;246;186
022;001;010;138;07;432;248;184
022;001;010;138;08;432;253;179
022;001;010;138;09;432;238;194
022;001;010;138;10;432;260;172
022;001;010;138;11;432;272;160
022;001;010;139;01;440;208;232
022;001;010;139;02;440;212;228
022;001;010;139;03;440;232;208
022;001;010;139;04;440;211;229
022;001;010;139;05;440;211;229
022;001;010;139;06;440;232;208
022;001;010;139;07;440;212;228
022;001;010;139;08;437;226;211
022;001;010;139;09;432;241;191
022;001;010;140;01;408;252;156
022;001;010;140;02;408;252;156
022;001;010;140;03;408;244;164
022;001;010;140;04;408;269;139
022;001;010;140;05;408;221;187
022;001;010;140;06;408;248;160
022;001;010;140;07;404;243;161
022;001;010;140;08;400;241;159
022;001;010;140;09;400;240;160
022;001;010;141;01;384;218;166
022;001;010;141;02;384;231;153
022;001;010;141;03;383;221;162
022;001;010;141;04;376;212;164
022;001;010;141;05;376;218;158
022;001;010;141;06;376;220;156
022;001;010;142;01;450;245;205
022;001;010;142;02;450;253;197
022;001;010;142;03;450;244;206
022;001;010;142;04;450;254;196
022;001;010;142;05;449;223;226
022;001;010;142;06;448;228;220
022;001;010;142;07;448;239;209
022;001;010;142;08;448;269;179
022;001;010;142;09;448;236;212
022;001;010;143;01;424;214;210
022;001;010;143;02;424;236;188
022;001;010;143;03;424;220;204
022;001;010;143;04;424;216;208
022;001;010;143;05;424;223;201
022;001;010;143;06;424;207;217
022;001;010;143;07;424;196;228
022;001;010;143;08;424;224;200
022;001;010;143;09;424;203;221
022;001;010;143;10;424;213;211
022;001;010;143;11;424;234;190
022;001;010;143;12;424;222;202
022;001;010;143;13;424;199;225
022;001;010;143;14;424;220;204
022;001;010;143;15;424;193;231
022;001;010;143;16;417;239;178
022;001;010;144;01;448;215;233
022;001;010;144;02;448;213;235
022;001;010;144;03;443;222;221
022;001;010;144;04;440;212;228
022;001;010;144;05;440;228;212
022;001;010;144;06;440;212;228
022;001;010;144;07;440;227;213
022;001;010;144;08;440;216;224
022;001;010;144;09;440;208;232
022;001;010;144;10;440;235;205
022;001;010;144;11;440;227;213
022;001;010;144;12;440;213;227
022;001;010;144;13;440;210;230
022;001;010;144;14;440;210;230
022;001;010;144;15;440;217;223
022;001;010;144;16;440;224;216
022;001;010;144;17;440;222;218
022;001;010;144;18;440;221;219
022;001;010;144;19;440;244;196
022;001;010;145;01;432;188;244
022;001;010;145;02;432;202;230
022;001;010;145;03;432;212;220
022;001;010;145;04;432;223;209
022;001;010;145;05;432;205;227
022;001;010;145;06;429;214;215
022;001;010;145;07;424;200;224
022;001;010;145;08;424;235;189
022;001;010;145;09;424;182;242
022;001;010;145;10;424;207;217
022;001;010;145;11;424;212;212
022;001;010;145;12;424;204;220
022;001;010;145;13;424;196;228
022;001;010;145;14;424;192;232
022;001;010;145;15;424;214;210
022;001;010;146;01;440;217;223
022;001;010;146;02;440;239;201
022;001;010;146;03;440;211;229
022;001;010;146;04;432;197;235
022;001;010;146;05;432;233;199
022;001;010;146;06;432;200;232
022;001;010;146;07;432;211;221
022;001;010;146;08;432;194;238
022;001;010;146;09;432;181;251
022;001;010;146;10;432;203;229
022;001;010;146;11;432;214;218
022;001;010;146;12;432;211;221
022;001;010;147;01;440;199;241
022;001;010;147;02;440;235;205
022;001;010;147;03;440;218;222
022;001;010;147;04;440;199;241
022;001;010;147;05;440;207;233
022;001;010;147;06;440;222;218
022;001;010;147;07;432;206;226
022;001;010;147;08;432;222;210
022;001;010;147;09;432;215;217
022;001;010;148;01;448;226;222
022;001;010;148;02;448;198;250
022;001;010;148;03;448;247;201
022;001;010;148;04;448;241;207
022;001;010;148;05;448;237;211
022;001;010;148;06;448;229;219
022;001;010;148;07;448;227;221
022;001;010;148;08;448;198;250
022;001;010;148;09;448;245;203
022;001;010;148;10;448;239;209
022;001;010;148;11;448;222;226
022;001;010;148;12;448;229;219
022;001;010;148;13;447;211;236
022;001;010;149;01;408;187;221
022;001;010;149;02;408;202;206
022;001;010;149;03;408;211;197
022;001;010;149;04;408;200;208
022;001;010;149;05;408;182;226
022;001;010;149;06;408;193;215
022;001;010;149;07;408;186;222
022;001;010;149;08;402;206;196
022;001;010;150;01;448;205;243
022;001;010;150;02;448;235;213
022;001;010;150;03;448;227;221
022;001;010;150;04;448;230;218
022;001;010;150;05;448;215;233
022;001;010;150;06;448;229;219
022;001;010;150;07;442;222;220
022;001;010;150;08;440;234;206
022;001;010;150;09;440;221;219
022;001;010;151;01;416;263;153
022;001;010;151;02;416;272;144
022;001;010;151;03;416;274;142
022;001;010;151;04;416;269;147
022;001;010;151;05;416;242;174
022;001;010;151;06;411;263;148
022;001;010;151;07;408;264;144
022;001;010;151;08;408;257;151
022;001;010;151;09;408;279;129
022;001;010;151;10;408;273;135
022;001;010;152;01;448;242;206
022;001;010;152;02;448;259;189
022;001;010;152;03;448;240;208
022;001;010;152;04;441;203;238
022;001;010;152;05;440;222;218
022;001;010;152;06;440;207;233
022;001;010;153;01;448;257;191
022;001;010;153;02;441;255;186
022;001;010;153;03;440;254;186
022;001;010;154;01;328;171;157
022;001;010;154;02;328;186;142
022;001;010;154;03;328;166;162
022;001;010;155;01;360;203;157
022;001;010;155;02;359;202;157
022;001;010;155;03;352;197;155
022;001;010;156;01;320;155;165
022;001;010;156;02;312;162;150
022;001;010;156;03;312;154;158
022;001;010;157;01;283;153;130
022;001;010;157;02;280;148;132
022;001;010;159;01;336;175;161
022;001;010;159;02;336;177;159
022;001;010;159;03;331;169;162
022;001;010;160;01;376;203;173
022;001;010;161;01;250;137;113
022;001;010;162;01;432;235;197
022;001;010;162;02;432;235;197
022;001;010;163;01;305;148;157
022;001;010;163;02;304;164;140
022;001;010;164;01;352;176;176
022;001;010;164;02;344;183;161
022;001;010;165;01;430;238;192
022;001;010;165;02;424;252;172
022;001;010;166;01;238;135;103
022;001;010;166;02;232;125;107
022;001;010;167;01;432;252;180
022;001;010;167;02;432;272;160
022;002;001;001;01;440;220;220
022;002;001;001;02;440;225;215
022;002;001;001;03;440;238;202
022;002;001;001;04;440;243;197
022;002;001;001;05;437;241;196
022;002;001;002;01;400;214;186
022;002;001;002;02;400;220;180
022;002;001;002;03;400;206;194
022;002;001;002;04;400;201;199
022;002;001;002;05;395;206;189
022;002;001;002;06;392;204;188
022;002;001;002;07;392;195;197
022;002;001;003;01;416;209;207
022;002;001;003;02;416;205;211
022;002;001;003;03;416;208;208
022;002;001;003;04;416;229;187
022;002;001;003;05;416;218;198
022;002;001;003;06;416;222;194
022;002;001;003;07;416;219;197
022;002;001;003;08;414;212;202
022;002;001;004;01;400;200;200
022;002;001;004;02;400;213;187
022;002;001;004;03;400;207;193
022;002;001;004;04;400;197;203
022;002;001;004;05;394;213;181
022;002;001;005;01;440;223;217
022;002;001;005;02;440;236;204
022;002;001;005;03;434;219;215
022;002;001;005;04;432;224;208
022;002;001;005;05;432;224;208
022;002;001;005;06;432;226;206
022;002;001;005;07;432;221;211
022;002;001;006;01;416;200;216
022;002;001;006;02;416;207;209
022;002;001;006;03;416;212;204
022;002;001;006;04;416;196;220
022;002;001;006;05;412;178;234
022;002;001;006;06;408;208;200
022;002;001;006;07;408;203;205
022;002;001;006;08;408;192;216
022;002;001;006;09;408;181;227
022;002;001;006;10;408;210;198
022;002;001;006;11;408;226;182
022;002;001;007;01;405;204;201
022;002;001;007;02;400;208;192
022;002;001;007;03;400;206;194
022;002;001;007;04;400;205;195
022;002;001;007;05;400;203;197
022;002;001;007;06;400;178;222
022;002;001;007;07;400;220;180
022;002;001;007;08;400;202;198
022;002;001;008;01;432;193;239
022;002;001;008;02;432;241;191
022;002;001;008;03;432;220;212
022;002;001;008;04;432;208;224
022;002;001;008;05;432;206;226
022;002;001;008;06;424;212;212
022;002;001;008;07;424;224;200
022;002;001;008;08;424;223;201
022;002;001;008;09;424;214;210
022;002;001;008;10;424;202;222
022;002;001;008;11;424;187;237
022;002;001;008;12;424;193;231
022;002;001;008;13;424;233;191
022;002;001;008;14;424;219;205
022;002;001;008;15;424;234;190
022;002;001;009;01;432;223;209
022;002;001;009;02;432;229;203
022;002;001;009;03;432;248;184
022;002;001;009;04;432;233;199
022;002;001;009;05;432;214;218
022;002;001;009;06;429;221;208
022;002;001;009;07;424;198;226
022;002;001;009;08;424;248;176
022;002;001;009;09;424;248;176
022;002;001;010;01;424;215;209
022;002;001;010;02;424;215;209
022;002;001;010;03;424;231;193
022;002;001;010;04;424;217;207
022;002;001;010;05;423;199;224
022;002;001;010;06;416;215;201
022;002;001;010;07;416;220;196
022;002;001;010;08;416;219;197
022;002;001;011;01;416;232;184
022;002;001;011;02;416;260;156
022;002;001;011;03;416;221;195
022;002;001;011;04;416;223;193
022;002;001;011;05;413;237;176
022;002;001;011;06;408;241;167
022;002;001;012;01;441;267;174
022;002;001;012;02;440;278;162
022;002;001;012;03;440;247;193
022;002;001;012;04;440;262;178
022;002;001;013;01;422;273;149
022;002;001;014;01;344;170;174
022;002;001;014;02;344;184;160
022;002;001;014;03;343;190;153
022;002;001;014;04;336;197;139
022;002;001;015;01;416;205;211
022;002;001;015;02;416;208;208
022;002;001;015;03;414;210;204
022;002;001;015;04;408;197;211
022;002;001;016;01;416;212;204
022;002;001;016;02;408;208;200
022;002;001;016;03;408;203;205
022;002;001;016;04;408;174;234
022;002;001;016;05;408;198;210
022;002;001;017;01;408;210;198
022;002;001;017;02;408;205;203
022;002;001;017;03;408;190;218
022;002;001;017;04;408;203;205
022;002;001;017;05;402;194;208
022;002;001;018;01;408;202;206
022;002;001;018;02;408;211;197
022;002;001;018;03;408;196;212
022;002;001;018;04;408;183;225
022;002;001;018;05;403;184;219
022;002;001;019;01;360;197;163
022;002;001;020;01;392;201;191
022;002;001;020;02;392;212;180
022;002;001;020;03;392;198;194
022;002;001;020;04;391;188;203
022;002;001;020;05;384;191;193
022;002;001;020;06;384;195;189
022;002;001;020;07;384;193;191
022;002;001;021;01;376;203;173
022;002;001;021;02;376;199;177
022;002;001;021;03;376;193;183
022;002;001;021;04;376;224;152
022;002;001;021;05;374;211;163
022;002;001;022;01;416;219;197
022;002;001;022;02;416;219;197
022;002;001;022;03;416;228;188
022;002;001;022;04;416;187;229
022;002;001;022;05;410;199;211
022;002;001;022;06;408;211;197
022;002;001;022;07;408;179;229
022;002;001;022;08;408;220;188
022;002;001;022;09;408;213;195
022;002;001;022;10;408;244;164
022;002;001;023;01;432;215;217
022;002;001;023;02;432;234;198
022;002;001;023;03;432;228;204
022;002;001;023;04;432;212;220
022;002;001;023;05;432;239;193
022;002;001;023;06;432;224;208
022;002;001;023;07;425;205;220
022;002;001;023;08;424;232;192
022;002;001;023;09;424;224;200
022;002;001;023;10;424;227;197
022;002;001;024;01;404;191;213
022;002;001;024;02;400;199;201
022;002;001;024;03;400;182;218
022;002;001;024;04;400;193;207
022;002;001;024;05;400;205;195
022;002;001;024;06;400;180;220
022;002;001;024;07;400;218;182
022;002;001;024;08;400;199;201
022;002;001;025;01;392;194;198
022;002;001;025;02;392;188;204
022;002;001;025;03;392;205;187
022;002;001;025;04;392;187;205
022;002;001;025;05;385;197;188
022;002;001;026;01;96;48;48
022;002;001;027;01;336;170;166
022;002;001;027;02;336;162;174
022;002;001;027;03;330;157;173
022;002;001;028;01;358;161;197
022;002;001;028;02;352;177;175
022;002;001;028;03;352;165;187
022;002;001;028;04;352;169;183
022;002;001;029;01;384;173;211
022;002;001;029;02;384;211;173
022;002;001;029;03;384;197;187
022;002;001;029;04;384;189;195
022;002;001;029;05;384;189;195
022;002;001;029;06;378;201;177
022;002;001;030;01;408;201;207
022;002;001;030;02;408;176;232
022;002;001;030;03;404;194;210
022;002;001;031;01;408;195;213
022;002;001;031;02;408;198;210
022;002;001;031;03;408;212;196
022;002;001;031;04;408;214;194
022;002;001;031;05;402;208;194
022;002;001;031;06;400;193;207
022;002;001;032;01;336;178;158
022;002;001;032;02;334;162;172
022;002;001;033;01;330;165;165
022;002;001;034;01;422;245;177
022;002;001;035;01;312;159;153
022;002;001;035;02;309;160;149
022;002;001;035;03;304;161;143
022;002;001;036;01;352;157;195
022;002;001;036;02;350;171;179
022;002;001;037;01;248;132;116
022;002;001;038;01;384;219;165
022;002;001;038;02;384;207;177
022;002;001;038;03;383;205;178
022;002;001;040;01;316;176;140
022;002;001;041;01;412;229;183
022;002;001;041;02;408;220;188
022;002;001;042;01;368;217;151
022;002;001;042;02;368;207;161
022;002;001;042;03;363;198;165
022;002;001;043;01;448;205;243
022;002;001;043;02;448;177;271
022;002;001;043;03;445;199;246
022;002;001;044;01;414;255;159
022;002;001;048;01;288;166;122
022;002;001;048;02;287;153;134
022;002;001;054;01;398;238;160
022;002;001;055;01;71;38;33
022;002;001;056;01;114;59;55
022;002;001;058;01;247;115;132
022;002;001;060;01;372;190;182
022;002;001;061;01;88;47;41
022;002;001;062;01;175;87;88
022;002;001;063;01;164;87;77
022;002;001;064;01;211;128;83
022;002;001;065;01;374;153;221
022;002;001;067;01;241;145;96
022;002;001;068;01;289;169;120
022;002;098;001;01;248;121;127
022;002;098;001;02;240;122;118
022;002;098;002;01;264;139;125
022;002;098;002;02;256;141;115
022;002;098;003;01;441;259;182
022;002;098;004;01;313;177;136
022;002;098;004;02;312;153;159
022;002;098;005;01;368;183;185
022;002;098;005;02;363;181;182
022;002;098;006;01;416;200;216
022;002;098;006;02;416;194;222
022;002;098;006;03;416;232;184
022;002;098;006;04;411;218;193
022;002;098;006;05;408;195;213
022;002;098;006;06;408;214;194
022;002;098;007;01;406;225;181
022;002;098;008;01;440;196;244
022;002;098;008;02;440;233;207
022;002;098;008;03;440;223;217
022;002;098;008;04;440;220;220
022;002;098;008;05;440;221;219
022;002;098;008;06;435;223;212
022;002;098;009;01;392;210;182
022;002;098;009;02;392;247;145
022;002;098;009;03;389;229;160
022;002;098;009;04;384;248;136
022;002;098;010;01;272;145;127
022;002;098;011;01;353;181;172
022;002;098;011;02;352;214;138
022;002;098;011;03;352;214;138
022;002;098;012;01;345;204;141
022;002;098;014;01;169;98;71
022;002;098;015;01;388;230;158
022;003;001;001;01;432;238;194
022;003;001;001;02;432;233;199
022;003;001;001;03;432;245;187
022;003;001;001;04;425;239;186
022;003;001;001;05;424;200;224
022;003;001;001;06;424;223;201
022;003;001;001;07;424;238;186
022;003;001;001;08;424;243;181
022;003;001;002;01;416;205;211
022;003;001;002;02;416;210;206
022;003;001;002;03;416;208;208
022;003;001;002;04;416;201;215
022;003;001;002;05;416;200;216
022;003;001;002;06;412;221;191
022;003;001;003;01;448;196;252
022;003;001;003;02;448;219;229
022;003;001;003;03;440;225;215
022;003;001;003;04;440;211;229
022;003;001;003;05;440;216;224
022;003;001;003;06;440;229;211
022;003;001;004;01;440;213;227
022;003;001;004;02;432;197;235
022;003;001;004;03;432;222;210
022;003;001;004;04;432;207;225
022;003;001;004;05;432;218;214
022;003;001;004;06;432;218;214
022;003;001;004;07;432;214;218
022;003;001;005;01;432;220;212
022;003;001;005;02;432;231;201
022;003;001;005;03;432;217;215
022;003;001;005;04;432;229;203
022;003;001;005;05;432;214;218
022;003;001;005;06;432;215;217
022;003;001;005;07;427;226;201
022;003;001;005;08;424;230;194
022;003;001;006;01;400;213;187
022;003;001;006;02;400;235;165
022;003;001;006;03;400;192;208
022;003;001;006;04;400;207;193
022;003;001;006;05;393;221;172
022;003;001;007;01;376;222;154
022;003;001;007;02;376;212;164
022;003;001;007;03;376;195;181
022;003;001;007;04;376;195;181
022;003;001;007;05;376;206;170
022;003;001;007;06;371;190;181
022;003;001;008;01;432;207;225
022;003;001;008;02;432;198;234
022;003;001;008;03;424;224;200
022;003;001;008;04;424;210;214
022;003;001;008;05;424;204;220
022;003;001;008;06;424;199;225
022;003;001;008;07;424;222;202
022;003;001;008;08;424;215;209
022;003;001;009;01;368;207;161
022;003;001;009;02;368;226;142
022;003;001;009;03;368;217;151
022;003;001;009;04;362;212;150
022;003;001;010;01;440;210;230
022;003;001;010;02;440;252;188
022;003;001;010;03;440;238;202
022;003;001;010;04;440;210;230
022;003;001;010;05;440;230;210
022;003;001;010;06;440;240;200
022;003;001;010;07;432;252;180
022;003;001;011;01;432;215;217
022;003;001;011;02;432;217;215
022;003;001;011;03;425;230;195
022;003;001;011;04;424;199;225
022;003;001;011;05;424;220;204
022;003;001;011;06;424;212;212
022;003;001;011;07;424;214;210
022;003;001;012;01;432;244;188
022;003;001;012;02;428;250;178
022;003;001;012;03;424;239;185
022;003;001;012;04;424;244;180
022;003;001;013;01;416;198;218
022;003;001;013;02;416;194;222
022;003;001;013;03;416;196;220
022;003;001;013;04;416;241;175
022;003;001;013;05;411;194;217
022;003;001;013;06;408;214;194
022;003;001;014;01;432;230;202
022;003;001;014;02;432;220;212
022;003;001;014;03;432;234;198
022;003;001;014;04;432;223;209
022;003;001;014;05;432;220;212
022;003;001;014;06;432;201;231
022;003;001;014;07;428;218;210
022;003;001;014;08;424;212;212
022;003;001;014;09;424;216;208
022;003;001;015;01;320;169;151
022;003;001;015;02;316;151;165
022;003;001;016;01;264;127;137
022;003;001;016;02;256;137;119
022;003;001;017;01;272;134;138
022;003;001;017;02;269;133;136
022;003;001;018;01;408;205;203
022;003;001;018;02;408;230;178
022;003;001;018;03;408;214;194
022;003;001;018;04;408;214;194
022;003;001;018;05;404;221;183
022;003;001;018;06;400;196;204
022;003;001;018;07;400;220;180
022;003;001;018;08;400;204;196
022;003;001;019;01;408;224;184
022;003;001;019;02;408;216;192
022;003;001;019;03;405;227;178
022;003;001;020;01;448;267;181
022;003;001;020;02;440;246;194
022;003;001;021;01;398;195;203
022;003;001;022;01;365;187;178
022;003;001;023;01;141;89;52
022;003;001;024;01;401;201;200
022;003;001;024;02;400;212;188
022;003;001;025;01;258;144;114
022;003;001;025;02;256;138;118
022;003;001;026;01;384;220;164
022;003;001;026;02;384;236;148
022;003;001;026;03;384;197;187
022;003;001;026;04;381;210;171
022;003;001;026;05;376;198;178
022;003;001;026;06;376;209;167
022;003;001;027;01;400;205;195
022;003;001;027;02;393;225;168
022;003;001;027;03;392;226;166
022;003;001;027;04;392;217;175
022;003;001;027;05;392;221;171
022;003;001;027;06;392;220;172
022;003;001;028;01;440;215;225
022;003;001;028;02;440;206;234
022;003;001;028;03;440;219;221
022;003;001;028;04;438;234;204
022;003;001;028;05;432;231;201
022;003;001;028;06;432;252;180
022;003;001;028;07;432;220;212
022;003;001;028;08;432;224;208
022;003;001;028;09;432;219;213
022;003;001;029;01;360;202;158
022;003;001;029;02;360;197;163
022;003;001;029;03;358;198;160
022;003;001;030;01;368;202;166
022;003;001;030;02;365;196;169
022;003;001;030;03;360;189;171
022;003;001;031;01;367;196;171
022;003;001;031;02;360;192;168
022;003;001;032;01;350;183;167
022;003;001;032;02;344;177;167
022;003;001;032;03;344;180;164
022;003;001;033;01;256;129;127
022;003;001;033;02;254;116;138
022;003;001;034;01;350;171;179
022;003;001;034;02;344;172;172
022;003;001;035;01;259;126;133
022;003;001;035;02;256;133;123
022;003;001;036;01;289;133;156
022;003;001;037;01;187;80;107
022;003;001;038;01;222;108;114
022;003;001;039;01;208;122;86
022;003;001;040;01;278;129;149
022;003;001;041;01;257;118;139
022;003;001;041;02;256;116;140
022;003;001;042;01;79;38;41
022;003;001;043;01;64;38;26
022;003;001;044;01;277;142;135
022;003;001;045;01;86;43;43
022;003;001;046;01;101;53;48
022;003;001;047;01;337;195;142
022;003;001;047;02;336;167;169
022;003;001;049;01;340;174;166
022;003;098;001;01;439;226;213
022;003;098;002;01;376;167;209
022;003;098;002;02;373;168;205
022;003;098;002;03;368;155;213
022;003;098;002;04;368;187;181
022;003;098;003;01;376;200;176
022;003;098;003;02;371;189;182
022;003;098;004;01;249;129;120
022;003;098;004;02;248;113;135
022;003;098;005;01;372;211;161
022;004;001;001;01;434;207;227
022;004;001;001;02;432;219;213
022;004;001;001;03;432;210;222
022;004;001;001;04;432;220;212
022;004;001;002;01;287;157;130
022;004;001;002;02;280;133;147
022;004;001;003;01;349;173;176
022;004;001;003;02;344;167;177
022;004;001;003;03;344;181;163
022;004;001;003;04;344;164;180
022;004;001;004;01;360;178;182
022;004;001;004;02;356;177;179
022;004;001;005;01;336;161;175
022;004;001;005;02;330;171;159
022;004;001;006;01;438;219;219
022;004;001;006;02;432;238;194
022;004;001;007;01;448;220;228
022;004;001;007;02;448;234;214
022;004;001;007;03;448;237;211
022;004;001;007;04;444;218;226
022;004;001;008;01;392;221;171
022;004;001;008;02;392;221;171
022;004;001;008;03;386;217;169
022;004;001;009;01;424;216;208
022;004;001;009;02;420;207;213
022;004;001;010;01;320;193;127
022;004;001;010;02;320;195;125
022;004;001;010;03;318;187;131
022;004;001;011;01;296;158;138
022;004;001;011;02;291;162;129
022;004;001;012;01;248;161;87
022;004;001;012;02;248;160;88
022;004;001;013;01;320;193;127
022;004;001;013;02;318;180;138
022;004;001;013;03;312;168;144
022;004;001;014;01;368;174;194
022;004;001;014;02;368;186;182
022;004;001;014;03;360;175;185
022;004;001;014;04;360;178;182
022;004;001;014;05;360;174;186
022;004;001;015;01;400;195;205
022;004;001;015;02;398;191;207
022;004;001;015;03;392;197;195
022;004;001;015;04;392;191;201
022;004;001;016;01;392;195;197
022;004;001;016;02;385;227;158
022;004;001;017;01;408;205;203
022;004;001;017;02;408;201;207
022;004;001;017;03;408;194;214
022;004;001;017;04;405;208;197
022;004;001;018;01;376;189;187
022;004;001;018;02;376;176;200
022;004;001;019;01;360;172;188
022;004;001;019;02;359;149;210
022;004;001;020;01;416;221;195
022;004;001;020;02;410;194;216
022;004;001;020;03;408;160;248
022;004;001;020;04;408;188;220
022;004;001;020;05;408;193;215
022;004;001;020;06;408;164;244
022;004;001;020;07;408;209;199
022;004;001;020;08;408;196;212
022;004;001;020;09;408;224;184
022;004;001;021;01;416;185;231
022;004;001;021;02;408;177;231
022;004;001;021;03;408;185;223
022;004;001;021;04;408;188;220
022;004;001;021;05;408;193;215
022;004;001;022;01;440;231;209
022;004;001;022;02;434;199;235
022;004;001;022;03;432;206;226
022;004;001;022;04;432;250;182
022;004;001;023;01;301;189;112
022;004;001;024;01;434;219;215
022;004;001;024;02;432;222;210
022;004;001;024;03;432;200;232
022;004;001;024;04;432;196;236
022;004;001;025;01;304;152;152
022;004;001;025;02;304;166;138
022;004;001;025;03;299;157;142
022;004;001;026;01;258;136;122
022;004;001;027;01;242;119;123
022;004;001;027;02;240;131;109
022;004;001;028;01;441;211;230
022;004;001;028;02;440;187;253
022;004;001;028;03;440;199;241
022;004;001;029;01;304;170;134
022;004;001;029;02;304;179;125
022;004;001;029;03;302;173;129
022;004;001;030;01;350;214;136
022;004;001;031;01;419;192;227
022;004;001;031;02;416;184;232
022;004;001;031;03;416;205;211
022;004;001;031;04;416;197;219
022;004;001;032;01;336;186;150
022;004;001;032;02;328;172;156
022;004;001;032;03;328;186;142
022;004;001;033;01;319;169;150
022;004;001;034;01;246;127;119
022;004;001;035;01;167;93;74
022;004;001;036;01;203;129;74
022;004;001;037;01;322;135;187
022;004;001;037;02;320;150;170
022;004;098;001;01;272;141;131
022;004;098;001;02;264;143;121
022;004;098;002;01;328;164;164
022;004;098;002;02;320;161;159
022;004;098;003;01;340;179;161
022;004;098;004;01;304;170;134
022;004;098;004;02;298;168;130
022;004;098;005;01;304;160;144
022;004;098;005;02;304;161;143
022;004;098;005;03;300;159;141
022;004;098;006;01;208;129;79
022;004;098;007;01;339;179;160
022;004;098;008;01;312;167;145
022;004;098;008;02;304;160;144
022;004;098;009;01;217;154;63
022;004;098;010;01;376;211;165
022;004;098;010;02;376;207;169
022;004;098;010;03;369;203;166
022;004;098;010;04;368;207;161
022;005;098;001;01;231;120;111
022;005;098;002;01;218;148;70
022;005;098;003;01;390;208;182
022;005;098;003;02;384;193;191
022;005;098;003;03;384;206;178
022;005;098;003;04;384;202;182
022;005;098;004;01;368;182;186
022;005;098;004;02;365;188;177
022;005;098;005;01;403;185;218
022;005;098;005;02;400;223;177
022;005;098;005;03;400;211;189
022;005;098;006;01;432;203;229
022;005;098;006;02;432;202;230
022;005;098;006;03;427;203;224
022;005;098;006;04;424;206;218
022;005;098;007;01;321;169;152
022;005;098;008;01;336;165;171
022;005;098;008;02;328;171;157
022;005;098;008;03;328;156;172
022;005;098;009;01;364;198;166
022;005;098;010;01;113;69;44
022;005;098;011;01;376;219;157
022;005;098;011;02;373;200;173
023;001;001;001;01;435;245;190
023;001;001;001;02;432;201;231
023;001;001;001;03;432;236;196
023;001;001;001;04;432;222;210
023;001;001;002;01;392;215;177
023;001;001;002;02;392;192;200
023;001;001;002;03;392;199;193
023;001;001;002;04;389;236;153
023;001;001;002;05;384;218;166
023;001;001;002;06;384;215;169
023;001;001;003;01;312;149;163
023;001;001;003;02;308;172;136
023;001;001;004;01;447;231;216
023;001;001;004;02;440;224;216
023;001;001;005;01;448;236;212
023;001;001;005;02;447;237;210
023;001;001;006;01;428;215;213
023;001;001;006;02;424;199;225
023;001;001;008;01;352;194;158
023;001;001;008;02;352;195;157
023;001;001;008;03;352;185;167
023;001;001;008;04;344;175;169
023;001;098;002;01;416;178;238
023;001;098;003;01;124;65;59
023;001;098;004;01;350;179;171
023;002;098;001;01;401;213;188
023;002;098;002;01;336;171;165
023;002;098;002;02;329;171;158
023;002;098;003;01;304;155;149
023;002;098;003;02;298;159;139
023;002;098;004;01;344;156;188
023;002;098;004;02;344;187;157
023;002;098;004;03;344;177;167
023;002;098;004;04;342;186;156
023;002;098;005;01;276;147;129
023;002;098;006;01;275;142;133
023;002;098;006;02;272;147;125
023;002;098;007;01;424;188;236
023;002;098;007;02;423;252;171
023;002;098;008;01;440;234;206
023;002;098;008;02;440;226;214
023;002;098;008;03;440;218;222
023;002;098;008;04;439;237;202
023;002;098;009;01;343;164;179
023;002;098;009;02;336;162;174
023;002;098;010;01;344;172;172
023;002;098;010;02;337;171;166
023;002;098;010;03;336;186;150
023;002;098;011;01;320;135;185
023;002;098;011;02;320;135;185
023;002;098;011;03;314;138;176
023;002;098;012;01;440;191;249
023;002;098;012;02;439;203;236
023;002;098;013;01;360;170;190
023;002;098;013;02;359;175;184
023;002;098;013;03;352;146;206
023;002;098;014;01;273;125;148
023;002;098;015;01;422;195;227
023;002;098;016;01;188;97;91
023;002;098;017;01;358;169;189
023;002;098;018;01;119;64;55
024;004;001;001;01;432;205;227
024;004;001;001;02;432;200;232
024;004;001;001;03;427;224;203
024;004;001;001;04;424;213;211
024;004;001;002;01;440;236;204
024;004;001;002;02;440;209;231
024;004;001;002;03;440;189;251
024;004;001;002;04;435;222;213
024;004;001;002;05;432;200;232
024;004;001;002;06;432;221;211
024;004;001;002;07;432;231;201
024;004;001;003;01;440;222;218
024;004;001;003;02;440;192;248
024;004;001;003;03;440;217;223
024;004;001;003;04;440;231;209
024;004;001;003;05;440;209;231
024;004;001;003;06;440;195;245
024;004;001;003;07;440;235;205
024;004;001;003;08;433;222;211
024;004;001;004;01;440;239;201
024;004;001;004;02;440;230;210
024;004;001;004;03;438;224;214
024;004;001;004;04;432;216;216
024;004;001;004;05;432;238;194
024;004;001;005;01;416;211;205
024;004;001;005;02;416;204;212
024;004;001;005;03;416;195;221
024;004;001;005;04;416;234;182
024;004;001;005;05;416;158;258
024;004;001;005;06;416;224;192
024;004;001;005;07;416;207;209
024;004;001;005;08;416;224;192
024;004;001;005;09;416;181;235
024;004;001;005;10;414;208;206
024;004;001;005;11;408;198;210
024;004;001;005;12;408;205;203
024;004;001;006;01;416;219;197
024;004;001;006;02;416;228;188
024;004;001;006;03;409;208;201
024;004;001;006;04;408;213;195
024;004;001;006;05;408;212;196
024;004;001;006;06;408;220;188
024;004;001;006;07;408;220;188
024;004;001;006;08;408;212;196
024;004;001;007;01;424;230;194
024;004;001;007;02;424;216;208
024;004;001;007;03;422;245;177
024;004;001;007;04;416;230;186
024;004;001;007;05;416;217;199
024;004;001;007;06;416;222;194
024;004;001;007;07;416;210;206
024;004;001;007;08;416;234;182
024;004;001;007;09;416;202;214
024;004;001;007;10;416;217;199
024;004;001;008;01;432;202;230
024;004;001;008;02;432;194;238
024;004;001;008;03;432;202;230
024;004;001;008;04;432;205;227
024;004;001;008;05;432;186;246
024;004;001;008;06;432;226;206
024;004;001;008;07;429;219;210
024;004;001;008;08;424;190;234
024;004;001;008;09;424;219;205
024;004;001;009;01;440;219;221
024;004;001;009;02;440;224;216
024;004;001;009;03;440;232;208
024;004;001;009;04;440;204;236
024;004;001;009;05;439;232;207
024;004;001;009;06;432;210;222
024;004;001;009;07;432;213;219
024;004;001;009;08;432;229;203
024;004;001;009;09;432;237;195
024;004;001;009;10;432;218;214
024;004;001;009;11;432;218;214
024;004;001;009;12;432;213;219
024;004;001;010;01;432;229;203
024;004;001;010;02;432;244;188
024;004;001;010;03;432;251;181
024;004;001;010;04;432;211;221
024;004;001;010;05;432;230;202
024;004;001;010;06;425;228;197
024;004;001;010;07;424;231;193
024;004;001;011;01;432;213;219
024;004;001;011;02;432;225;207
024;004;001;011;03;432;236;196
024;004;001;011;04;430;200;230
024;004;001;011;05;424;215;209
024;004;001;011;06;424;182;242
024;004;001;011;07;424;191;233
024;004;001;011;08;424;240;184
024;004;001;011;09;424;233;191
024;004;001;011;10;424;201;223
024;004;001;011;11;424;177;247
024;004;001;011;12;424;244;180
024;004;001;012;01;424;203;221
024;004;001;012;02;424;230;194
024;004;001;012;03;424;208;216
024;004;001;012;04;424;229;195
024;004;001;012;05;416;176;240
024;004;001;012;06;416;230;186
024;004;001;012;07;416;223;193
024;004;001;012;08;416;174;242
024;004;001;012;09;416;247;169
024;004;001;012;10;416;228;188
024;004;001;013;01;392;204;188
024;004;001;013;02;392;227;165
024;004;001;013;03;392;211;181
024;004;001;013;04;392;166;226
024;004;001;013;05;392;222;170
024;004;001;013;06;392;210;182
024;004;001;013;07;390;202;188
024;004;001;014;01;400;233;167
024;004;001;014;02;400;241;159
024;004;001;014;03;400;208;192
024;004;001;014;04;394;226;168
024;004;001;014;05;392;211;181
024;004;001;015;01;448;213;235
024;004;001;015;02;448;186;262
024;004;001;015;03;448;259;189
024;004;001;015;04;448;195;253
024;004;001;015;05;448;169;279
024;004;001;015;06;440;244;196
024;004;001;015;07;440;235;205
024;004;001;015;08;440;197;243
024;004;001;016;01;384;172;212
024;004;001;016;02;384;156;228
024;004;001;016;03;380;200;180
024;004;001;016;04;376;158;218
024;004;001;016;05;376;190;186
024;004;001;016;06;376;172;204
024;004;001;017;01;416;197;219
024;004;001;017;02;416;187;229
024;004;001;017;03;416;198;218
024;004;001;017;04;416;207;209
024;004;001;017;05;414;191;223
024;004;001;017;06;408;202;206
024;004;001;018;01;432;204;228
024;004;001;018;02;432;195;237
024;004;001;018;03;432;207;225
024;004;001;018;04;428;146;282
024;004;001;018;05;424;187;237
024;004;001;018;06;424;184;240
024;004;001;018;07;424;183;241
024;004;001;019;01;408;207;201
024;004;001;019;02;408;158;250
024;004;001;019;03;408;183;225
024;004;001;019;04;408;180;228
024;004;001;019;05;404;198;206
024;004;001;020;01;393;233;160
024;004;001;020;02;392;230;162
024;004;001;020;03;392;204;188
024;004;001;020;04;392;252;140
024;004;001;021;01;426;221;205
024;004;001;021;02;424;222;202
024;004;001;021;03;424;182;242
024;004;001;021;04;424;196;228
024;004;001;021;05;424;208;216
024;004;001;021;06;424;196;228
024;004;001;021;07;424;213;211
024;004;001;022;01;416;235;181
024;004;001;022;02;416;195;221
024;004;001;022;03;416;234;182
024;004;001;022;04;414;217;197
024;004;001;023;01;392;215;177
024;004;001;023;02;386;167;219
024;004;001;023;03;384;186;198
024;004;001;023;04;384;191;193
024;004;001;023;05;384;184;200
024;004;001;023;06;384;215;169
024;004;001;024;01;392;207;185
024;004;001;024;02;392;220;172
024;004;001;024;03;387;204;183
024;004;001;024;04;384;225;159
024;004;001;025;01;352;175;177
024;004;001;025;02;352;169;183
024;004;001;025;03;348;181;167
024;004;001;025;04;344;180;164
024;004;001;026;01;432;329;103
024;004;001;026;02;432;292;140
024;004;001;026;03;432;291;141
024;004;001;026;04;425;299;126
024;004;001;026;05;424;306;118
024;004;001;027;01;397;279;118
024;004;001;027;02;392;262;130
024;004;001;027;03;392;268;124
024;004;001;027;04;392;256;136
024;004;001;027;05;392;268;124
024;004;001;027;06;392;262;130
024;004;001;028;01;440;227;213
024;004;001;028;02;436;236;200
024;004;001;029;01;384;211;173
024;004;001;029;02;378;186;192
024;004;001;029;03;376;203;173
024;004;001;030;01;320;160;160
024;004;001;030;02;314;165;149
024;004;001;030;03;312;174;138
024;004;001;031;01;392;200;192
024;004;001;031;02;392;212;180
024;004;001;031;03;386;199;187
024;004;001;032;01;311;149;162
024;004;001;032;02;304;161;143
024;004;001;032;03;304;162;142
024;004;001;033;01;416;181;235
024;004;001;033;02;415;193;222
024;004;001;033;03;408;223;185
024;004;001;033;04;408;186;222
024;004;001;033;05;408;205;203
024;004;001;034;01;400;201;199
024;004;001;034;02;400;201;199
024;004;001;034;03;400;209;191
024;004;001;034;04;394;199;195
024;004;001;034;05;392;199;193
024;004;001;034;06;392;198;194
024;004;001;035;01;440;228;212
024;004;001;035;02;440;211;229
024;004;001;036;01;345;199;146
024;004;001;037;01;344;180;164
024;004;001;037;02;344;193;151
024;004;001;037;03;340;180;160
024;004;001;037;04;336;177;159
024;004;001;038;01;422;202;220
024;004;001;038;02;416;216;200
024;004;001;038;03;416;230;186
024;004;001;039;01;320;158;162
024;004;001;039;02;315;174;141
024;004;001;039;03;312;183;129
024;004;001;040;01;416;205;211
024;004;001;040;02;416;234;182
024;004;001;040;03;408;203;205
024;004;001;041;01;443;225;218
024;004;001;041;02;440;243;197
024;004;001;041;03;440;242;198
024;004;001;041;04;440;240;200
024;004;001;042;01;432;232;200
024;004;001;042;02;430;249;181
024;004;001;042;03;424;231;193
024;004;001;042;04;424;179;245
024;004;001;042;05;424;263;161
024;004;001;042;06;424;222;202
024;004;001;042;07;424;181;243
024;004;001;042;08;424;203;221
024;004;001;042;09;424;238;186
024;004;001;042;10;424;226;198
024;004;001;042;11;424;222;202
024;004;001;043;01;408;214;194
024;004;001;043;02;407;215;192
024;004;001;043;03;400;206;194
024;004;001;043;04;400;200;200
024;004;001;043;05;400;208;192
024;004;001;043;06;400;220;180
024;004;001;043;07;400;203;197
024;004;001;044;01;401;179;222
024;004;001;044;02;400;193;207
024;004;001;045;01;392;199;193
024;004;001;045;02;392;177;215
024;004;001;045;03;392;187;205
024;004;001;045;04;392;167;225
024;004;001;045;05;386;170;216
024;004;001;045;06;384;183;201
024;004;001;046;01;450;236;214
024;004;001;046;02;450;198;252
024;004;001;046;03;450;230;220
024;004;001;046;04;450;230;220
024;004;001;047;01;429;192;237
024;004;001;047;02;424;183;241
024;004;001;047;03;424;223;201
024;004;001;047;04;424;175;249
024;004;001;047;05;424;200;224
024;004;001;047;06;424;237;187
024;004;001;047;07;424;202;222
024;004;001;047;08;424;203;221
024;004;001;048;01;370;186;184
024;004;001;049;01;448;233;215
024;004;001;049;02;441;232;209
024;004;001;049;03;440;221;219
024;004;001;050;01;408;237;171
024;004;001;050;02;408;222;186
024;004;001;050;03;408;208;200
024;004;001;050;04;402;205;197
024;004;001;050;05;400;200;200
024;004;001;050;06;400;200;200
024;004;001;050;07;400;212;188
024;004;001;050;08;400;201;199
024;004;001;050;09;400;221;179
024;004;001;051;01;256;117;139
024;004;001;051;02;252;121;131
024;004;001;052;01;431;221;210
024;004;001;052;02;424;215;209
024;004;098;001;01;360;199;161
024;004;098;001;02;356;176;180
024;004;098;002;01;286;135;151
024;004;098;003;01;135;74;61
024;004;098;004;01;376;175;201
024;004;098;004;02;376;170;206
024;004;098;004;03;369;203;166
024;004;098;005;01;67;30;37
024;004;098;006;01;249;116;133
024;004;098;006;02;248;142;106
024;004;098;007;01;350;196;154
024;004;098;008;01;313;189;124
024;004;098;008;02;312;200;112
024;004;098;009;01;221;100;121
024;004;098;010;01;274;132;142
024;004;098;011;01;287;145;142
024;004;098;012;01;392;183;209
024;004;098;012;02;389;191;198
024;004;098;013;01;208;116;92
024;004;098;014;01;282;154;128
024;004;098;015;01;187;104;83
024;004;098;016;01;222;121;101
024;004;098;017;01;354;175;179
024;004;098;018;01;350;142;208
024;004;098;018;02;344;175;169
024;004;098;019;01;286;144;142
024;004;098;019;02;280;164;116
024;004;098;020;01;181;107;74
024;004;098;021;01;448;247;201
024;004;098;021;02;448;230;218
024;004;098;021;03;448;226;222
024;004;098;021;04;448;228;220
024;004;098;021;05;448;247;201
024;004;098;022;01;155;82;73
024;004;098;023;01;109;49;60
024;005;098;001;01;403;216;187
024;005;098;002;01;407;220;187
024;005;098;003;01;376;205;171
024;005;098;003;02;376;181;195
024;005;098;003;03;368;216;152
024;005;098;004;01;355;192;163
024;005;098;005;01;352;184;168
024;005;098;005;02;352;171;181
024;005;098;005;03;346;186;160
024;005;098;006;01;330;200;130
024;005;098;007;01;353;212;141
024;005;098;008;01;264;127;137
024;005;098;008;02;261;134;127
024;005;098;009;01;340;190;150
024;005;098;010;01;353;171;182
024;005;098;011;01;240;113;127
024;005;098;011;02;237;136;101
024;005;098;012;01;169;101;68
024;005;098;013;01;320;164;156
024;005;098;013;02;314;176;138
024;005;098;014;01;352;178;174
024;005;098;014;02;348;186;162
024;005;098;015;01;352;178;174
024;005;098;015;02;352;187;165
024;005;098;015;03;345;189;156
024;005;098;016;01;239;132;107
024;005;098;016;02;232;132;100
025;003;001;001;01;376;186;190
025;003;001;001;02;370;156;214
025;003;001;001;03;368;190;178
025;003;001;002;01;344;169;175
025;003;001;002;02;343;190;153
025;003;001;002;03;336;131;205
025;003;001;002;04;336;189;147
025;003;001;003;01;259;123;136
025;003;001;004;01;253;130;123
025;003;001;004;02;248;105;143
025;003;001;005;01;245;118;127
025;003;001;005;02;240;110;130
025;003;001;006;01;291;138;153
025;003;001;007;01;258;137;121
025;003;001;007;02;256;121;135
025;003;098;001;01;210;98;112
025;003;098;002;01;312;158;154
025;003;098;002;02;306;161;145
025;003;098;003;01;360;153;207
025;003;098;004;01;345;149;196
025;003;098;005;01;312;128;184
025;003;098;005;02;312;149;163
025;003;098;006;01;92;50;42
025;003;098;007;01;286;129;157
025;003;098;008;01;170;83;87
025;003;098;009;01;95;40;55
025;003;098;010;01;276;121;155
025;003;098;010;02;272;130;142
025;003;098;011;01;273;122;151
025;003;098;012;01;376;156;220
025;003;098;012;02;375;208;167
025;003;098;012;03;368;163;205
025;003;098;013;01;260;124;136
025;004;001;001;01;411;204;207
025;004;001;001;02;408;232;176
025;004;001;001;03;408;228;180
025;004;001;002;01;371;209;162
025;004;001;002;02;368;179;189
025;004;001;003;01;376;166;210
025;004;001;003;02;376;194;182
025;004;001;003;03;370;170;200
025;004;001;004;01;304;149;155
025;004;098;001;01;369;176;193
025;004;098;002;01;392;173;219
025;004;098;003;01;384;197;187
025;004;098;003;02;383;197;186
025;004;098;004;01;189;90;99
025;004;098;005;01;166;82;84
025;004;098;006;01;216;109;107
025;004;098;007;01;110;54;56
025;004;098;008;01;378;168;210
025;004;098;009;01;344;176;168
025;004;098;009;02;336;151;185
025;004;098;009;03;336;146;190
025;004;098;010;01;240;106;134
025;004;098;010;02;232;99;133
025;005;098;001;01;326;155;171
025;005;098;002;01;405;199;206
025;005;098;002;02;400;179;221
025;005;098;002;03;400;168;232
025;005;098;002;04;400;226;174
025;005;098;003;01;304;147;157
025;005;098;003;02;302;120;182
025;005;098;004;01;384;184;200
025;005;098;004;02;384;200;184
025;005;098;004;03;384;140;244
025;005;098;004;04;380;192;188
025;005;098;005;01;232;107;125
025;005;098;005;02;224;114;110
025;005;098;006;01;416;205;211
025;005;098;006;02;412;175;237
025;005;098;007;01;376;174;202
025;005;098;007;02;376;176;200
025;005;098;007;03;376;154;222
025;005;098;007;04;370;160;210
025;005;098;007;05;368;176;192
025;005;098;008;01;352;154;198
025;005;098;008;02;351;161;190
025;005;098;009;01;280;151;129
025;005;098;009;02;273;145;128
025;005;098;010;01;320;174;146
025;005;098;011;01;328;133;195
025;005;098;011;02;328;186;142
025;005;098;012;01;344;166;178
025;005;098;012;02;344;174;170
025;005;098;012;03;344;166;178
025;005;098;012;04;337;174;163
025;005;098;013;01;323;156;167
025;005;098;014;01;118;62;56
025;005;098;015;01;183;82;101
026;006;001;001;01;413;214;199
026;006;001;001;02;408;206;202
026;006;001;001;03;408;196;212
026;006;001;001;04;408;186;222
026;006;001;001;05;408;217;191
026;006;001;002;01;414;207;207
026;006;001;002;02;408;187;221
026;006;001;002;03;408;201;207
026;006;001;002;04;408;178;230
026;006;001;002;05;408;201;207
026;006;001;003;01;301;149;152
026;006;001;003;02;296;147;149
026;006;001;004;01;263;136;127
026;006;098;001;01;131;71;60
026;006;098;002;01;362;180;182
026;006;098;003;01;291;144;147
026;006;098;004;01;203;90;113
026;006;098;005;01;190;78;112
026;006;098;006;01;275;119;156
026;006;098;006;02;272;133;139
026;006;098;007;01;368;160;208
026;006;098;008;01;253;123;130
026;006;098;009;01;286;136;150
026;006;098;010;01;373;170;203
026;006;098;010;02;368;194;174
026;006;098;011;01;422;210;212
026;006;098;012;01;126;61;65
026;012;001;001;01;384;190;194
026;012;001;001;02;384;179;205
026;012;001;001;03;384;178;206
026;012;001;001;04;384;201;183
026;012;001;001;05;376;192;184
026;012;001;002;01;333;152;181
026;012;001;003;01;311;144;167
026;012;001;004;01;97;46;51
026;012;001;005;01;345;202;143
026;012;001;005;02;344;159;185
026;012;001;006;01;232;110;122
026;012;001;006;02;227;126;101
026;012;001;007;01;289;151;138
026;012;098;001;01;300;144;156
026;012;098;002;01;284;154;130
026;012;098;002;02;280;138;142
026;012;098;003;01;232;104;128
026;012;098;003;02;226;118;108
026;012;098;004;01;344;178;166
026;012;098;004;02;344;145;199
026;012;098;004;03;343;164;179
026;012;098;005;01;240;130;110
026;012;098;005;02;233;107;126
026;012;098;006;01;29;18;11
026;014;098;001;01;360;189;171
026;014;098;002;01;338;161;177
026;014;098;003;01;114;73;41
026;014;098;004;01;432;211;221
026;014;098;004;02;430;205;225
026;014;098;005;01;371;166;205
026;014;098;006;01;197;103;94
026;015;098;001;01;352;196;156
026;015;098;001;02;352;184;168
026;015;098;001;03;349;183;166
026;015;098;002;01;307;160;147
026;015;098;003;01;400;198;202
026;015;098;004;01;294;152;142
026;015;098;004;02;288;153;135
026;015;098;005;01;223;115;108
026;015;098;006;01;312;154;158
026;015;098;006;02;309;144;165
027;001;001;001;01;352;172;180
027;001;001;001;02;352;179;173
027;001;001;001;03;351;183;168
027;001;001;001;04;344;175;169
027;001;001;002;01;400;215;185
027;001;001;002;02;400;204;196
027;001;001;002;03;400;198;202
027;001;001;002;04;400;198;202
027;001;001;002;05;400;193;207
027;001;001;002;06;392;207;185
027;001;001;002;07;392;199;193
027;001;001;003;01;424;229;195
027;001;001;003;02;424;202;222
027;001;001;003;03;418;192;226
027;001;001;003;04;416;215;201
027;001;001;004;01;354;180;174
027;001;001;004;02;352;178;174
027;001;001;005;01;440;230;210
027;001;001;005;02;440;220;220
027;001;001;005;03;440;201;239
027;001;001;005;04;440;205;235
027;001;001;005;05;433;203;230
027;001;001;006;01;400;177;223
027;001;001;006;02;394;176;218
027;001;001;007;01;383;194;189
027;001;001;007;02;376;197;179
027;001;001;008;01;241;161;80
027;001;001;008;02;240;163;77
027;001;001;009;01;280;127;153
027;001;001;009;02;277;147;130
027;001;001;010;01;377;204;173
027;001;001;011;01;277;131;146
027;001;001;012;01;239;118;121
027;001;001;012;02;232;126;106
027;001;001;013;01;185;91;94
027;001;001;014;01;427;222;205
027;001;001;015;01;339;177;162
027;001;001;016;01;400;206;194
027;001;001;016;02;399;206;193
027;001;001;016;03;392;205;187
027;001;001;017;01;352;180;172
027;001;001;017;02;346;170;176
027;001;001;018;01;240;118;122
027;001;001;018;02;239;109;130
027;001;001;019;01;448;217;231
027;001;001;019;02;447;238;209
027;001;001;020;01;305;146;159
027;001;001;021;01;376;201;175
027;001;001;021;02;368;193;175
027;001;001;022;01;264;150;114
027;001;001;023;01;374;199;175
027;001;001;024;01;196;116;80
027;001;001;025;01;288;142;146
027;001;001;025;02;286;150;136
027;001;001;026;01;379;192;187
027;001;001;027;01;376;201;175
027;001;001;027;02;369;187;182
027;001;001;028;01;264;135;129
027;001;001;028;02;260;152;108
027;001;001;029;01;427;200;227
027;001;098;001;01;287;133;154
027;001;098;002;01;167;80;87
027;001;098;003;01;289;143;146
027;001;098;004;01;126;58;68
027;001;098;005;01;101;54;47
027;001;098;006;01;232;110;122
027;001;098;006;02;228;105;123
027;001;098;007;01;322;142;180
027;001;098;008;01;264;133;131
027;001;098;008;02;260;132;128
027;001;098;009;01;448;234;214
027;001;098;009;02;445;212;233
027;001;098;010;01;440;235;205
027;001;098;010;02;436;223;213
027;001;098;011;01;323;161;162
027;001;098;012;01;187;98;89
027;001;098;013;01;343;179;164
027;001;098;014;01;161;69;92
027;001;098;015;01;289;140;149
027;001;098;016;01;285;131;154
027;001;098;017;01;256;131;125
027;001;098;018;01;179;85;94
027;001;098;019;01;113;58;55
027;001;098;020;01;237;125;112
027;001;098;021;01;180;92;88
027;001;098;022;01;351;183;168
027;001;098;023;01;121;54;67
027;001;098;024;01;153;77;76
027;001;098;025;01;211;107;104
027;001;098;026;01;272;149;123
027;001;098;026;02;265;150;115
027;001;098;027;01;338;157;181
027;001;098;027;02;336;182;154
027;001;098;028;01;173;78;95
027;001;098;029;01;320;167;153
027;002;001;001;01;353;178;175
027;002;001;001;02;352;164;188
027;002;001;001;03;352;183;169
027;002;001;002;01;343;175;168
027;002;001;002;02;336;158;178
027;002;001;002;03;336;180;156
027;002;001;003;01;351;188;163
027;002;001;004;01;340;164;176
027;002;001;005;01;215;117;98
027;002;001;006;01;126;50;76
027;002;001;007;01;166;74;92
027;002;001;008;01;241;126;115
027;002;001;009;01;94;48;46
027;002;001;010;01;276;121;155
027;002;001;010;02;272;137;135
027;002;001;011;01;430;217;213
027;002;001;012;01;133;63;70
027;002;001;013;01;82;46;36
027;002;001;014;01;146;77;69
027;002;001;015;01;216;97;119
027;002;001;016;01;360;170;190
027;002;001;016;02;359;168;191
027;002;001;017;01;142;62;80
027;002;001;018;01;86;44;42
027;002;098;001;01;264;135;129
027;002;098;001;02;264;111;153
027;002;098;002;01;82;44;38
027;002;098;003;01;301;163;138
027;002;098;005;01;432;197;235
027;002;098;005;02;430;211;219
027;002;098;007;01;384;166;218
027;002;098;007;02;376;184;192
027;002;098;008;01;332;169;163
027;002;098;009;01;259;117;142
027;002;098;009;02;256;133;123
027;002;098;012;01;328;157;171
027;004;098;001;01;91;65;26
027;004;098;002;01;318;157;161
027;004;098;002;02;312;176;136
027;004;098;003;01;283;128;155
027;004;098;003;02;280;126;154
027;004;098;004;01;232;125;107
027;004;098;004;02;227;113;114
027;004;098;005;01;320;160;160
027;004;098;005;02;315;175;140
027;004;098;006;01;422;201;221
027;004;098;007;01;186;99;87
027;004;098;008;01;252;126;126
027;004;098;008;02;248;136;112
027;004;098;009;01;49;34;15
027;004;098;010;01;87;53;34
027;005;098;001;01;139;69;70
027;005;098;002;01;159;84;75
027;005;098;003;01;257;130;127
027;005;098;003;02;256;131;125
027;005;098;004;01;359;169;190
027;005;098;005;01;414;199;215
027;005;098;006;01;376;177;199
027;005;098;006;02;372;180;192
027;005;098;007;01;304;147;157
027;005;098;007;02;301;152;149
027;005;098;008;01;414;208;206
027;005;098;009;01;272;120;152
027;005;098;009;02;271;137;134
027;005;098;010;01;158;86;72
027;005;098;011;01;312;167;145
027;005;098;011;02;312;158;154
027;005;098;012;01;118;62;56
027;005;098;013;01;158;84;74
027;005;098;014;01;144;80;64
027;006;098;001;01;262;119;143
027;006;098;002;01;277;125;152
027;006;098;003;01;389;179;210
027;006;098;004;01;294;125;169
027;006;098;005;01;284;112;172
027;006;098;006;01;258;130;128
027;006;098;007;01;356;174;182
027;006;098;007;02;352;181;171
027;006;098;008;01;207;94;113
027;006;098;009;01;362;167;195
027;006;098;010;01;353;168;185
027;006;098;011;01;147;65;82
027;007;098;001;01;393;159;234
027;007;098;002;01;169;93;76
027;007;098;003;01;310;148;162
027;007;098;004;01;275;118;157
027;007;098;005;01;402;162;240
027;007;098;006;01;260;131;129
027;007;098;006;02;256;101;155
027;007;098;007;01;275;140;135
027;007;098;007;02;272;145;127
027;007;098;008;01;258;103;155
027;007;098;009;01;142;67;75
027;007;098;010;01;159;80;79
027;007;098;011;01;163;62;101
027;007;098;012;01;103;48;55
027;007;098;013;01;399;176;223
027;007;098;014;01;254;119;135
027;007;098;015;01;260;122;138
027;007;098;017;01;106;50;56
027;008;098;001;01;299;130;169
027;008;098;002;01;300;160;140
027;008;098;002;02;296;140;156
027;008;098;003;01;248;123;125
027;008;098;003;02;240;124;116
027;008;098;004;01;351;176;175
027;008;098;005;01;241;125;116
027;008;098;006;01;162;97;65
027;008;098;007;01;117;57;60
027;008;098;009;01;121;65;56
028;001;001;001;01;412;204;208
028;001;001;001;02;408;199;209
028;001;001;002;01;272;134;138
028;001;001;002;02;270;128;142
028;001;001;003;01;284;138;146
028;001;001;003;02;280;135;145
028;001;001;004;01;376;192;184
028;001;001;004;02;376;193;183
028;001;001;004;03;375;201;174
028;001;001;005;01;432;197;235
028;001;001;005;02;429;228;201
028;001;001;006;01;267;105;162
028;001;001;006;02;264;120;144
028;001;001;007;01;230;130;100
028;001;001;007;02;224;118;106
028;001;001;008;01;416;191;225
028;001;001;008;02;416;177;239
028;001;001;008;03;412;193;219
028;001;001;009;01;344;152;192
028;001;001;010;01;254;139;115
028;001;001;011;01;160;77;83
028;001;001;012;01;223;96;127
028;001;001;013;01;355;152;203
028;001;001;014;01;252;115;137
028;001;001;014;02;248;128;120
028;001;001;015;01;202;84;118
028;001;001;016;01;304;149;155
028;001;001;016;02;300;149;151
028;001;001;017;01;174;73;101
028;001;001;018;01;131;52;79
028;001;001;019;01;272;95;177
028;001;001;019;02;272;143;129
028;001;001;020;01;165;77;88
028;001;001;021;01;127;46;81
028;001;001;022;01;352;150;202
028;001;001;023;01;170;65;105
028;001;001;024;01;194;112;82
028;001;001;025;01;239;104;135
028;001;001;026;01;184;72;112
028;001;001;027;01;120;54;66
028;001;001;028;01;368;139;229
028;004;001;001;01;384;192;192
028;004;001;001;02;384;168;216
028;004;001;001;03;384;155;229
028;004;001;001;04;380;171;209
028;004;001;001;05;376;175;201
028;004;001;001;06;376;162;214
028;004;001;002;01;368;178;190
028;004;001;002;02;368;151;217
028;004;001;002;03;368;149;219
028;004;001;002;04;367;184;183
028;004;001;003;01;272;97;175
028;004;001;003;02;264;105;159
028;004;001;004;01;336;202;134
028;004;001;004;02;329;199;130
028;004;001;005;01;362;173;189
028;004;001;005;02;360;168;192
028;004;001;005;03;360;161;199
028;004;001;006;01;239;64;175
028;004;001;007;01;322;136;186
028;004;001;007;02;320;156;164
028;004;001;007;03;320;139;181
028;004;001;008;01;149;69;80
028;004;001;009;01;126;55;71
028;004;001;010;01;240;96;144
028;004;001;010;02;232;103;129
028;004;001;011;01;63;28;35
028;004;001;013;01;293;134;159
028;004;001;014;01;336;162;174
028;004;001;014;02;332;168;164
028;004;001;015;01;287;132;155
028;004;001;016;01;382;135;247
028;004;001;017;01;320;126;194
028;004;001;017;02;315;125;190
028;004;001;018;01;368;174;194
028;004;001;018;02;361;160;201
028;004;001;019;01;405;186;219
028;004;001;020;01;289;97;192
028;004;001;020;02;288;126;162
028;004;001;021;01;104;45;59
028;004;001;022;01;108;50;58
028;004;001;023;01;288;115;173
028;004;001;023;02;282;138;144
028;004;001;024;01;147;62;85
028;004;001;025;01;399;160;239
028;004;001;026;01;312;134;178
028;004;001;026;02;312;139;173
028;004;001;026;03;306;153;153
028;004;001;027;01;262;126;136
028;004;001;028;01;86;53;33
028;004;001;029;01;183;103;80
028;004;098;001;01;73;37;36
028;004;098;002;01;111;44;67
028;004;098;003;01;52;24;28
028;004;098;004;01;146;58;88
028;004;098;005;01;91;38;53
028;004;098;006;01;115;50;65
028;004;098;007;01;76;32;44
028;004;098;008;01;61;29;32
028;004;098;009;01;72;30;42
028;004;098;010;01;90;33;57
028;004;098;011;01;96;50;46
028;004;098;012;01;45;20;25
028;004;098;013;01;102;47;55
028;004;098;014;01;73;34;39
028;004;098;015;01;101;51;50
028;006;098;001;01;335;136;199
028;006;098;001;02;328;147;181
028;006;098;002;01;90;40;50
028;006;098;003;01;83;39;44
028;006;098;004;01;90;46;44
028;006;098;005;01;401;180;221
028;006;098;007;01;348;147;201
028;006;098;008;01;209;69;140
028;006;098;009;01;275;124;151
028;006;098;010;01;122;49;73
028;006;098;011;01;254;112;142
028;006;098;012;01;414;172;242
028;006;098;012;02;408;177;231
028;006;098;013;01;76;35;41
028;006;098;014;01;328;133;195
028;006;098;014;02;325;111;214
028;006;098;014;03;320;153;167
028;006;098;015;01;229;101;128
028;006;098;015;02;224;99;125
028;006;098;016;01;255;98;157
028;006;098;016;02;248;105;143
028;006;098;017;01;189;89;100
028;006;098;018;01;317;102;215
028;006;098;018;02;312;106;206
028;006;098;019;01;292;115;177
028;006;098;019;02;288;137;151
028;006;098;020;01;89;31;58
028;006;098;021;01;233;107;126
028;006;098;022;01;434;195;239
028;006;098;022;02;432;214;218
028;006;098;023;01;250;111;139
028;006;098;024;01;216;88;128
028;006;098;025;01;212;90;122
028;006;098;026;01;290;104;186
028;006;098;026;02;288;107;181
028;006;098;027;01;264;122;142
028;006;098;027;02;263;110;153
028;006;098;028;01;232;84;148
028;006;098;029;01;148;62;86
028;006;098;030;01;230;110;120
028;006;098;031;01;238;91;147
028;006;098;032;01;258;121;137
028;006;098;033;01;85;33;52
028;007;098;001;01;122;60;62
028;007;098;002;01;436;203;233
028;007;098;003;01;157;81;76
028;007;098;004;01;145;76;69
028;007;098;005;01;173;78;95
028;007;098;006;01;446;208;238
028;007;098;007;01;60;32;28
028;007;098;008;01;217;110;107
028;007;098;009;01;110;55;55
028;007;098;010;01;194;106;88
028;007;098;011;01;162;78;84
028;007;098;012;01;171;88;83
028;007;098;013;01;151;77;74
028;007;098;014;01;424;204;220
028;007;098;015;01;80;40;40
028;007;098;016;01;364;174;190
028;007;098;017;01;198;92;106
028;007;098;018;01;88;47;41
028;007;098;019;01;92;44;48
028;007;098;020;01;138;81;57
028;007;098;021;01;76;38;38
028;007;098;022;01;80;37;43
028;007;098;023;01;75;42;33
029;002;001;001;01;344;231;113
029;002;001;001;02;344;216;128
029;002;001;001;03;339;226;113
029;002;001;001;04;336;224;112
029;002;001;002;01;368;237;131
029;002;001;002;02;368;218;150
029;002;001;002;03;368;201;167
029;002;001;002;04;361;231;130
029;002;001;002;05;360;227;133
029;002;001;003;01;450;249;201
029;002;001;003;02;450;231;219
029;002;001;003;03;450;231;219
029;002;001;003;04;450;196;254
029;002;001;003;05;450;265;185
029;002;001;003;06;448;195;253
029;002;001;003;07;448;264;184
029;002;001;003;08;448;217;231
029;002;001;003;09;448;244;204
029;002;001;003;10;448;247;201
029;002;001;004;01;450;244;206
029;002;001;004;02;450;232;218
029;002;001;004;03;450;236;214
029;002;001;004;04;450;238;212
029;002;001;004;05;450;219;231
029;002;001;004;06;450;243;207
029;002;001;004;07;448;229;219
029;002;001;005;01;383;229;154
029;002;001;005;02;376;190;186
029;002;001;005;03;376;214;162
029;002;001;006;01;416;216;200
029;002;001;006;02;416;232;184
029;002;001;006;03;416;200;216
029;002;001;006;04;409;220;189
029;002;001;006;05;408;219;189
029;002;001;007;01;450;246;204
029;002;001;007;02;450;243;207
029;002;001;007;03;450;211;239
029;002;001;007;04;450;275;175
029;002;001;008;01;343;195;148
029;002;001;009;01;408;223;185
029;002;001;009;02;408;196;212
029;002;001;009;03;406;215;191
029;002;001;009;04;400;217;183
029;002;001;009;05;400;217;183
029;002;001;010;01;376;179;197
029;002;001;010;02;376;179;197
029;002;001;010;03;376;191;185
029;002;001;010;04;376;165;211
029;002;001;010;05;376;176;200
029;002;001;010;06;375;190;185
029;002;001;011;01;368;199;169
029;002;001;011;02;368;192;176
029;002;001;011;03;368;196;172
029;002;001;011;04;368;197;171
029;002;001;011;05;362;203;159
029;002;001;012;01;448;219;229
029;002;001;012;02;448;227;221
029;002;001;012;03;447;234;213
029;002;001;013;01;380;206;174
029;002;001;013;02;376;179;197
029;002;001;013;03;376;167;209
029;002;001;013;04;376;175;201
029;002;001;013;05;376;197;179
029;002;001;013;06;376;194;182
029;002;001;014;01;432;229;203
029;002;001;014;02;432;222;210
029;002;001;014;03;432;202;230
029;002;001;014;04;432;214;218
029;002;001;014;05;432;223;209
029;002;001;014;06;432;205;227
029;002;001;014;07;432;186;246
029;002;001;014;08;432;210;222
029;002;001;014;09;432;208;224
029;002;001;014;10;432;229;203
029;002;001;014;11;431;216;215
029;002;001;015;01;368;180;188
029;002;001;015;02;368;181;187
029;002;001;015;03;368;163;205
029;002;001;015;04;368;181;187
029;002;001;015;05;364;167;197
029;002;001;016;01;448;224;224
029;002;001;016;02;443;250;193
029;002;001;016;03;440;244;196
029;002;001;016;04;440;254;186
029;002;001;017;01;432;232;200
029;002;001;017;02;432;233;199
029;002;001;017;03;432;223;209
029;002;001;017;04;429;210;219
029;002;001;017;05;424;215;209
029;002;001;017;06;424;228;196
029;002;001;018;01;338;161;177
029;002;001;018;02;336;182;154
029;002;001;019;01;231;147;84
029;002;001;019;02;224;117;107
029;002;001;020;01;376;166;210
029;002;001;020;02;376;174;202
029;002;001;020;03;376;168;208
029;002;001;020;04;376;175;201
029;002;001;021;01;450;208;242
029;002;001;021;02;450;215;235
029;002;001;021;03;450;212;238
029;002;001;021;04;450;202;248
029;002;001;021;05;450;213;237
029;002;001;021;06;448;211;237
029;002;001;021;07;448;215;233
029;002;001;021;08;448;214;234
029;002;001;021;09;448;191;257
029;002;001;022;01;424;207;217
029;002;001;022;02;422;213;209
029;002;001;022;03;416;207;209
029;002;001;022;04;416;224;192
029;002;001;022;05;416;202;214
029;002;001;023;01;432;218;214
029;002;001;023;02;432;210;222
029;002;001;023;03;432;210;222
029;002;001;023;04;432;202;230
029;002;001;023;05;432;217;215
029;002;001;023;06;425;194;231
029;002;001;023;07;424;199;225
029;002;001;023;08;424;208;216
029;002;001;023;09;424;212;212
029;002;001;023;10;424;219;205
029;002;001;024;01;370;228;142
029;002;001;024;02;368;190;178
029;002;001;024;03;368;189;179
029;002;001;024;04;368;200;168
029;002;001;024;05;368;212;156
029;002;001;025;01;400;217;183
029;002;001;025;02;400;203;197
029;002;001;025;03;400;174;226
029;002;001;025;04;400;198;202
029;002;001;025;05;400;203;197
029;002;001;025;06;400;188;212
029;002;001;025;07;400;198;202
029;002;001;025;08;394;208;186
029;002;001;026;01;432;225;207
029;002;001;026;02;432;222;210
029;002;001;026;03;432;208;224
029;002;001;026;04;432;211;221
029;002;001;026;05;432;191;241
029;002;001;026;06;432;205;227
029;002;001;026;07;432;213;219
029;002;001;026;08;432;198;234
029;002;001;026;09;432;213;219
029;002;001;026;10;432;201;231
029;002;001;026;11;432;202;230
029;002;001;026;12;432;209;223
029;002;001;026;13;432;213;219
029;002;001;026;14;432;231;201
029;002;001;026;15;429;207;222
029;002;001;027;01;240;94;146
029;002;001;027;02;236;125;111
029;002;001;028;01;407;209;198
029;002;001;028;02;400;196;204
029;002;001;028;03;400;189;211
029;002;001;028;04;400;216;184
029;002;001;028;05;400;206;194
029;002;001;029;01;432;225;207
029;002;001;029;02;432;203;229
029;002;001;029;03;432;203;229
029;002;001;029;04;432;195;237
029;002;001;029;05;432;228;204
029;002;001;029;06;432;187;245
029;002;001;029;07;432;217;215
029;002;001;029;08;432;266;166
029;002;001;029;09;432;206;226
029;002;001;029;10;432;226;206
029;002;001;029;11;432;220;212
029;002;001;029;12;429;232;197
029;002;001;030;01;424;211;213
029;002;001;030;02;424;229;195
029;002;001;030;03;422;222;200
029;002;001;030;04;416;202;214
029;002;001;030;05;416;198;218
029;002;001;030;06;416;206;210
029;002;001;030;07;416;202;214
029;002;001;031;01;450;236;214
029;002;001;031;02;450;202;248
029;002;001;031;03;448;240;208
029;002;001;031;04;448;249;199
029;002;001;032;01;419;223;196
029;002;001;032;02;416;219;197
029;002;001;032;03;416;223;193
029;002;001;032;04;416;206;210
029;002;001;032;05;416;246;170
029;002;001;032;06;416;236;180
029;002;001;033;01;450;224;226
029;002;001;033;02;450;211;239
029;002;001;033;03;450;237;213
029;002;001;033;04;450;228;222
029;002;001;033;05;450;228;222
029;002;001;033;06;450;232;218
029;002;001;033;07;450;264;186
029;002;001;033;08;450;200;250
029;002;001;033;09;450;231;219
029;002;001;033;10;450;242;208
029;002;001;033;11;450;213;237
029;002;001;033;12;450;226;224
029;002;001;033;13;450;223;227
029;002;001;033;14;450;236;214
029;002;001;034;01;400;227;173
029;002;001;034;02;400;207;193
029;002;001;034;03;400;227;173
029;002;001;034;04;398;210;188
029;002;001;034;05;392;234;158
029;002;001;034;06;392;218;174
029;002;001;035;01;432;216;216
029;002;001;035;02;432;225;207
029;002;001;035;03;432;216;216
029;002;001;035;04;432;225;207
029;002;001;035;05;432;198;234
029;002;001;035;06;432;186;246
029;002;001;035;07;432;220;212
029;002;001;035;08;432;211;221
029;002;001;035;09;432;208;224
029;002;001;035;10;432;204;228
029;002;001;035;11;429;207;222
029;002;001;035;12;424;204;220
029;002;001;035;13;424;222;202
029;002;001;036;01;440;237;203
029;002;001;036;02;440;212;228
029;002;001;036;03;440;226;214
029;002;001;036;04;440;227;213
029;002;001;036;05;435;242;193
029;002;001;037;01;450;243;207
029;002;001;037;02;450;237;213
029;002;001;037;03;450;263;187
029;002;001;037;04;450;232;218
029;002;001;037;05;449;245;204
029;002;001;038;01;432;211;221
029;002;001;038;02;432;256;176
029;002;001;038;03;432;224;208
029;002;001;038;04;432;233;199
029;002;001;038;05;432;207;225
029;002;001;038;06;432;200;232
029;002;001;038;07;432;231;201
029;002;001;038;08;432;207;225
029;002;001;038;09;432;209;223
029;002;001;038;10;432;205;227
029;002;001;038;11;432;245;187
029;002;001;038;12;432;251;181
029;002;001;038;13;432;250;182
029;002;001;038;14;431;247;184
029;002;001;038;15;424;201;223
029;002;001;038;16;424;242;182
029;002;001;039;01;432;201;231
029;002;001;039;02;432;202;230
029;002;001;039;03;432;221;211
029;002;001;039;04;432;209;223
029;002;001;039;05;432;196;236
029;002;001;039;06;432;203;229
029;002;001;039;07;431;206;225
029;002;001;039;08;424;199;225
029;002;001;039;09;424;195;229
029;002;001;039;10;424;203;221
029;002;001;040;01;432;250;182
029;002;001;040;02;432;250;182
029;002;001;040;03;432;223;209
029;002;001;040;04;432;241;191
029;002;001;040;05;432;247;185
029;002;001;040;06;430;252;178
029;002;001;040;07;424;247;177
029;002;001;040;08;424;244;180
029;002;001;041;01;416;229;187
029;002;001;041;02;416;223;193
029;002;001;041;03;416;216;200
029;002;001;041;04;416;196;220
029;002;001;041;05;416;226;190
029;002;001;041;06;410;192;218
029;002;001;041;07;408;203;205
029;002;001;041;08;408;214;194
029;002;001;041;09;408;187;221
029;002;001;041;10;408;205;203
029;002;001;042;01;432;218;214
029;002;001;042;02;432;227;205
029;002;001;042;03;432;209;223
029;002;001;042;04;428;198;230
029;002;001;042;05;424;212;212
029;002;001;042;06;424;195;229
029;002;001;043;01;400;207;193
029;002;001;043;02;400;191;209
029;002;001;043;03;400;193;207
029;002;001;043;04;400;212;188
029;002;001;043;05;400;199;201
029;002;001;043;06;400;192;208
029;002;001;043;07;400;205;195
029;002;001;043;08;393;206;187
029;002;001;044;01;416;226;190
029;002;001;044;02;416;193;223
029;002;001;044;03;416;199;217
029;002;001;044;04;416;216;200
029;002;001;044;05;416;192;224
029;002;001;044;06;416;201;215
029;002;001;044;07;416;212;204
029;002;001;044;08;410;216;194
029;002;001;045;01;408;229;179
029;002;001;045;02;408;241;167
029;002;001;045;03;400;212;188
029;002;001;045;04;400;191;209
029;002;001;045;05;400;207;193
029;002;001;045;06;400;194;206
029;002;001;045;07;400;218;182
029;002;001;045;08;400;239;161
029;002;001;045;09;400;236;164
029;002;001;046;01;400;200;200
029;002;001;046;02;400;203;197
029;002;001;046;03;400;209;191
029;002;001;046;04;397;215;182
029;002;001;046;05;392;220;172
029;002;001;047;01;448;228;220
029;002;001;047;02;448;212;236
029;002;001;047;03;448;209;239
029;002;001;047;04;447;260;187
029;002;001;048;01;392;215;177
029;002;001;048;02;392;217;175
029;002;001;048;03;392;179;213
029;002;001;048;04;391;180;211
029;002;001;048;05;384;202;182
029;002;001;048;06;384;217;167
029;002;001;048;07;384;218;166
029;002;001;049;01;448;231;217
029;002;001;049;02;448;232;216
029;002;001;049;03;448;246;202
029;002;001;049;04;448;190;258
029;002;001;049;05;448;229;219
029;002;001;049;06;448;225;223
029;002;001;049;07;444;204;240
029;002;001;049;08;440;235;205
029;002;001;049;09;440;226;214
029;002;001;050;01;286;158;128
029;002;001;051;01;394;206;188
029;002;001;052;01;448;251;197
029;002;001;052;02;448;237;211
029;002;001;052;03;448;231;217
029;002;001;052;04;448;242;206
029;002;001;052;05;448;231;217
029;002;001;052;06;448;211;237
029;002;001;052;07;443;244;199
029;002;001;052;08;440;244;196
029;002;001;052;09;440;185;255
029;002;001;052;10;440;234;206
029;002;001;053;01;396;228;168
029;002;001;053;02;392;222;170
029;002;001;053;03;392;197;195
029;002;001;053;04;392;237;155
029;002;001;053;05;392;243;149
029;002;001;054;01;408;222;186
029;002;001;054;02;408;198;210
029;002;001;054;03;408;209;199
029;002;001;054;04;408;242;166
029;002;001;055;01;400;188;212
029;002;001;055;02;400;203;197
029;002;001;055;03;400;194;206
029;002;001;055;04;400;208;192
029;002;001;056;01;424;208;216
029;002;001;056;02;419;215;204
029;002;001;056;03;416;209;207
029;002;001;056;04;416;201;215
029;002;001;056;05;416;189;227
029;002;001;056;06;416;198;218
029;002;001;056;07;416;222;194
029;002;001;056;08;416;224;192
029;002;001;057;01;424;227;197
029;002;001;057;02;424;202;222
029;002;001;057;03;424;190;234
029;002;001;057;04;419;176;243
029;002;001;057;05;416;194;222
029;002;001;057;06;416;203;213
029;002;001;058;01;432;231;201
029;002;001;058;02;432;224;208
029;002;001;058;03;432;203;229
029;002;001;058;04;425;218;207
029;002;001;058;05;424;213;211
029;002;001;058;06;424;231;193
029;002;001;059;01;322;145;177
029;002;001;059;02;320;151;169
029;002;001;059;03;320;159;161
029;002;001;060;01;426;197;229
029;002;001;060;02;424;227;197
029;002;001;061;01;450;231;219
029;002;001;061;02;450;201;249
029;002;001;061;03;450;217;233
029;002;001;061;04;450;193;257
029;002;001;061;05;450;212;238
029;002;001;061;06;450;202;248
029;002;001;061;07;450;213;237
029;002;001;061;08;448;228;220
029;002;001;061;09;448;232;216
029;002;001;061;10;448;213;235
029;002;001;061;11;448;231;217
029;002;001;062;01;424;247;177
029;002;001;062;02;424;227;197
029;002;001;062;03;424;223;201
029;002;001;062;04;424;211;213
029;002;001;062;05;424;226;198
029;002;001;062;06;418;220;198
029;002;001;062;07;416;214;202
029;002;001;063;01;432;242;190
029;002;001;063;02;432;220;212
029;002;001;063;03;432;237;195
029;002;001;063;04;430;237;193
029;002;001;064;01;432;204;228
029;002;001;064;02;432;200;232
029;002;001;064;03;432;219;213
029;002;001;064;04;428;209;219
029;002;001;065;01;416;212;204
029;002;001;065;02;408;192;216
029;002;001;065;03;408;203;205
029;002;001;065;04;408;211;197
029;002;001;066;01;437;275;162
029;002;001;066;02;432;272;160
029;002;001;066;03;432;283;149
029;002;001;066;04;432;278;154
029;002;001;066;05;432;264;168
029;002;001;067;01;371;222;149
029;002;001;067;02;368;206;162
029;002;001;067;03;368;185;183
029;002;001;067;04;368;210;158
029;002;001;067;05;368;199;169
029;002;001;068;01;420;267;153
029;002;001;068;02;416;271;145
029;002;001;069;01;408;215;193
029;002;001;069;02;404;203;201
029;002;001;069;03;400;198;202
029;002;001;069;04;400;244;156
029;002;001;070;01;440;206;234
029;002;001;070;02;440;228;212
029;002;001;070;03;432;221;211
029;002;001;070;04;432;220;212
029;002;001;070;05;432;222;210
029;002;001;070;06;432;235;197
029;002;001;070;07;432;226;206
029;002;001;071;01;404;246;158
029;002;001;071;02;400;217;183
029;002;001;071;03;400;210;190
029;002;001;071;04;400;203;197
029;002;001;071;05;400;218;182
029;002;001;072;01;448;230;218
029;002;001;072;02;448;204;244
029;002;001;072;03;448;225;223
029;002;001;072;04;440;221;219
029;002;001;072;05;440;236;204
029;002;001;073;01;392;187;205
029;002;001;073;02;392;185;207
029;002;001;073;03;390;182;208
029;002;001;073;04;384;190;194
029;002;001;074;01;424;230;194
029;002;001;074;02;419;193;226
029;002;001;074;03;416;215;201
029;002;001;074;04;416;202;214
029;002;001;075;01;448;216;232
029;002;001;075;02;448;243;205
029;002;001;075;03;448;213;235
029;002;001;075;04;448;195;253
029;002;001;075;05;448;237;211
029;002;001;075;06;444;224;220
029;002;001;076;01;424;216;208
029;002;001;076;02;424;217;207
029;002;001;076;03;424;193;231
029;002;001;076;04;424;197;227
029;002;001;076;05;424;215;209
029;002;001;076;06;424;198;226
029;002;001;076;07;424;195;229
029;002;001;076;08;424;208;216
029;002;001;076;09;422;206;216
029;002;001;076;10;416;202;214
029;002;001;077;01;432;209;223
029;002;001;077;02;432;223;209
029;002;001;077;03;432;190;242
029;002;001;077;04;432;199;233
029;002;001;077;05;425;214;211
029;002;001;077;06;424;193;231
029;002;001;077;07;424;210;214
029;002;001;078;01;408;208;200
029;002;001;078;02;408;213;195
029;002;001;078;03;408;204;204
029;002;001;078;04;400;201;199
029;002;001;078;05;400;198;202
029;002;001;078;06;400;197;203
029;002;001;078;07;400;208;192
029;002;001;078;08;400;225;175
029;002;001;079;01;360;243;117
029;002;001;079;02;360;217;143
029;002;001;079;03;360;203;157
029;002;001;079;04;359;235;124
029;002;001;080;01;424;232;192
029;002;001;080;02;424;222;202
029;002;001;080;03;424;230;194
029;002;001;080;04;424;225;199
029;002;001;080;05;422;234;188
029;002;001;080;06;416;255;161
029;002;001;081;01;348;168;180
029;002;001;081;02;344;187;157
029;002;001;081;03;344;183;161
029;002;001;081;04;344;198;146
029;002;001;082;01;432;235;197
029;002;001;082;02;429;230;199
029;002;001;082;03;424;190;234
029;002;001;082;04;424;220;204
029;002;001;082;05;424;245;179
029;002;001;083;01;432;220;212
029;002;001;083;02;432;228;204
029;002;001;083;03;432;216;216
029;002;001;083;04;432;217;215
029;002;001;083;05;432;205;227
029;002;001;083;06;424;236;188
029;002;001;083;07;424;211;213
029;002;001;084;01;432;220;212
029;002;001;084;02;424;198;226
029;002;001;084;03;424;189;235
029;002;001;084;04;424;226;198
029;002;001;084;05;424;223;201
029;002;001;084;06;424;214;210
029;002;001;085;01;440;226;214
029;002;001;085;02;439;232;207
029;002;001;085;03;432;210;222
029;002;001;085;04;432;213;219
029;002;001;085;05;432;205;227
029;002;001;086;01;440;233;207
029;002;001;086;02;440;219;221
029;002;001;086;03;440;260;180
029;002;001;086;04;440;222;218
029;002;001;086;05;440;241;199
029;002;001;086;06;440;236;204
029;002;001;086;07;432;215;217
029;002;001;086;08;432;200;232
029;002;001;086;09;432;237;195
029;002;001;086;10;432;224;208
029;002;001;087;01;389;188;201
029;002;001;087;02;384;191;193
029;002;001;087;03;384;184;200
029;002;001;087;04;384;176;208
029;002;001;087;05;384;190;194
029;002;001;087;06;384;193;191
029;002;001;088;01;448;227;221
029;002;001;088;02;448;228;220
029;002;001;088;03;448;245;203
029;002;001;088;04;448;228;220
029;002;001;088;05;448;223;225
029;002;001;088;06;448;190;258
029;002;001;088;07;440;244;196
029;002;001;088;08;440;210;230
029;002;001;088;09;440;213;227
029;002;001;088;10;440;226;214
029;002;001;088;11;440;206;234
029;002;001;089;01;312;169;143
029;002;001;089;02;304;165;139
029;002;001;090;01;336;163;173
029;002;001;090;02;336;177;159
029;002;001;090;03;335;172;163
029;002;001;091;01;230;122;108
029;002;001;091;02;224;116;108
029;002;001;092;01;320;208;112
029;002;001;092;02;312;190;122
029;002;001;093;01;128;71;57
029;002;001;094;01;336;187;149
029;002;001;094;02;336;203;133
029;002;001;095;01;206;123;83
029;002;001;096;01;183;84;99
029;002;001;097;01;65;26;39
029;002;001;098;01;187;88;99
029;002;001;099;01;204;98;106
029;002;001;100;01;210;99;111
029;002;001;101;01;98;47;51
029;002;001;102;01;202;98;104
029;002;001;103;01;242;123;119
029;002;001;104;01;185;108;77
029;002;001;105;01;320;139;181
029;002;001;106;01;261;113;148
029;002;001;106;02;256;109;147
029;002;001;107;01;265;129;136
029;002;001;108;01;400;187;213
029;002;001;108;02;399;170;229
029;002;001;108;03;392;176;216
029;002;001;109;01;173;71;102
029;002;001;110;01;90;46;44
029;002;001;111;01;123;55;68
029;002;001;112;01;240;101;139
029;002;001;112;02;234;120;114
029;002;001;113;01;277;115;162
029;002;001;114;01;229;91;138
029;002;001;114;02;224;99;125
029;002;001;115;01;78;38;40
029;002;001;116;01;226;111;115
029;002;001;117;01;202;90;112
029;002;001;118;01;112;57;55
029;002;001;119;01;100;51;49
029;002;001;120;01;408;190;218
029;002;001;120;02;402;185;217
029;002;001;121;01;304;136;168
029;002;001;122;01;115;59;56
029;002;001;123;01;161;76;85
029;002;001;124;01;336;143;193
029;002;001;124;02;334;175;159
029;002;001;125;01;264;127;137
029;002;001;126;01;290;156;134
029;002;001;127;01;155;66;89
029;002;001;128;01;365;172;193
029;002;001;129;01;203;93;110
029;002;001;130;01;246;116;130
029;002;001;131;01;224;100;124
029;002;001;132;01;248;127;121
029;002;001;132;02;241;115;126
029;002;001;133;01;293;160;133
029;002;001;134;01;347;182;165
029;002;001;135;01;271;126;145
029;002;001;136;01;252;118;134
029;002;001;137;01;203;109;94
029;002;001;138;01;307;159;148
029;002;001;139;01;384;216;168
029;002;001;139;02;381;222;159
029;002;001;140;01;432;267;165
029;002;001;140;02;425;246;179
029;002;001;141;01;280;155;125
029;002;001;141;02;272;150;122
029;002;001;142;01;249;135;114
029;002;001;143;01;71;41;30
029;002;001;144;01;312;155;157
029;002;001;144;02;307;141;166
029;002;001;144;03;304;159;145
029;002;001;145;01;253;131;122
029;002;001;146;01;258;142;116
029;002;001;147;01;204;109;95
029;002;001;148;01;117;56;61
029;002;001;149;01;114;60;54
029;002;001;150;01;360;138;222
029;002;001;150;02;353;165;188
029;002;001;151;01;145;65;80
029;002;001;152;01;195;88;107
029;002;001;153;01;225;113;112
029;002;001;154;01;248;123;125
029;002;001;155;01;197;92;105
029;002;001;156;01;427;200;227
029;002;001;157;01;128;59;69
029;002;001;158;01;236;106;130
029;002;001;158;02;232;128;104
029;002;001;159;01;360;168;192
029;002;001;159;02;360;182;178
029;002;001;159;03;353;161;192
029;002;001;160;01;308;151;157
029;002;001;161;01;232;118;114
029;002;001;161;02;225;117;108
029;002;001;162;01;376;211;165
029;002;001;162;02;376;191;185
029;002;001;162;03;376;184;192
029;002;001;162;04;375;215;160
029;002;001;162;05;368;210;158
029;002;001;163;01;344;200;144
029;002;001;163;02;344;165;179
029;002;001;163;03;343;194;149
029;002;001;163;04;336;199;137
029;002;001;164;01;257;133;124
029;002;001;164;02;256;127;129
029;002;001;165;01;370;206;164
029;002;001;165;02;368;197;171
029;002;001;166;01;432;211;221
029;002;001;166;02;432;198;234
029;002;001;166;03;432;220;212
029;002;001;166;04;432;181;251
029;002;001;166;05;432;204;228
029;002;001;166;06;432;188;244
029;002;001;166;07;432;185;247
029;002;001;166;08;432;175;257
029;002;001;166;09;424;195;229
029;002;001;166;10;424;215;209
029;002;001;166;11;424;174;250
029;002;001;166;12;424;198;226
029;002;001;167;01;360;173;187
029;002;001;168;01;281;137;144
029;002;001;169;01;180;84;96
029;002;001;170;01;288;125;163
029;002;001;170;02;285;161;124
029;002;001;171;01;384;183;201
029;002;001;171;02;384;170;214
029;002;001;171;03;382;195;187
029;002;001;171;04;376;190;186
029;002;001;171;05;376;176;200
029;002;001;172;01;427;203;224
029;002;001;172;02;424;221;203
029;002;001;172;03;424;216;208
029;002;001;172;04;424;226;198
029;002;001;173;01;416;208;208
029;002;001;173;02;416;213;203
029;002;001;173;03;416;211;205
029;002;001;173;04;416;208;208
029;002;001;173;05;416;212;204
029;002;001;173;06;411;190;221
029;002;001;173;07;408;186;222
029;002;001;173;08;408;217;191
029;002;001;173;09;408;213;195
029;002;001;173;10;408;180;228
029;002;001;173;11;408;184;224
029;002;001;174;01;368;161;207
029;002;001;175;01;430;202;228
029;002;001;175;02;424;217;207
029;002;001;176;01;320;165;155
029;002;001;176;02;320;137;183
029;002;001;176;03;317;135;182
029;002;001;177;01;344;155;189
029;002;001;177;02;343;165;178
029;002;001;178;01;400;190;210
029;002;001;178;02;400;191;209
029;002;001;178;03;394;194;200
029;002;001;179;01;349;152;197
029;002;001;179;02;344;173;171
029;002;001;179;03;344;164;180
029;002;001;179;04;344;166;178
029;002;001;180;01;352;157;195
029;002;001;180;02;352;177;175
029;002;001;180;03;344;160;184
029;002;098;001;01;406;154;252
029;002;098;002;01;368;138;230
029;002;098;003;01;271;131;140
029;002;098;004;01;261;86;175
029;002;098;004;02;256;106;150
029;002;098;005;01;176;79;97
029;002;098;006;01;288;110;178
029;002;098;007;01;244;106;138
029;002;098;007;02;240;104;136
029;002;098;008;01;176;71;105
029;002;098;009;01;241;80;161
029;002;098;010;01;380;186;194
029;002;098;011;01;147;67;80
029;002;098;012;01;160;73;87
029;002;098;013;01;364;182;182
029;002;098;014;01;261;126;135
029;002;098;015;01;137;75;62
029;002;098;016;01;166;78;88
029;002;098;017;01;264;133;131
029;002;098;018;01;109;60;49
029;002;098;019;01;321;151;170
029;002;098;020;01;97;43;54
029;002;098;021;01;307;135;172
029;002;098;021;02;304;125;179
029;002;098;021;03;304;179;125
029;002;098;022;01;144;62;82
029;002;098;023;01;375;173;202
029;002;098;023;02;368;187;181
029;002;098;024;01;153;80;73
029;002;098;025;01;390;185;205
029;002;098;025;02;384;181;203
029;002;098;026;01;202;107;95
029;002;098;027;01;295;159;136
029;002;098;028;01;71;42;29
029;002;098;029;01;230;109;121
029;002;098;030;01;198;100;98
029;002;098;031;01;112;52;60
029;002;098;032;01;182;88;94
029;002;098;033;01;115;55;60
029;002;098;034;01;124;64;60
029;002;098;035;01;140;82;58
029;002;098;036;01;122;62;60
029;002;098;037;01;45;27;18
029;002;098;038;01;178;90;88
029;002;098;039;01;70;41;29
029;002;098;040;01;145;76;69
029;002;098;041;01;131;75;56
029;002;098;042;01;148;75;73
029;002;098;043;01;96;58;38
029;002;098;044;01;293;144;149
029;002;098;045;01;358;179;179
029;002;098;046;01;205;111;94
029;002;098;047;01;238;135;103
029;002;098;048;01;131;74;57
029;003;001;001;01;440;209;231
029;003;001;001;02;432;229;203
029;003;001;002;01;384;170;214
029;003;001;002;02;381;182;199
029;003;001;002;03;376;171;205
029;003;001;002;04;376;183;193
029;003;001;002;05;376;192;184
029;003;001;002;06;376;171;205
029;003;001;003;01;288;142;146
029;003;001;005;01;360;163;197
029;003;001;005;02;360;176;184
029;003;001;005;03;353;168;185
029;003;001;006;01;98;45;53
029;003;001;008;01;178;61;117
029;003;001;009;01;179;72;107
029;003;001;010;01;285;114;171
029;003;001;011;01;309;128;181
029;003;001;012;01;271;103;168
029;003;001;013;01;193;71;122
029;003;001;014;01;274;121;153
029;003;001;015;01;255;110;145
029;003;001;015;02;248;132;116
029;003;001;016;01;311;121;190
029;003;001;017;01;225;87;138
029;003;001;018;01;232;95;137
029;003;001;019;01;143;59;84
029;003;001;020;01;125;53;72
029;003;001;021;01;128;42;86
029;003;001;022;01;182;71;111
029;003;001;023;01;213;85;128
029;003;001;024;01;68;30;38
029;003;001;025;01;177;74;103
029;003;001;026;01;206;70;136
029;003;001;027;01;127;54;73
029;003;001;028;01;240;109;131
029;003;001;028;02;236;96;140
029;003;001;029;01;68;29;39
029;003;001;030;01;191;78;113
029;003;001;031;01;204;107;97
029;003;001;032;01;30;11;19
029;003;001;033;01;121;57;64
029;005;001;001;01;450;214;236
029;005;001;001;02;450;190;260
029;005;001;001;03;449;198;251
029;005;001;001;04;448;199;249
029;005;001;001;05;448;231;217
029;005;001;002;01;126;51;75
029;005;001;003;01;258;109;149
029;005;001;004;01;69;31;38
029;005;001;005;01;182;75;107
029;005;001;006;01;113;46;67
029;005;001;007;01;265;104;161
029;005;001;008;01;197;82;115
029;005;001;009;01;147;78;69
029;005;001;010;01;268;118;150
029;005;001;011;01;251;102;149
029;005;001;012;01;192;90;102
029;005;001;013;01;220;89;131
029;005;001;014;01;260;112;148
029;005;001;015;01;243;119;124
029;005;001;016;01;370;148;222
029;005;001;016;02;368;141;227
029;005;001;017;01;165;62;103
029;005;001;018;01;210;82;128
029;005;001;019;01;244;100;144
029;005;001;020;01;201;81;120
029;005;001;021;01;276;115;161
029;005;001;022;01;240;95;145
029;005;001;023;01;154;62;92
029;005;001;024;01;153;61;92
029;005;001;025;01;203;94;109
029;005;001;026;01;118;49;69
029;005;001;027;01;308;121;187
029;005;001;028;01;317;147;170
029;005;001;029;01;361;142;219
029;005;001;030;01;419;163;256
029;005;001;031;01;159;77;82
029;005;001;032;01;310;151;159
029;005;001;033;01;250;91;159
029;005;001;034;01;192;90;102
029;005;001;035;01;404;147;257
029;005;001;035;02;400;169;231
029;005;001;036;01;143;58;85
029;005;001;037;01;243;92;151
029;005;001;038;01;48;27;21
029;005;001;039;01;244;125;119
029;005;001;040;01;223;99;124
029;005;098;001;01;270;130;140
029;005;098;002;01;109;46;63
029;005;098;003;01;314;131;183
029;005;098;004;01;328;132;196
029;005;098;004;02;323;149;174
029;005;098;005;01;440;197;243
029;005;098;006;01;217;95;122
029;006;098;001;01;46;24;22
029;006;098;002;01;260;118;142
029;006;098;003;01;114;59;55
029;006;098;004;01;229;107;122
029;006;098;005;01;232;90;142
029;006;098;006;01;121;58;63
029;006;098;007;01;248;97;151
029;006;098;007;02;245;119;126
029;006;098;008;01;112;51;61
029;006;098;009;01;276;130;146
029;006;098;010;01;228;104;124
029;006;098;011;01;59;18;41
029;007;098;001;01;256;125;131
029;007;098;002;01;204;93;111
029;007;098;003;01;272;112;160
029;007;098;004;01;328;121;207
029;007;098;005;01;151;71;80
029;007;098;006;01;78;32;46
029;007;098;007;01;129;61;68
029;007;098;008;01;29;17;12
029;007;098;010;01;95;46;49
029;007;098;011;01;280;138;142
029;007;098;012;01;66;26;40
029;007;098;013;01;351;151;200
029;007;098;014;01;300;130;170
029;007;098;015;01;195;85;110
029;007;098;016;01;352;167;185
029;007;098;017;01;261;123;138
029;007;098;017;02;256;130;126
029;007;098;018;01;192;59;133
029;007;098;020;01;159;64;95
029;007;098;021;01;46;24;22
029;007;098;022;01;162;84;78
029;007;098;023;01;242;112;130
029;007;098;023;02;240;103;137
029;007;098;024;01;133;50;83
029;007;098;025;01;107;46;61
029;007;098;026;01;126;51;75
029;007;098;027;01;201;77;124
029;007;098;030;01;37;26;11
029;007;098;031;01;57;36;21
030;001;001;001;01;321;154;167
030;001;001;001;02;320;145;175
030;001;001;001;03;320;147;173
030;001;001;002;01;416;217;199
030;001;001;002;02;414;210;204
030;001;001;002;03;408;229;179
030;001;001;003;01;347;179;168
030;001;001;003;02;344;185;159
030;001;001;003;03;344;180;164
030;001;001;004;01;429;244;185
030;001;001;004;02;424;249;175
030;001;001;005;01;396;175;221
030;001;001;006;01;396;195;201
030;001;001;007;01;416;202;214
030;001;001;007;02;412;208;204
030;001;001;008;01;262;120;142
030;001;001;009;01;277;134;143
030;001;001;010;01;309;159;150
030;001;001;010;02;304;170;134
030;001;001;010;03;304;171;133
030;001;001;011;01;200;95;105
030;001;001;012;01;376;151;225
030;001;001;012;02;369;183;186
030;001;001;013;01;277;123;154
030;001;001;014;01;307;139;168
030;001;001;015;01;311;147;164
030;001;001;016;01;146;61;85
030;001;001;017;01;210;80;130
030;001;001;018;01;448;185;263
030;001;001;018;02;444;188;256
030;001;001;019;01;286;122;164
030;001;001;020;01;166;73;93
030;001;001;021;01;117;60;57
030;001;001;022;01;276;126;150
030;001;001;022;02;272;154;118
030;001;001;023;01;179;81;98
030;001;001;024;01;174;88;86
030;001;001;025;01;137;70;67
030;001;001;026;01;326;156;170
030;001;001;027;01;288;137;151
030;001;001;027;02;285;134;151
030;001;001;028;01;397;181;216
030;001;001;029;01;398;197;201
030;001;001;030;01;179;86;93
030;001;001;031;01;284;131;153
030;001;001;032;01;412;203;209
030;001;001;033;01;144;75;69
030;001;001;034;01;303;152;151
030;001;001;034;02;296;141;155
030;001;001;035;01;434;215;219
030;001;001;036;01;171;90;81
030;001;001;037;01;112;57;55
030;001;001;038;01;53;24;29
030;001;001;039;01;243;110;133
030;001;001;040;01;198;88;110
030;001;001;041;01;210;89;121
030;001;001;042;01;145;69;76
030;001;001;043;01;124;69;55
030;001;001;044;01;416;183;233
030;001;001;045;01;146;73;73
030;001;001;046;01;124;54;70
030;001;001;047;01;418;190;228
030;001;098;001;01;439;209;230
030;001;098;002;01;116;51;65
030;001;098;003;01;105;54;51
030;001;098;004;01;203;87;116
030;001;098;005;01;243;105;138
030;001;098;006;01;264;111;153
030;001;098;007;01;264;104;160
030;001;098;007;02;263;124;139
030;001;098;008;01;196;94;102
030;001;098;009;01;170;90;80
030;001;098;010;01;352;164;188
030;001;098;010;02;351;181;170
030;001;098;011;01;102;47;55
030;001;098;012;01;263;127;136
030;001;098;013;01;106;54;52
030;001;098;014;01;300;140;160
030;001;098;015;01;202;101;101
030;001;098;016;01;196;104;92
030;001;098;017;01;370;191;179
030;001;098;018;01;291;165;126
030;001;098;019;01;214;112;102
030;001;098;020;01;169;93;76
030;001;098;021;01;436;215;221
030;001;098;022;01;429;208;221
030;001;098;023;01;303;144;159
030;001;098;024;01;240;119;121
030;001;098;025;01;428;218;210
030;001;098;026;01;205;103;102
030;001;098;027;01;275;145;130
030;001;098;028;01;241;121;120
030;001;098;029;01;61;33;28
030;002;098;001;01;341;169;172
030;002;098;001;02;336;168;168
030;002;098;002;01;375;196;179
030;002;098;003;01;236;106;130
030;002;098;003;02;232;115;117
030;003;098;001;01;368;180;188
030;003;098;001;02;361;193;168
030;003;098;002;01;278;149;129
030;003;098;002;02;272;130;142
030;003;098;003;01;384;186;198
030;003;098;003;02;381;210;171
030;003;098;004;01;418;225;193
030;003;098;004;02;416;205;211
030;003;098;005;01;418;218;200
030;003;098;006;01;395;195;200
030;004;098;001;01;150;67;83
030;004;098;002;01;227;110;117
030;004;098;003;01;93;36;57
030;004;098;004;01;87;39;48
030;004;098;005;01;146;60;86
030;004;098;006;01;424;167;257
030;004;098;007;01;147;73;74
030;004;098;008;01;89;47;42
030;004;098;009;01;125;57;68
030;004;098;010;01;400;167;233
030;004;098;010;02;400;185;215
030;004;098;011;01;119;51;68
030;004;098;013;01;288;110;178
030;004;098;013;02;286;129;157
030;004;098;014;01;188;85;103
030;004;098;015;01;249;103;146
030;004;098;017;01;325;132;193
030;004;098;017;02;320;152;168
030;004;098;018;01;159;61;98
030;004;098;019;01;209;88;121
030;004;098;020;01;294;121;173
030;004;098;021;01;164;69;95
030;004;098;022;01;127;61;66
030;004;098;023;01;296;128;168
030;004;098;023;02;289;133;156
030;004;098;024;01;134;58;76
030;004;098;025;01;190;74;116
030;004;098;026;01;67;29;38
030;004;098;027;01;190;80;110
030;004;098;028;01;214;81;133
030;004;098;029;01;148;63;85
030;004;098;030;01;78;36;42
030;004;098;031;01;140;62;78
030;004;098;032;01;194;75;119
030;004;098;033;01;96;44;52
031;002;001;001;01;450;231;219
031;002;001;001;02;450;227;223
031;002;001;001;03;449;230;219
031;002;001;002;01;384;219;165
031;002;001;002;02;381;211;170
031;002;001;002;03;376;211;165
031;002;001;002;04;376;218;158
031;002;001;003;01;432;231;201
031;002;001;003;02;430;237;193
031;002;001;004;01;378;189;189
031;002;001;004;02;376;202;174
031;002;001;005;01;376;209;167
031;002;001;005;02;373;195;178
031;002;001;005;03;368;188;180
031;002;001;005;04;368;223;145
031;002;001;006;01;448;215;233
031;002;001;006;02;446;212;234
031;002;001;007;01;446;224;222
031;002;001;007;02;440;240;200
031;002;001;008;01;138;74;64
031;002;001;009;01;199;93;106
031;002;001;010;01;270;137;133
031;002;001;011;01;178;96;82
031;002;001;012;01;362;179;183
031;002;001;013;01;320;184;136
031;002;001;013;02;315;203;112
031;002;001;013;03;312;178;134
031;002;001;014;01;296;169;127
031;002;001;014;02;292;155;137
031;002;001;015;01;365;199;166
031;002;001;016;01;304;198;106
031;002;001;016;02;304;161;143
031;002;001;016;03;302;181;121
031;002;001;017;01;287;113;174
031;002;001;018;01;193;105;88
031;002;001;019;01;70;40;30
031;002;001;020;01;97;58;39
031;002;001;021;01;341;175;166
031;002;001;022;01;432;237;195
031;002;001;022;02;431;247;184
031;002;001;026;01;136;77;59
031;002;098;001;01;346;183;163
031;002;098;001;02;344;198;146
031;002;098;001;03;344;190;154
031;002;098;002;01;210;126;84
031;002;098;003;01;239;133;106
031;002;098;004;01;220;135;85
031;002;098;005;01;425;247;178
031;002;098;006;01;265;140;125
031;002;098;007;01;273;155;118
031;002;098;008;01;236;140;96
031;002;098;008;02;232;127;105
031;002;098;009;01;163;76;87
031;002;098;010;01;170;94;76
031;002;098;011;01;360;204;156
031;002;098;011;02;354;183;171
031;002;098;012;01;109;59;50
031;002;098;013;01;298;155;143
031;002;098;014;01;142;68;74
031;002;098;016;01;195;109;86
031;002;098;017;01;224;136;88
031;002;098;021;01;131;83;48
031;003;098;001;01;163;86;77
031;003;098;002;01;416;222;194
031;003;098;002;02;412;225;187
031;003;098;003;01;416;213;203
031;003;098;003;02;409;204;205
031;003;098;003;03;408;241;167
031;003;098;004;01;259;145;114
031;003;098;004;02;256;153;103
031;003;098;005;01;365;210;155
031;003;098;006;01;421;272;149
031;003;098;007;01;391;229;162
031;003;098;008;01;273;181;92
031;003;098;009;01;449;263;186
031;003;098;010;01;139;99;40
031;003;098;011;01;174;114;60
031;003;098;012;01;252;150;102
031;003;098;012;02;248;151;97
031;003;098;013;01;229;151;78
031;003;098;014;01;188;113;75
031;003;098;015;01;107;66;41
031;003;098;016;01;288;162;126
031;003;098;017;01;247;134;113
031;003;098;018;01;170;101;69
031;003;098;019;01;320;161;159
031;003;098;019;02;315;186;129
031;003;098;020;01;319;176;143
031;003;098;021;01;244;123;121
031;003;098;021;02;240;119;121
031;003;098;022;01;312;185;127
031;003;098;023;01;239;143;96
031;003;098;024;01;157;83;74
031;003;098;025;01;264;153;111
031;003;098;025;02;259;145;114
031;003;098;026;01;268;167;101
031;003;098;027;01;107;53;54
031;003;098;028;01;139;89;50
031;003;098;029;01;199;119;80
031;003;098;031;01;126;70;56
031;003;098;032;01;228;146;82
031;003;098;034;01;165;96;69
031;003;098;035;01;159;109;50
031;004;098;001;01;321;175;146
031;004;098;002;01;450;271;179
031;004;098;002;02;450;263;187
031;004;098;002;03;448;283;165
031;004;098;003;01;280;179;101
031;004;098;003;02;272;183;89
031;004;098;004;01;110;62;48
031;004;098;005;01;240;142;98
031;004;098;005;02;239;137;102
031;004;098;006;01;178;94;84
031;004;098;007;01;435;231;204
031;004;098;007;02;432;226;206
031;004;098;007;03;432;233;199
031;004;098;008;01;305;184;121
031;004;098;008;02;304;193;111
031;004;098;008;03;304;174;130
031;004;098;009;01;245;189;56
031;004;098;010;01;278;140;138
031;004;098;010;02;272;161;111
031;004;098;011;01;171;102;69
031;004;098;012;01;328;190;138
031;004;098;012;02;328;198;130
031;004;098;012;03;321;171;150
031;004;098;013;01;226;123;103
031;004;098;014;01;272;162;110
031;004;098;014;02;267;161;106
031;004;098;015;01;248;136;112
031;004;098;016;01;233;164;69
031;004;098;017;01;240;154;86
031;004;098;017;02;233;153;80
031;005;098;001;01;378;224;154
031;005;098;002;01;240;133;107
031;005;098;002;02;237;138;99
031;005;098;003;01;220;125;95
031;005;098;004;01;156;94;62
031;005;098;006;01;306;187;119
031;005;098;007;01;127;62;65
031;005;098;008;01;171;90;81
031;005;098;009;01;308;174;134
031;005;098;010;01;166;90;76
031;005;098;011;01;158;99;59
031;005;098;012;01;344;209;135
031;005;098;013;01;397;213;184
031;005;098;013;02;392;225;167
031;005;098;014;01;250;170;80
031;005;098;015;01;278;164;114
031;005;098;017;01;208;152;56
031;005;098;018;01;107;69;38
031;006;098;001;01;344;178;166
031;006;098;001;02;343;207;136
031;006;098;002;01;352;193;159
031;006;098;002;02;347;219;128
031;006;098;003;01;230;128;102
031;006;098;003;02;224;131;93
031;006;098;004;01;211;128;83
031;006;098;005;01;294;164;130
031;006;098;006;01;312;176;136
031;006;098;006;02;312;177;135
031;006;098;006;03;309;186;123
031;006;098;007;01;99;55;44
031;006;098;008;01;271;154;117
031;006;098;009;01;163;100;63
031;006;098;010;01;254;136;118
031;006;098;011;01;416;259;157
031;006;098;012;01;229;134;95
031;006;098;013;01;246;142;104
031;006;098;014;01;276;156;120
031;006;098;028;01;225;134;91
031;006;098;029;01;152;94;58
031;007;098;001;01;431;247;184
031;007;098;002;01;253;140;113
031;007;098;003;01;375;217;158
031;007;098;004;01;288;175;113
031;007;098;004;02;287;184;103
031;007;098;005;01;238;129;109
031;007;098;005;02;232;149;83
031;007;098;006;01;271;169;102
032;002;001;001;01;352;175;177
032;002;001;001;02;352;189;163
032;002;001;001;03;347;171;176
032;002;001;002;01;450;242;208
032;002;001;002;02;449;228;221
032;002;001;003;01;324;157;167
032;002;001;003;02;320;165;155
032;002;001;004;01;341;180;161
032;002;001;004;02;336;182;154
032;002;001;004;03;336;166;170
032;002;001;005;01;282;163;119
032;002;001;006;01;400;181;219
032;002;001;007;01;311;160;151
032;002;001;008;01;266;136;130
032;002;001;009;01;407;239;168
032;002;001;010;01;331;164;167
032;002;001;011;01;215;127;88
032;002;001;012;01;87;58;29
032;002;001;013;01;384;217;167
032;002;001;013;02;380;200;180
032;002;001;014;01;317;175;142
032;002;001;015;01;145;92;53
032;002;001;016;01;88;55;33
032;002;001;017;01;320;177;143
032;002;001;018;01;107;64;43
032;002;001;019;01;163;100;63
032;002;001;020;01;126;68;58
032;002;001;021;01;172;96;76
032;002;001;023;01;231;119;112
032;002;098;001;01;286;147;139
032;002;098;002;01;287;143;144
032;002;098;002;02;280;147;133
032;002;098;003;01;313;197;116
032;002;098;004;01;243;142;101
032;002;098;005;01;312;181;131
032;003;098;001;01;67;42;25
032;003;098;002;01;228;130;98
032;003;098;003;01;235;147;88
032;003;098;004;01;435;246;189
032;003;098;004;02;432;232;200
032;003;098;004;03;432;244;188
032;003;098;005;01;79;53;26
032;003;098;006;01;154;98;56
032;003;098;007;01;181;106;75
032;003;098;008;01;319;179;140
032;003;098;009;01;95;63;32
032;003;098;010;01;122;80;42
032;003;098;011;01;184;107;77
032;003;098;012;01;80;52;28
032;003;098;013;01;45;26;19
032;003;098;014;01;162;94;68
032;003;098;015;01;118;68;50
032;003;098;016;01;103;54;49
032;003;098;017;01;278;135;143
032;003;098;017;02;272;142;130
032;003;098;018;01;162;100;62
032;003;098;019;01;194;114;80
032;003;098;020;01;88;51;37
032;003;098;021;01;116;64;52
032;003;098;022;01;125;74;51
032;003;098;023;01;156;89;67
032;003;098;024;01;328;169;159
032;003;098;024;02;322;165;157
032;003;098;024;03;320;178;142
032;003;098;025;01;113;69;44
032;004;098;001;01;325;197;128
032;004;098;002;01;201;113;88
032;004;098;003;01;174;107;67
032;004;098;004;01;180;92;88
032;004;098;005;01;69;38;31
032;004;098;006;01;175;103;72
032;004;098;007;01;123;66;57
032;004;098;008;01;93;59;34
032;004;098;009;01;422;223;199
032;004;098;010;01;173;92;81
032;004;098;011;01;312;173;139
032;004;098;011;02;309;163;146
032;004;098;011;03;304;157;147
032;004;098;012;01;344;179;165
032;004;098;012;02;342;191;151
032;004;098;013;01;165;84;81
032;004;098;014;01;153;85;68
033;001;001;001;01;400;189;211
033;001;001;001;02;400;185;215
033;001;001;001;03;400;206;194
033;001;001;001;04;400;180;220
033;001;001;001;05;400;191;209
033;001;001;001;06;394;215;179
033;001;001;002;01;448;225;223
033;001;001;002;02;440;204;236
033;001;001;002;03;440;256;184
033;001;001;002;04;440;247;193
033;001;001;002;05;440;230;210
033;001;001;003;01;417;198;219
033;001;001;003;02;416;196;220
033;001;001;003;03;416;217;199
033;001;001;003;04;416;184;232
033;001;001;003;05;416;204;212
033;001;001;003;06;416;199;217
033;001;001;004;01;440;229;211
033;001;001;004;02;440;272;168
033;001;001;004;03;440;223;217
033;001;001;004;04;438;251;187
033;001;001;004;05;432;245;187
033;001;001;004;06;432;221;211
033;001;001;005;01;408;219;189
033;001;001;005;02;408;232;176
033;001;001;005;03;405;232;173
033;001;001;006;01;416;195;221
033;001;001;006;02;416;194;222
033;001;001;006;03;416;196;220
033;001;001;006;04;413;204;209
033;001;001;006;05;408;217;191
033;001;001;007;01;400;206;194
033;001;001;007;02;400;190;210
033;001;001;007;03;400;187;213
033;001;001;007;04;400;201;199
033;001;001;007;05;400;192;208
033;001;001;007;06;398;203;195
033;001;001;007;07;392;187;205
033;001;001;008;01;405;188;217
033;001;001;008;02;400;180;220
033;001;001;008;03;400;200;200
033;001;001;009;01;352;159;193
033;001;001;009;02;352;157;195
033;001;001;009;03;352;178;174
033;001;001;009;04;350;171;179
033;001;001;010;01;416;195;221
033;001;001;010;02;413;188;225
033;001;001;010;03;408;181;227
033;001;001;010;04;408;183;225
033;001;001;011;01;400;199;201
033;001;001;011;02;393;196;197
033;001;001;011;03;392;182;210
033;001;001;012;01;432;210;222
033;001;001;012;02;431;200;231
033;001;001;012;03;424;215;209
033;001;001;012;04;424;196;228
033;001;001;012;05;424;225;199
033;001;001;012;06;424;192;232
033;001;001;012;07;424;221;203
033;001;001;013;01;440;247;193
033;001;001;013;02;440;247;193
033;001;001;013;03;439;251;188
033;001;001;013;04;432;259;173
033;001;001;013;05;432;229;203
033;001;001;013;06;432;243;189
033;001;001;014;01;440;230;210
033;001;001;014;02;436;222;214
033;001;001;014;03;432;214;218
033;001;001;015;01;400;241;159
033;001;001;015;02;398;217;181
033;001;001;015;03;392;213;179
033;001;001;016;01;424;244;180
033;001;001;016;02;424;209;215
033;001;001;016;03;424;228;196
033;001;001;016;04;424;228;196
033;001;001;016;05;416;223;193
033;001;001;017;01;368;192;176
033;001;001;017;02;368;183;185
033;001;001;017;03;367;205;162
033;001;001;017;04;360;166;194
033;001;001;017;05;360;176;184
033;001;001;018;01;408;213;195
033;001;001;018;02;401;182;219
033;001;001;018;03;400;191;209
033;001;001;018;04;400;208;192
033;001;001;019;01;424;221;203
033;001;001;019;02;424;218;206
033;001;001;019;03;424;213;211
033;001;001;019;04;424;190;234
033;001;001;019;05;421;208;213
033;001;001;019;06;416;209;207
033;001;001;019;07;416;217;199
033;001;001;019;08;416;214;202
033;001;001;020;01;70;47;23
033;001;001;021;01;432;204;228
033;001;001;021;02;432;221;211
033;001;001;021;03;432;221;211
033;001;001;021;04;425;214;211
033;001;001;022;01;440;259;181
033;001;001;022;02;440;234;206
033;001;001;022;03;440;249;191
033;001;001;022;04;432;245;187
033;001;001;023;01;402;196;206
033;001;001;023;02;400;179;221
033;001;001;023;03;400;188;212
033;001;001;023;04;400;215;185
033;001;001;024;01;432;209;223
033;001;001;024;02;432;216;216
033;001;001;024;03;432;211;221
033;001;001;024;04;432;211;221
033;001;001;024;05;429;198;231
033;001;001;024;06;424;204;220
033;001;001;024;07;424;220;204
033;001;001;025;01;448;220;228
033;001;001;025;02;448;241;207
033;001;001;025;03;448;222;226
033;001;001;025;04;446;246;200
033;001;001;025;05;440;239;201
033;001;001;025;06;440;231;209
033;001;001;026;01;450;233;217
033;001;001;026;02;450;230;220
033;001;001;026;03;450;238;212
033;001;001;026;04;449;193;256
033;001;001;026;05;448;228;220
033;001;001;026;06;448;214;234
033;001;001;026;07;448;208;240
033;001;001;026;08;448;239;209
033;001;001;026;09;448;218;230
033;001;001;027;01;440;207;233
033;001;001;027;02;433;210;223
033;001;001;027;03;432;198;234
033;001;001;027;04;432;199;233
033;001;001;028;01;440;231;209
033;001;001;028;02;440;238;202
033;001;001;028;03;440;220;220
033;001;001;028;04;440;243;197
033;001;001;028;05;440;227;213
033;001;001;028;06;436;227;209
033;001;001;028;07;432;236;196
033;001;001;028;08;432;245;187
033;001;001;029;01;357;194;163
033;001;001;029;02;352;202;150
033;001;001;029;03;352;197;155
033;001;001;030;01;424;217;207
033;001;001;030;02;424;220;204
033;001;001;030;03;424;230;194
033;001;001;030;04;424;219;205
033;001;001;030;05;419;218;201
033;001;001;031;01;352;185;167
033;001;001;032;01;328;177;151
033;001;001;032;02;322;184;138
033;001;001;033;01;248;133;115
033;001;001;033;02;247;147;100
033;001;001;034;01;446;216;230
033;001;001;034;02;440;197;243
033;001;001;034;03;440;234;206
033;001;001;035;01;312;171;141
033;001;001;035;02;310;169;141
033;001;001;035;03;304;171;133
033;001;001;036;01;272;152;120
033;001;001;036;02;266;139;127
033;001;001;037;01;368;178;190
033;001;001;037;02;367;145;222
033;001;001;038;01;344;175;169
033;001;001;038;02;342;190;152
033;001;001;039;01;304;163;141
033;001;001;039;02;297;138;159
033;001;001;040;01;400;185;215
033;001;001;040;02;400;188;212
033;001;001;040;03;394;202;192
033;001;001;040;04;392;204;188
033;001;001;041;01;441;214;227
033;001;001;041;02;440;211;229
033;001;001;041;03;440;212;228
033;001;001;041;04;440;218;222
033;001;001;041;05;440;232;208
033;001;001;041;06;440;229;211
033;001;001;042;01;440;242;198
033;001;001;042;02;440;223;217
033;001;001;042;03;438;232;206
033;001;001;042;04;432;221;211
033;001;001;042;05;432;190;242
033;001;001;042;06;432;240;192
033;001;001;043;01;424;258;166
033;001;001;043;02;424;225;199
033;001;001;043;03;424;211;213
033;001;001;043;04;418;240;178
033;001;001;044;01;381;199;182
033;001;001;044;02;376;204;172
033;001;001;045;01;440;202;238
033;001;001;045;02;440;201;239
033;001;001;045;03;440;214;226
033;001;001;045;04;435;212;223
033;001;001;045;05;432;227;205
033;001;001;046;01;113;52;61
033;001;001;047;01;151;77;74
033;001;001;048;01;296;145;151
033;001;001;048;02;290;143;147
033;001;001;049;01;220;121;99
033;001;001;050;01;253;112;141
033;001;001;050;02;248;107;141
033;001;001;051;01;434;232;202
033;001;001;052;01;100;57;43
033;001;001;053;01;262;140;122
033;001;001;054;01;227;109;118
033;001;001;055;01;338;150;188
033;001;001;056;01;269;149;120
033;001;001;056;02;264;148;116
033;001;001;057;01;296;138;158
033;001;001;057;02;292;137;155
033;001;098;001;01;417;203;214
033;001;098;002;01;378;197;181
033;001;098;003;01;295;146;149
033;001;098;004;01;320;164;156
033;001;098;004;02;319;158;161
033;001;098;005;01;206;126;80
033;001;098;006;01;409;190;219
033;001;098;007;01;219;107;112
033;001;098;008;01;227;111;116
033;001;098;009;01;278;147;131
033;001;098;010;01;348;178;170
033;001;098;011;01;67;38;29
033;001;098;012;01;279;134;145
033;001;098;012;02;272;148;124
033;001;098;013;01;347;176;171
033;001;098;014;01;430;216;214
033;001;098;015;01;156;89;67
033;001;098;016;01;393;183;210
033;001;098;017;01;148;101;47
033;001;098;018;01;304;175;129
033;001;098;018;02;299;176;123
033;001;098;019;01;148;88;60
033;001;098;020;01;373;195;178
033;001;098;021;01;156;89;67
033;001;098;022;01;131;79;52
033;001;098;023;01;311;168;143
033;001;098;024;01;218;130;88
033;001;098;025;01;302;147;155
033;001;098;026;01;389;206;183
033;001;098;027;01;272;161;111
033;001;098;028;01;232;122;110
033;001;098;029;01;443;231;212
033;001;098;030;01;130;78;52
033;001;098;031;01;293;154;139
033;001;098;031;02;288;133;155
033;001;098;032;01;382;189;193
033;001;098;032;02;376;188;188
033;001;098;033;01;130;76;54
033;001;098;034;01;316;175;141
033;001;098;035;01;286;155;131
033;001;098;036;01;427;237;190
033;001;098;037;01;281;136;145
033;001;098;038;01;331;168;163
033;001;098;039;01;280;130;150
033;001;098;040;01;360;202;158
033;001;098;041;01;331;172;159
033;001;098;042;01;376;189;187
033;001;098;043;01;384;183;201
033;001;098;044;01;310;149;161
033;001;098;045;01;310;159;151
033;001;098;046;01;335;194;141
033;001;098;047;01;418;235;183
033;001;098;047;02;416;198;218
033;001;098;048;01;438;210;228
033;001;098;049;01;241;133;108
033;001;098;050;01;295;152;143
033;001;098;051;01;292;160;132
033;001;098;052;01;185;107;78
033;001;098;053;01;150;85;65
033;001;098;054;01;396;225;171
033;001;098;055;01;121;64;57
033;001;098;056;01;336;189;147
033;001;098;057;01;344;176;168
033;001;098;057;02;338;182;156
033;001;098;058;01;360;227;133
033;001;098;059;01;110;67;43
033;001;098;060;01;135;67;68
033;001;098;061;01;254;119;135
033;001;098;061;02;248;122;126
033;001;098;062;01;416;232;184
033;001;098;062;02;413;251;162
033;001;098;063;01;109;56;53
033;001;098;064;01;399;236;163
033;001;098;064;02;392;217;175
033;001;098;065;01;58;36;22
033;002;098;001;01;232;115;117
033;002;098;001;02;228;116;112
033;002;098;002;01;391;199;192
033;002;098;003;01;161;87;74
033;002;098;004;01;408;245;163
033;002;098;004;02;408;190;218
033;002;098;004;03;408;231;177
033;002;098;004;04;405;242;163
033;002;098;005;01;256;132;124
033;002;098;005;02;253;147;106
033;002;098;006;01;272;139;133
033;002;098;007;01;444;281;163
033;003;001;001;01;352;153;199
033;003;001;001;02;344;168;176
033;003;001;001;03;344;152;192
033;003;001;002;01;426;215;211
033;003;001;002;02;424;210;214
033;003;001;003;01;435;232;203
033;003;001;003;02;432;231;201
033;003;001;003;03;432;226;206
033;003;001;004;01;360;177;183
033;003;001;004;02;360;187;173
033;003;001;004;03;357;178;179
033;003;001;004;04;352;186;166
033;003;001;005;01;351;158;193
033;003;001;005;02;344;161;183
033;003;001;005;03;344;179;165
033;003;001;006;01;424;233;191
033;003;001;006;02;416;212;204
033;003;001;006;03;416;235;181
033;003;001;007;01;332;180;152
033;003;001;008;01;414;207;207
033;003;001;009;01;377;187;190
033;003;001;010;01;223;108;115
033;003;001;011;01;289;161;128
033;003;001;012;01;194;103;91
033;003;001;013;01;270;147;123
033;003;001;014;01;256;134;122
033;003;001;014;02;255;130;125
033;003;001;015;01;380;185;195
033;003;001;016;01;367;198;169
033;003;001;016;02;360;167;193
033;003;001;017;01;242;128;114
033;003;001;017;02;240;146;94
033;003;001;018;01;148;72;76
033;003;001;019;01;134;84;50
033;003;001;020;01;61;41;20
033;003;098;001;01;363;162;201
033;003;098;002;01;202;118;84
033;003;098;003;01;362;168;194
033;003;098;004;01;308;159;149
033;003;098;005;01;142;83;59
033;003;098;006;01;319;151;168
033;003;098;006;02;312;137;175
033;003;098;007;01;407;202;205
033;003;098;008;01;62;32;30
033;003;098;009;01;180;95;85
033;003;098;010;01;35;23;12
033;003;098;011;01;59;26;33
033;003;098;012;01;166;86;80
033;003;098;013;01;119;58;61
033;003;098;014;01;273;128;145
033;003;098;014;02;272;139;133
033;003;098;015;01;248;133;115
033;003;098;016;01;130;72;58
033;003;098;017;01;242;143;99
033;003;098;018;01;125;70;55
033;003;098;019;01;123;68;55
033;003;098;020;01;192;98;94
033;003;098;021;01;288;159;129
033;003;098;022;01;208;108;100
033;003;098;023;01;208;115;93
033;003;098;024;01;256;126;130
033;003;098;025;01;117;65;52
033;003;098;026;01;151;76;75
033;003;098;027;01;78;45;33
033;003;098;028;01;82;43;39
033;004;001;001;01;344;158;186
033;004;001;001;02;340;176;164
033;004;001;001;03;336;194;142
033;004;001;001;04;336;188;148
033;004;001;002;01;408;191;217
033;004;001;002;02;408;211;197
033;004;001;002;03;407;190;217
033;004;001;002;04;400;203;197
033;004;001;003;01;360;162;198
033;004;001;003;02;354;194;160
033;004;001;003;03;352;201;151
033;004;001;004;01;156;83;73
033;004;001;005;01;401;233;168
033;004;001;006;01;402;185;217
033;004;001;006;02;400;202;198
033;004;001;007;01;320;165;155
033;004;001;007;02;320;157;163
033;004;001;007;03;317;166;151
033;004;001;008;01;382;213;169
033;004;001;008;02;376;217;159
033;004;001;009;01;262;133;129
033;004;001;009;02;256;137;119
033;004;001;010;01;183;109;74
033;004;001;011;01;166;86;80
033;004;001;012;01;252;132;120
033;004;001;013;01;192;109;83
033;004;001;014;01;232;125;107
033;004;001;015;01;402;220;182
033;004;001;016;01;235;137;98
033;004;001;017;01;304;138;166
033;004;001;017;02;304;156;148
033;004;001;017;03;303;134;169
033;004;001;018;01;352;192;160
033;004;001;018;02;347;179;168
033;004;001;019;01;250;141;109
033;004;001;020;01;408;186;222
033;004;001;020;02;405;225;180
033;004;001;020;03;400;207;193
033;004;001;021;01;272;147;125
033;004;001;022;01;310;173;137
033;004;098;001;01;200;111;89
033;004;098;002;01;285;148;137
033;004;098;002;02;280;161;119
033;004;098;003;01;162;96;66
033;004;098;004;01;194;109;85
033;004;098;005;01;203;110;93
033;004;098;006;01;232;121;111
033;004;098;007;01;307;130;177
033;004;098;008;01;53;36;17
033;004;098;009;01;60;38;22
033;004;098;010;01;36;22;14
033;005;098;001;01;401;198;203
033;005;098;001;02;400;185;215
033;005;098;001;03;400;207;193
033;005;098;001;04;400;202;198
033;005;098;002;01;395;229;166
033;005;098;002;02;392;219;173
033;005;098;003;01;367;199;168
033;005;098;003;02;360;163;197
033;005;098;003;03;360;194;166
033;005;098;003;04;360;180;180
033;005;098;004;01;424;202;222
033;005;098;004;02;418;221;197
033;005;098;005;01;448;205;243
033;005;098;005;02;448;210;238
033;005;098;006;01;416;239;177
033;005;098;007;01;120;58;62
033;005;098;008;01;407;203;204
033;005;098;009;01;249;126;123
033;005;098;010;01;227;117;110
033;005;098;011;01;276;124;152
033;005;098;011;02;272;138;134
033;005;098;012;01;323;141;182
033;005;098;012;02;320;141;179
033;005;098;013;01;448;225;223
033;005;098;013;02;443;209;234
033;005;098;014;01;272;132;140
033;005;098;014;02;269;134;135
033;005;098;015;01;441;216;225
033;005;098;016;01;332;185;147
033;005;098;017;01;87;50;37
033;005;098;018;01;264;152;112
033;005;098;019;01;215;106;109
033;005;098;020;01;218;107;111
033;005;098;021;01;408;208;200
033;005;098;021;02;400;183;217
033;005;098;022;01;256;139;117
033;005;098;023;01;86;55;31
033;005;098;024;01;204;117;87
033;005;098;025;01;179;96;83
033;005;098;026;01;123;64;59
033;005;098;027;01;256;126;130
033;005;098;027;02;250;133;117
033;005;098;028;01;60;27;33
033;005;098;029;01;163;84;79
033;005;098;030;01;136;63;73
033;005;098;031;01;126;61;65
033;005;098;032;01;61;36;25
033;005;098;033;01;312;153;159
033;005;098;033;02;309;148;161
033;005;098;034;01;143;75;68
033;005;098;035;01;175;99;76
033;005;098;036;01;139;72;67
033;005;098;037;01;238;127;111
033;005;098;038;01;332;188;144
033;005;098;041;01;336;171;165
033;006;098;001;01;262;126;136
033;006;098;001;02;256;147;109
033;006;098;002;01;240;136;104
033;006;098;002;02;235;129;106
033;006;098;003;01;288;150;138
033;006;098;003;02;288;126;162
033;006;098;004;01;150;77;73
033;006;098;005;01;141;89;52
033;006;098;006;01;448;224;224
033;006;098;007;01;74;44;30
033;006;098;008;01;337;167;170
033;006;098;009;01;248;121;127
033;006;098;009;02;247;124;123
033;006;098;010;01;280;148;132
033;006;098;010;02;276;157;119
033;006;098;011;01;437;215;222
033;006;098;012;01;240;117;123
033;006;098;012;02;232;118;114
033;006;098;013;01;369;203;166
033;007;098;001;01;444;220;224
033;007;098;002;01;432;204;228
033;007;098;002;02;432;210;222
033;007;098;002;03;428;196;232
033;007;098;003;01;401;202;199
033;007;098;003;02;400;211;189
033;007;098;003;03;400;234;166
033;007;098;004;01;160;93;67
033;007;098;005;01;229;138;91
033;007;098;005;02;224;126;98
033;007;098;006;01;91;44;47
033;007;098;007;01;304;152;152
033;007;098;007;02;303;156;147
033;007;098;008;01;125;66;59
033;007;098;009;01;288;149;139
033;007;098;009;02;284;131;153
033;007;098;010;01;436;220;216
033;007;098;011;01;274;144;130
033;007;098;012;01;323;154;169
033;007;098;013;01;346;170;176
033;007;098;014;01;142;73;69
033;007;098;015;01;218;117;101
033;007;098;016;01;210;115;95
033;007;098;017;01;64;42;22
033;007;098;018;01;43;27;16
033;008;098;004;01;253;142;111
033;008;098;004;02;248;139;109
033;008;098;013;01;265;150;115
033;008;098;014;01;297;146;151
033;008;098;017;01;197;118;79
033;009;098;001;01;287;169;118
033;009;098;002;01;300;161;139
033;009;098;002;02;296;157;139
033;009;098;003;01;119;80;39
033;009;098;004;01;341;196;145
033;009;098;005;01;252;127;125
033;009;098;006;01;94;59;35
033;009;098;007;01;232;124;108
033;009;098;008;01;421;238;183
033;010;098;001;01;337;167;170
033;010;098;002;01;305;140;165
033;010;098;003;01;304;148;156
033;010;098;003;02;303;154;149
033;010;098;004;01;347;190;157
033;010;098;005;01;318;177;141
033;010;098;006;01;357;194;163
033;010;098;007;01;304;175;129
033;010;098;007;02;304;156;148
033;010;098;007;03;297;169;128
033;010;098;008;01;192;107;85
033;010;098;009;01;424;199;225
033;010;098;009;02;424;209;215
033;010;098;009;03;424;207;217
033;010;098;009;04;423;204;219
033;010;098;010;01;360;182;178
033;010;098;010;02;352;200;152
033;010;098;011;01;301;153;148
033;010;098;012;01;75;46;29
033;010;098;013;01;119;71;48
033;011;098;001;01;358;183;175
033;011;098;002;01;336;176;160
033;011;098;002;02;336;178;158
033;011;098;002;03;330;176;154
033;011;098;003;01;240;118;122
033;011;098;003;02;235;123;112
033;011;098;004;01;195;111;84
033;011;098;005;01;237;115;122
033;011;098;005;02;232;132;100
033;011;098;006;01;110;62;48
033;011;098;007;01;225;140;85
033;011;098;008;01;199;109;90
033;011;098;009;01;227;131;96
033;011;098;010;01;348;194;154
033;011;098;011;01;359;198;161
033;011;098;012;01;195;122;73
033;011;098;013;01;280;146;134
033;011;098;013;02;277;158;119
033;011;098;014;01;382;185;197
033;011;098;015;01;401;236;165
033;011;098;016;01;337;183;154
033;011;098;017;01;264;147;117
033;011;098;018;01;237;125;112
033;011;098;019;01;206;128;78
033;011;098;020;01;190;108;82
033;011;098;021;01;87;66;21
033;011;098;022;01;109;71;38
033;011;098;023;01;114;59;55
033;012;098;001;01;344;178;166
033;012;098;001;02;336;169;167
033;012;098;002;01;386;187;199
033;012;098;003;01;155;86;69
033;012;098;004;01;120;70;50
033;012;098;005;01;203;111;92
033;012;098;006;01;282;139;143
033;012;098;006;02;280;141;139
033;012;098;007;01;429;217;212
033;012;098;008;01;277;136;141
033;012;098;009;01;318;177;141
033;012;098;009;02;312;168;144
033;012;098;009;03;312;163;149
033;012;098;010;01;186;109;77
033;012;098;011;01;156;86;70
033;012;098;012;01;232;122;110
033;012;098;012;02;230;111;119
033;012;098;013;01;336;184;152
033;012;098;013;02;331;175;156
033;012;098;014;01;248;112;136
033;012;098;014;02;240;98;142
033;012;098;015;01;292;145;147
033;012;098;015;02;288;130;158
033;012;098;016;01;101;55;46
033;012;098;017;01;52;27;25
034;001;001;001;01;416;216;200
034;001;001;001;02;410;209;201
034;001;001;001;03;408;215;193
034;001;001;001;04;408;188;220
034;001;001;001;05;408;222;186
034;001;001;001;06;408;214;194
034;001;001;002;01;400;224;176
034;001;001;002;02;394;204;190
034;001;001;002;03;392;204;188
034;001;001;002;04;392;243;149
034;001;001;002;05;392;234;158
034;001;001;003;01;445;229;216
034;001;001;003;02;440;217;223
034;001;001;003;03;440;240;200
034;001;001;003;04;440;214;226
034;001;001;003;05;440;271;169
034;001;001;004;01;408;209;199
034;001;001;004;02;408;221;187
034;001;001;004;03;408;213;195
034;001;001;004;04;407;250;157
034;001;001;004;05;400;223;177
034;001;001;005;01;376;199;177
034;001;001;005;02;375;178;197
034;001;001;006;01;207;118;89
034;001;001;007;01;407;221;186
034;001;001;007;02;400;228;172
034;001;001;008;01;305;164;141
034;001;001;010;01;301;171;130
034;001;001;010;02;296;181;115
034;001;001;012;01;448;222;226
034;001;001;012;02;448;245;203
034;001;001;012;03;448;259;189
034;001;001;012;04;448;229;219
034;001;001;012;05;442;272;170
034;001;001;013;01;292;152;140
034;001;001;013;02;288;139;149
034;001;001;014;01;322;162;160
034;001;001;014;02;320;166;154
034;001;001;015;01;322;171;151
034;001;001;016;01;448;257;191
034;001;001;016;02;448;236;212
034;001;001;016;03;448;264;184
034;001;001;016;04;442;271;171
034;001;001;017;01;163;87;76
034;001;001;018;01;428;235;193
034;001;001;018;02;424;221;203
034;001;001;018;03;424;244;180
034;001;001;020;01;248;124;124
034;001;001;022;01;77;43;34
034;001;001;023;01;341;188;153
034;001;098;001;01;107;51;56
034;001;098;002;01;288;141;147
034;001;098;002;02;281;148;133
034;001;098;003;01;256;132;124
034;001;098;003;02;249;122;127
034;001;098;004;01;384;192;192
034;001;098;005;01;366;185;181
034;001;098;006;01;450;239;211
034;001;098;007;01;245;150;95
034;001;098;007;02;240;124;116
034;001;098;008;01;400;194;206
034;001;098;008;02;395;207;188
034;001;098;009;01;233;129;104
034;001;098;009;02;232;113;119
034;001;098;010;01;161;89;72
034;001;098;011;01;281;144;137
034;001;098;012;01;280;144;136
034;001;098;012;02;277;140;137
034;001;098;013;01;297;156;141
034;001;098;014;01;140;73;67
034;001;098;015;01;152;77;75
034;001;098;016;01;134;77;57
034;001;098;017;01;114;71;43
034;002;001;001;01;448;222;226
034;002;001;001;02;448;234;214
034;002;001;001;03;443;236;207
034;002;001;001;04;440;248;192
034;002;001;001;05;440;249;191
034;002;001;002;01;432;182;250
034;002;001;002;02;432;208;224
034;002;001;002;03;432;213;219
034;002;001;002;04;431;212;219
034;002;001;003;01;336;177;159
034;002;001;003;02;333;180;153
034;002;001;003;03;328;204;124
034;002;001;004;01;399;209;190
034;002;001;004;02;392;201;191
034;002;001;004;03;392;215;177
034;002;001;004;04;392;199;193
034;002;001;004;05;392;214;178
034;002;001;005;01;408;205;203
034;002;001;005;02;408;240;168
034;002;001;005;03;408;232;176
034;002;001;005;04;408;202;206
034;002;001;005;05;408;211;197
034;002;001;005;06;400;207;193
034;002;001;006;01;328;176;152
034;002;001;006;02;326;177;149
034;002;001;006;03;320;168;152
034;002;001;007;01;344;164;180
034;002;001;007;02;344;180;164
034;002;001;007;03;343;176;167
034;002;001;008;01;328;197;131
034;002;001;008;02;325;204;121
034;002;001;009;01;391;174;217
034;002;001;009;02;384;197;187
034;002;001;009;03;384;181;203
034;002;001;009;04;384;192;192
034;002;001;010;01;400;201;199
034;002;001;010;02;400;198;202
034;002;001;010;03;394;191;203
034;002;001;010;04;392;185;207
034;002;001;010;05;392;203;189
034;002;001;010;06;392;196;196
034;002;001;011;01;352;186;166
034;002;001;011;02;352;166;186
034;002;001;011;03;347;162;185
034;002;001;012;01;446;223;223
034;002;001;012;02;440;218;222
034;002;001;012;03;440;239;201
034;002;001;012;04;440;249;191
034;002;001;012;05;440;251;189
034;002;001;013;01;72;39;33
034;002;001;014;01;149;69;80
034;002;001;015;01;207;111;96
034;002;001;016;01;102;53;49
034;002;001;017;01;58;36;22
034;002;001;018;01;57;40;17
034;002;001;019;01;357;180;177
034;002;001;020;01;177;97;80
034;002;001;021;01;246;133;113
034;002;001;022;01;360;190;170
034;002;001;022;02;359;194;165
034;002;001;023;01;189;90;99
034;002;001;024;01;273;133;140
034;002;001;025;01;333;198;135
034;002;001;026;01;138;64;74
034;002;001;027;01;148;78;70
034;002;001;028;01;138;77;61
034;002;001;029;01;384;202;182
034;002;001;029;02;381;192;189
034;002;001;030;01;368;184;184
034;002;001;030;02;362;184;178
034;002;001;031;01;145;81;64
034;002;001;032;01;262;127;135
034;002;001;033;01;75;42;33
034;002;001;034;01;121;67;54
034;002;001;035;01;125;68;57
034;002;001;036;01;288;161;127
034;002;001;036;02;282;153;129
034;002;001;038;01;53;30;23
034;002;001;039;01;67;36;31
034;002;001;040;01;113;60;53
034;002;001;041;01;89;54;35
034;002;001;042;01;279;130;149
034;002;001;043;01;383;201;182
034;002;001;044;01;322;152;170
034;002;001;045;01;118;63;55
034;002;098;001;01;385;202;183
034;002;098;001;02;384;211;173
034;002;098;002;01;85;61;24
034;002;098;003;01;154;89;65
034;002;098;004;01;66;30;36
034;002;098;005;01;43;24;19
034;002;098;006;01;89;46;43
034;002;098;007;01;131;75;56
034;002;098;008;01;166;89;77
034;002;098;009;01;206;117;89
034;002;098;010;01;212;114;98
034;002;098;011;01;236;125;111
034;002;098;012;01;228;118;110
034;002;098;013;01;443;211;232
034;002;098;013;02;440;205;235
034;002;098;014;01;248;137;111
034;002;098;014;02;240;130;110
034;002;098;015;01;196;94;102
034;002;098;017;01;432;230;202
034;002;098;017;02;432;226;206
034;002;098;017;03;428;209;219
034;002;098;017;04;424;219;205
034;002;098;018;01;251;125;126
034;002;098;019;01;267;128;139
034;002;098;020;01;199;113;86
034;002;098;021;01;363;179;184
034;002;098;022;01;172;108;64
034;002;098;023;01;268;140;128
034;002;098;024;01;161;83;78
034;002;098;025;01;323;173;150
034;002;098;026;01;382;183;199
034;002;098;027;01;130;72;58
034;002;098;028;01;423;213;210
034;002;098;029;01;424;208;216
034;002;098;029;02;417;217;200
034;002;098;030;01;124;70;54
034;002;098;031;01;105;54;51
034;002;098;032;01;148;83;65
034;002;098;033;01;312;176;136
034;002;098;033;02;311;170;141
034;002;098;034;01;257;142;115
034;002;098;034;02;256;146;110
034;002;098;035;01;232;125;107
034;002;098;036;01;98;52;46
034;002;098;037;01;248;128;120
034;002;098;037;02;243;137;106
034;002;098;038;01;130;82;48
034;002;098;039;01;124;67;57
034;002;098;040;01;256;118;138
034;002;098;040;02;254;126;128
034;002;098;041;01;224;124;100
034;002;098;042;01;212;121;91
034;002;098;043;01;119;60;59
034;002;098;044;01;86;45;41
034;003;098;001;01;283;154;129
034;003;098;001;02;280;146;134
034;003;098;002;01;190;102;88
034;003;098;003;01;287;139;148
034;003;098;004;01;379;185;194
034;003;098;005;01;352;170;182
034;003;098;005;02;352;161;191
034;003;098;005;03;351;182;169
034;003;098;005;04;344;180;164
034;003;098;006;01;243;122;121
034;003;098;007;01;313;161;152
034;003;098;008;01;180;90;90
034;003;098;009;01;448;205;243
034;003;098;010;01;138;69;69
034;003;098;011;01;232;123;109
034;003;098;011;02;229;117;112
034;003;098;012;01;176;97;79
034;003;098;013;01;411;205;206
034;003;098;013;02;408;226;182
034;003;098;014;01;214;114;100
034;003;098;015;01;44;23;21
034;003;098;016;01;59;29;30
034;003;098;017;01;272;141;131
034;003;098;017;02;264;142;122
034;003;098;019;01;88;59;29
034;003;098;020;01;90;51;39
034;004;098;001;01;308;152;156
034;004;098;001;02;304;163;141
034;004;098;001;03;304;153;151
034;004;098;002;01;352;170;182
034;004;098;002;02;344;182;162
034;004;098;003;01;70;36;34
034;004;098;004;01;336;188;148
034;004;098;004;02;335;148;187
034;004;098;005;01;225;120;105
034;004;098;006;01;118;58;60
034;004;098;007;01;270;128;142
034;004;098;007;02;264;128;136
034;004;098;008;01;256;127;129
034;004;098;008;02;252;139;113
034;004;098;009;01;432;224;208
034;004;098;009;02;429;214;215
034;004;098;009;03;424;218;206
034;004;098;010;01;227;130;97
034;004;098;011;01;169;90;79
034;004;098;012;01;209;105;104
034;004;098;013;01;413;198;215
034;004;098;014;01;175;98;77
034;004;098;015;01;109;61;48
034;004;098;016;01;125;70;55
034;004;098;017;01;196;103;93
034;004;098;018;01;103;53;50
034;004;098;019;01;113;61;52
034;004;098;020;01;170;84;86
035;001;001;001;01;400;216;184
035;001;001;001;02;400;214;186
035;001;001;001;03;399;210;189
035;001;001;001;04;392;204;188
035;001;001;001;05;392;202;190
035;001;001;002;01;376;201;175
035;001;001;002;02;376;206;170
035;001;001;002;03;376;234;142
035;001;001;002;04;376;205;171
035;001;001;002;05;375;225;150
035;001;001;003;01;440;218;222
035;001;001;003;02;437;255;182
035;001;001;003;03;432;249;183
035;001;001;004;01;365;171;194
035;001;001;004;02;360;176;184
035;001;001;004;03;360;181;179
035;001;001;004;04;360;187;173
035;001;001;005;01;389;189;200
035;001;001;005;02;384;191;193
035;001;001;005;03;384;198;186
035;001;001;005;04;384;166;218
035;001;001;005;05;384;203;181
035;001;001;006;01;426;233;193
035;001;001;006;02;424;253;171
035;001;001;006;03;424;232;192
035;001;001;006;04;424;252;172
035;001;001;007;01;424;205;219
035;001;001;007;02;424;231;193
035;001;001;007;03;419;203;216
035;001;001;007;04;416;207;209
035;001;001;008;01;432;214;218
035;001;001;008;02;432;205;227
035;001;001;008;03;426;216;210
035;001;001;009;01;424;165;259
035;001;001;009;02;424;206;218
035;001;001;009;03;424;196;228
035;001;001;009;04;424;202;222
035;001;001;009;05;424;195;229
035;001;001;009;06;424;200;224
035;001;001;009;07;424;164;260
035;001;001;009;08;424;232;192
035;001;001;009;09;423;214;209
035;001;001;010;01;357;160;197
035;001;001;010;02;352;169;183
035;001;001;010;03;352;183;169
035;001;001;010;04;352;197;155
035;001;001;011;01;411;178;233
035;001;001;011;02;408;201;207
035;001;001;011;03;408;193;215
035;001;001;011;04;408;197;211
035;001;001;012;01;416;216;200
035;001;001;012;02;416;206;210
035;001;001;012;03;414;232;182
035;001;001;013;01;136;69;67
035;001;001;014;01;257;122;135
035;001;001;015;01;179;97;82
035;001;001;016;01;179;87;92
035;001;001;017;01;333;177;156
035;001;001;018;01;281;151;130
035;001;001;019;01;348;139;209
035;001;001;019;02;344;178;166
035;001;001;020;01;328;153;175
035;001;001;020;02;328;155;173
035;001;001;020;03;322;168;154
035;001;001;021;01;209;91;118
035;001;001;022;01;408;170;238
035;001;001;022;02;408;200;208
035;001;001;022;03;408;208;200
035;001;001;022;04;404;162;242
035;001;001;022;05;400;241;159
035;001;001;023;01;384;186;198
035;001;001;023;02;384;182;202
035;001;001;023;03;384;197;187
035;001;001;023;04;378;163;215
035;001;001;023;05;376;185;191
035;001;001;024;01;448;208;240
035;001;001;024;02;448;230;218
035;001;001;024;03;448;248;200
035;001;001;024;04;445;197;248
035;001;001;024;05;440;255;185
035;001;001;025;01;340;176;164
035;001;001;025;02;336;196;140
035;001;001;025;03;336;187;149
035;001;001;026;01;427;201;226
035;001;001;026;02;424;220;204
035;001;001;026;03;424;230;194
035;001;001;027;01;408;172;236
035;001;001;027;02;408;223;185
035;001;001;027;03;408;205;203
035;001;001;027;04;408;206;202
035;001;001;027;05;402;184;218
035;001;001;027;06;400;216;184
035;001;001;028;01;384;217;167
035;001;001;028;02;384;175;209
035;001;001;028;03;384;219;165
035;001;001;028;04;384;197;187
035;001;001;028;05;384;213;171
035;001;001;029;01;176;95;81
035;001;001;030;01;336;191;145
035;001;001;030;02;329;175;154
035;001;001;030;03;328;169;159
035;001;001;031;01;84;51;33
035;001;001;032;01;340;174;166
035;001;001;033;01;178;113;65
035;001;001;034;01;400;203;197
035;001;001;034;02;400;201;199
035;001;001;034;03;396;208;188
035;001;001;034;04;392;188;204
035;001;001;035;01;203;98;105
035;001;001;036;01;136;74;62
035;001;001;037;01;66;44;22
035;001;098;001;01;155;84;71
035;001;098;002;01;400;161;239
035;001;098;002;02;399;174;225
035;001;098;003;01;449;175;274
035;001;098;003;02;448;217;231
035;001;098;004;01;96;46;50
035;001;098;005;01;194;100;94
035;001;098;006;01;293;134;159
035;001;098;007;01;127;60;67
035;001;098;008;01;282;124;158
035;001;098;008;02;280;106;174
035;001;098;009;01;116;53;63
035;001;098;010;01;104;54;50
035;001;098;011;01;158;71;87
035;001;098;012;01;271;107;164
035;001;098;012;02;264;137;127
035;001;098;013;01;269;120;149
035;001;098;014;01;182;90;92
035;001;098;015;01;125;63;62
035;001;098;016;01;234;112;122
035;001;098;017;01;115;57;58
035;001;098;018;01;305;166;139
035;001;098;019;01;357;202;155
035;001;098;020;01;408;176;232
035;001;098;020;02;408;205;203
035;001;098;020;03;404;207;197
035;002;098;001;01;247;113;134
035;002;098;002;01;105;52;53
035;002;098;003;01;242;116;126
035;002;098;004;01;102;49;53
035;002;098;005;01;176;88;88
035;002;098;006;01;108;57;51
035;002;098;007;01;432;175;257
035;002;098;007;02;432;212;220
035;002;098;007;03;432;228;204
035;002;098;007;04;426;210;216
035;002;098;007;05;424;220;204
035;002;098;008;01;91;44;47
035;002;098;009;01;424;197;227
035;002;098;010;01;124;61;63
035;002;098;011;01;47;24;23
035;002;098;012;01;269;134;135
035;002;098;012;02;264;138;126
035;002;098;013;01;152;84;68
035;002;098;014;01;255;110;145
035;002;098;015;01;198;99;99
035;002;098;016;01;237;121;116
035;002;098;017;01;233;120;113
035;002;098;018;01;280;110;170
035;002;098;018;02;277;132;145
035;002;098;019;01;336;150;186
035;002;098;019;02;332;148;184
035;002;098;019;03;328;167;161
035;002;098;020;01;257;125;132
035;002;098;021;01;260;112;148
035;002;098;022;01;183;91;92
035;002;098;023;01;242;125;117
035;002;098;024;01;73;33;40
035;004;098;001;01;145;71;74
035;004;098;002;01;249;108;141
035;004;098;003;01;352;140;212
035;004;098;003;02;352;187;165
035;004;098;003;03;352;177;175
035;004;098;003;04;344;159;185
035;004;098;004;01;366;124;242
035;004;098;004;02;360;185;175
035;004;098;004;03;360;164;196
035;004;098;004;04;360;173;187
035;004;098;004;05;360;167;193
035;004;098;006;01;185;94;91
035;004;098;007;01;212;100;112
035;005;098;002;01;191;81;110
035;005;098;003;01;431;175;256
035;005;098;004;01;392;197;195
035;005;098;004;02;386;185;201
035;005;098;005;01;213;103;110
035;005;098;006;01;275;134;141
035;005;098;007;01;201;105;96
035;005;098;010;01;365;193;172
035;005;098;011;01;400;207;193
035;005;098;012;01;127;68;59
035;005;098;013;01;125;67;58
035;005;098;014;01;232;126;106
035;005;098;015;01;273;150;123
035;005;098;016;01;384;197;187
035;005;098;016;02;384;206;178
035;005;098;016;03;384;196;188
035;005;098;016;04;379;200;179
035;005;098;016;05;376;79;297
035;005;098;016;06;376;280;96
035;005;098;017;01;374;194;180
035;005;098;017;02;368;183;185
035;005;098;017;03;368;213;155
035;005;098;018;01;176;84;92
035;005;098;019;01;174;95;79
035;005;098;020;01;352;179;173
035;005;098;020;02;352;209;143
035;005;098;020;03;352;167;185
035;005;098;021;01;408;166;242
035;005;098;021;02;408;213;195
035;005;098;021;03;408;203;205
035;005;098;021;04;408;238;170
035;005;098;021;05;408;243;165
035;005;098;021;06;402;210;192
035;005;098;022;01;326;167;159
035;005;098;023;01;307;165;142
035;005;098;023;02;304;177;127
035;006;098;001;01;320;121;199
035;006;098;001;02;312;183;129
035;006;098;001;03;312;150;162
035;006;098;002;01;320;177;143
035;006;098;002;02;316;169;147
035;006;098;003;01;203;93;110
035;006;098;004;01;289;127;162
035;006;098;005;01;351;106;245
035;006;098;005;02;344;167;177
035;006;098;005;03;344;189;155
035;006;098;005;04;344;161;183
035;006;098;006;01;432;177;255
035;006;098;006;02;432;201;231
035;006;098;006;03;426;204;222
035;006;098;007;01;333;149;184
035;006;098;008;01;423;181;242
035;006;098;009;01;259;120;139
035;006;098;010;01;287;133;154
035;006;098;011;01;261;95;166
035;006;098;011;02;256;121;135
035;006;098;012;01;349;150;199
035;006;098;013;01;271;127;144
035;006;098;014;01;329;137;192
035;006;098;015;01;228;107;121
035;006;098;016;01;248;94;154
035;006;098;016;02;248;136;112
035;006;098;017;01;60;30;30
035;006;098;018;01;328;148;180
035;006;098;018;02;328;174;154
035;006;098;018;03;320;175;145
035;006;098;019;01;164;70;94
035;007;098;001;01;368;173;195
035;007;098;002;01;163;71;92
035;007;098;003;01;255;114;141
035;007;098;004;01;63;30;33
035;007;098;005;01;294;137;157
035;007;098;006;01;237;109;128
035;007;098;007;01;376;178;198
035;007;098;007;02;368;191;177
035;007;098;008;01;303;155;148
035;007;098;009;01;241;118;123
035;007;098;011;01;50;33;17
035;008;098;001;01;424;198;226
035;008;098;002;01;328;121;207
035;008;098;002;02;320;138;182
035;008;098;002;03;320;151;169
035;008;098;003;01;384;202;182
035;008;098;003;02;384;100;284
035;008;098;003;03;377;208;169
035;008;098;004;01;204;94;110
035;008;098;005;01;443;174;269
035;008;098;005;02;440;202;238
035;008;098;005;03;440;247;193
035;008;098;006;01;190;103;87
035;008;098;007;01;292;118;174
035;008;098;008;01;176;83;93
035;008;098;009;01;191;97;94
035;008;098;010;01;154;86;68
035;008;098;011;01;248;113;135
035;008;098;012;01;272;110;162
035;008;098;012;02;265;128;137
035;008;098;013;01;361;167;194
035;008;098;014;01;240;141;99
035;008;098;014;02;232;119;113
035;008;098;015;01;140;70;70
035;008;098;016;01;89;48;41
035;008;098;017;01;129;78;51
035;008;098;018;01;82;44;38
035;009;098;001;01;232;114;118
035;009;098;001;02;227;99;128
035;009;098;002;01;53;27;26
035;009;098;003;01;116;58;58
035;009;098;004;01;238;110;128
035;009;098;005;01;171;74;97
035;009;098;006;01;284;120;164
035;009;098;007;01;414;165;249
035;009;098;007;02;408;220;188
035;009;098;007;03;408;186;222
035;009;098;008;01;403;171;232
035;009;098;008;02;400;171;229
035;009;098;009;01;433;180;253
035;009;098;009;02;432;239;193
035;009;098;010;01;248;91;157
035;009;098;010;02;245;111;134
035;009;098;011;01;93;48;45
035;009;098;012;01;180;110;70
035;009;098;013;01;408;199;209
035;009;098;013;02;408;223;185
035;009;098;013;03;406;196;210
035;009;098;013;04;400;230;170
035;009;098;014;01;256;139;117
035;009;098;014;02;252;150;102
035;009;098;015;01;118;71;47
035;009;098;016;01;267;167;100
035;009;098;016;02;264;174;90
035;009;098;017;01;160;85;75
035;009;098;018;01;397;244;153
035;009;098;018;02;392;251;141
035;009;098;019;01;120;55;65
035;009;098;020;01;221;105;116
035;009;098;021;01;154;76;78
035;009;098;022;01;448;216;232
035;009;098;022;02;441;222;219
035;009;098;022;03;440;233;207
035;009;098;022;04;440;224;216
035;009;098;023;01;279;156;123
035;009;098;023;02;272;153;119
035;009;098;024;01;344;160;184
035;009;098;024;02;339;157;182
035;009;098;025;01;392;220;172
035;009;098;025;02;388;228;160
035;009;098;026;01;168;102;66
035;009;098;027;01;184;100;84
035;009;098;028;01;241;147;94
035;009;098;029;01;312;161;151
035;009;098;029;02;307;189;118
035;009;098;031;01;294;174;120
035;009;098;032;01;109;54;55
035;010;098;001;01;210;105;105
035;010;098;002;01;389;188;201
035;010;098;003;01;189;91;98
035;010;098;004;01;325;138;187
035;010;098;005;01;424;174;250
035;010;098;005;02;416;227;189
035;010;098;006;01;229;105;124
035;011;098;001;01;278;140;138
035;011;098;002;01;345;184;161
035;011;098;003;01;240;128;112
035;011;098;003;02;238;141;97
035;011;098;004;01;250;134;116
035;011;098;004;02;248;150;98
035;011;098;005;01;355;212;143
035;011;098;005;02;352;189;163
035;011;098;006;01;317;165;152
035;011;098;007;01;253;153;100
035;011;098;008;01;309;164;145
035;011;098;008;02;304;166;138
035;011;098;008;03;304;164;140
035;011;098;009;01;273;163;110
035;011;098;010;01;263;159;104
035;011;098;011;01;218;115;103
035;012;098;001;01;256;126;130
035;012;098;001;02;255;125;130
035;012;098;002;01;420;190;230
035;012;098;003;01;261;106;155
035;012;098;003;02;256;140;116
035;012;098;004;01;400;139;261
035;012;098;004;02;400;185;215
035;012;098;004;03;395;162;233
035;012;098;005;01;239;97;142
035;012;098;006;01;328;138;190
035;012;098;006;02;323;164;159
035;012;098;007;01;363;155;208
035;012;098;008;01;111;54;57
035;012;098;009;01;193;81;112
035;012;098;010;01;415;170;245
035;012;098;010;02;408;188;220
035;012;098;010;03;408;187;221
035;012;098;010;04;408;141;267
035;012;098;010;05;408;193;215
035;012;098;010;06;408;189;219
035;012;098;011;01;264;120;144
035;012;098;011;02;264;116;148
035;012;098;012;01;327;131;196
035;012;098;012;02;320;158;162
035;013;098;001;01;102;43;59
035;013;098;002;01;148;66;82
035;013;098;003;01;400;144;256
035;013;098;003;02;399;193;206
035;013;098;003;03;392;184;208
035;013;098;004;01;393;171;222
035;013;098;005;01;104;48;56
035;013;098;006;01;256;114;142
035;013;098;007;01;91;47;44
036;001;001;001;01;408;212;196
036;001;001;001;02;401;223;178
036;001;001;002;01;368;161;207
036;001;001;002;02;368;215;153
036;001;001;002;03;368;190;178
036;001;001;002;04;368;202;166
036;001;001;002;05;367;187;180
036;001;001;003;01;368;177;191
036;001;001;003;02;361;183;178
036;001;001;004;01;410;169;241
036;001;001;004;02;408;208;200
036;001;001;005;01;312;121;191
036;001;001;005;02;306;157;149
036;001;001;006;01;440;121;319
036;001;001;006;02;440;235;205
036;001;001;006;03;440;259;181
036;001;001;006;04;433;198;235
036;001;001;007;01;241;124;117
036;001;001;008;01;406;188;218
036;001;001;008;02;400;238;162
036;001;001;009;01;323;136;187
036;001;001;009;02;320;184;136
036;001;001;011;01;430;247;183
036;001;098;001;01;149;80;69
036;001;098;002;01;169;100;69
036;001;098;003;01;435;187;248
036;001;098;003;02;432;247;185
036;001;098;004;01;156;75;81
036;001;098;005;01;373;181;192
036;001;098;006;01;117;68;49
036;001;098;007;01;333;174;159
036;001;098;008;01;286;153;133
036;001;098;009;01;214;112;102
036;001;098;010;01;263;92;171
036;001;098;010;02;256;136;120
036;001;098;011;01;195;91;104
036;001;098;012;01;317;164;153
036;001;098;013;01;352;112;240
036;001;098;013;02;347;205;142
036;001;098;013;03;344;180;164
036;001;098;014;01;284;127;157
036;001;098;015;01;379;162;217
036;001;098;016;01;139;62;77
036;001;098;017;01;416;166;250
036;001;098;017;02;408;228;180
036;001;098;018;01;101;44;57
036;001;098;019;01;164;79;85
036;002;001;001;01;335;147;188
036;002;001;001;02;328;151;177
036;002;001;002;01;304;149;155
036;002;001;002;02;301;148;153
036;002;001;003;01;304;135;169
036;002;001;003;02;303;139;164
036;002;001;004;01;437;187;250
036;002;001;004;02;432;216;216
036;002;001;005;01;272;122;150
036;002;001;005;02;264;108;156
036;002;001;006;01;360;144;216
036;002;001;006;02;356;176;180
036;002;001;006;03;352;173;179
036;002;001;007;01;237;116;121
036;002;001;008;01;338;169;169
036;002;098;001;01;190;88;102
036;002;098;002;01;261;106;155
036;002;098;002;02;256;109;147
036;002;098;003;01;109;59;50
036;002;098;004;01;333;170;163
036;002;098;005;01;253;116;137
036;002;098;006;01;198;93;105
036;002;098;007;01;102;58;44
036;002;098;008;01;317;151;166
036;002;098;009;01;282;132;150
036;002;098;010;01;144;72;72
036;002;098;011;01;187;92;95
036;002;098;012;01;446;215;231
036;002;098;013;01;63;31;32
036;002;098;014;01;295;142;153
036;002;098;014;02;288;153;135
036;002;098;015;01;50;26;24
036;002;098;016;01;180;91;89
036;002;098;017;01;398;165;233
036;002;098;018;01;74;39;35
036;002;098;019;01;231;103;128
036;002;098;020;01;174;71;103
036;002;098;021;01;44;26;18
036;003;098;001;01;212;110;102
036;003;098;002;01;234;111;123
036;003;098;002;02;232;128;104
036;003;098;003;01;95;51;44
036;003;098;004;01;419;202;217
036;003;098;005;01;269;116;153
036;003;098;006;01;246;97;149
036;003;098;006;02;240;116;124
036;003;098;007;01;376;157;219
036;003;098;007;02;374;188;186
036;003;098;008;01;272;119;153
036;003;098;008;02;266;134;132
036;003;098;009;01;408;169;239
036;003;098;009;02;408;219;189
036;003;098;009;03;403;221;182
036;003;098;010;01;352;124;228
036;003;098;010;02;352;174;178
036;003;098;010;03;350;184;166
036;003;098;011;01;267;95;172
036;003;098;011;02;264;150;114
036;003;098;012;01;264;141;123
036;003;098;013;01;320;141;179
036;003;098;013;02;312;152;160
036;003;098;014;01;328;116;212
036;003;098;014;02;328;147;181
036;003;098;014;03;321;180;141
036;003;098;015;01;387;180;207
036;003;098;016;01;151;82;69
036;003;098;017;01;227;115;112
036;003;098;018;01;255;106;149
036;003;098;018;02;248;129;119
036;003;098;019;01;174;84;90
036;003;098;020;01;192;102;90
036;003;098;021;01;90;50;40
036;003;098;023;01;123;57;66
036;004;098;001;01;148;78;70
036;004;098;002;01;162;86;76
036;004;098;003;01;147;68;79
036;004;098;004;01;404;197;207
036;004;098;005;01;222;108;114
036;004;098;006;01;166;74;92
036;004;098;007;01;400;177;223
036;004;098;007;02;395;188;207
036;004;098;008;01;198;93;105
036;004;098;009;01;316;147;169
036;004;098;009;02;312;143;169
036;004;098;010;01;139;73;66
036;004;098;011;01;80;49;31
036;004;098;012;01;178;85;93
036;005;098;001;01;323;167;156
036;005;098;002;01;237;97;140
036;005;098;002;02;232;145;87
036;005;098;003;01;280;101;179
036;005;098;003;02;273;134;139
036;005;098;004;01;281;117;164
036;005;098;005;01;287;140;147
036;005;098;006;01;404;175;229
036;005;098;006;02;400;208;192
036;005;098;007;01;83;41;42
036;005;098;008;01;250;127;123
036;005;098;009;01;248;139;109
036;005;098;009;02;241;134;107
036;006;098;001;01;407;200;207
036;006;098;002;01;351;164;187
036;006;098;003;01;240;90;150
036;006;098;003;02;238;120;118
036;006;098;004;01;324;146;178
036;006;098;005;01;164;79;85
036;006;098;006;01;277;116;161
036;006;098;006;02;272;142;130
036;006;098;007;01;341;133;208
036;006;098;007;02;336;191;145
036;006;098;007;03;336;159;177
036;006;098;008;01;448;175;273
036;006;098;008;02;444;226;218
036;006;098;009;01;311;156;155
036;006;098;010;01;388;159;229
036;006;098;010;02;384;222;162
036;006;098;010;03;384;225;159
036;006;098;011;01;241;115;126
036;006;098;012;01;114;73;41
037;003;001;001;01;435;225;210
037;003;001;001;02;432;216;216
037;003;001;002;01;437;222;215
037;003;001;002;02;432;207;225
037;003;001;003;01;402;229;173
037;003;001;003;02;400;200;200
037;003;001;003;03;400;202;198
037;003;001;004;01;320;175;145
037;003;001;004;02;320;151;169
037;003;001;005;01;189;101;88
037;003;098;001;01;400;229;171
037;003;098;001;02;398;171;227
037;003;098;002;01;424;260;164
037;003;098;002;02;417;92;325
037;003;098;002;03;416;220;196
037;003;098;003;01;336;218;118
037;003;098;003;02;332;115;217
037;003;098;004;01;442;229;213
037;003;098;005;01;222;109;113
037;003;098;006;01;328;152;176
037;003;098;006;02;326;141;185
037;003;098;007;01;363;202;161
037;003;098;007;02;360;163;197
037;003;098;008;01;368;179;189
037;003;098;009;01;239;129;110
037;003;098;010;01;262;120;142
037;003;098;011;01;86;48;38
037;004;098;001;01;240;117;123
037;004;098;001;02;232;113;119
037;004;098;002;01;273;164;109
037;004;098;002;02;272;125;147
037;004;098;003;01;397;225;172
037;004;098;003;02;392;169;223
037;004;098;004;01;336;191;145
037;004;098;004;02;328;158;170
037;004;098;004;03;328;149;179
037;004;098;005;01;410;176;234
037;005;098;001;01;320;196;124
037;005;098;001;02;318;144;174
037;005;098;001;03;312;132;180
037;005;098;002;01;29;20;9
037;005;098;003;01;185;88;97
037;005;098;004;01;165;85;80
037;005;098;005;01;370;201;169
037;005;098;006;01;198;110;88
037;005;098;007;01;114;60;54
037;006;098;001;01;136;69;67
037;006;098;002;01;272;141;131
037;006;098;002;02;267;113;154
037;006;098;003;01;405;204;201
037;006;098;004;01;240;122;118
037;006;098;005;01;443;223;220
037;006;098;006;01;408;204;204
037;006;098;006;02;406;228;178
037;006;098;007;01;177;91;86
037;006;098;008;01;418;211;207
037;006;098;009;01;408;221;187
037;006;098;009;02;408;182;226
037;006;098;009;03;408;147;261
037;006;098;009;04;408;211;197
037;006;098;010;01;229;115;114
037;006;098;011;01;138;58;80
037;006;098;012;01;92;51;41
038;004;001;001;01;296;140;156
038;004;001;001;02;291;172;119
038;004;001;002;01;376;131;245
038;004;001;002;02;376;163;213
038;004;001;002;03;375;206;169
038;004;001;002;04;368;208;160
038;004;001;002;05;368;174;194
038;004;001;003;01;84;44;40
038;004;001;004;01;336;151;185
038;004;001;004;02;336;154;182
038;004;001;004;03;331;167;164
038;004;001;005;01;408;169;239
038;004;001;005;02;408;201;207
038;004;001;005;03;402;184;218
038;004;001;006;01;376;149;227
038;004;001;006;02;374;184;190
038;004;001;006;03;368;191;177
038;004;001;006;04;368;182;186
038;004;001;007;01;409;189;220
038;004;001;007;02;408;211;197
038;004;001;007;03;408;215;193
038;004;001;008;01;256;136;120
038;004;001;008;02;255;152;103
038;004;001;009;01;298;160;138
038;004;001;009;02;296;150;146
038;004;001;010;01;328;135;193
038;004;001;010;02;321;170;151
038;004;001;010;03;320;165;155
038;004;001;011;01;356;166;190
038;004;001;012;01;346;162;184
038;004;001;013;01;376;194;182
038;004;001;014;01;272;114;158
038;004;001;014;02;272;142;130
038;004;001;015;01;337;141;196
038;004;001;015;02;336;164;172
038;004;001;015;03;336;162;174
038;004;001;016;01;374;176;198
038;004;001;017;01;346;151;195
038;004;001;018;01;285;129;156
038;004;001;018;02;280;149;131
038;004;001;019;01;328;135;193
038;004;001;019;02;327;158;169
038;004;001;020;01;242;115;127
038;004;001;021;01;271;144;127
038;004;001;022;01;328;148;180
038;004;001;022;02;323;165;158
038;004;001;023;01;279;136;143
038;004;001;023;02;272;159;113
038;004;001;024;01;272;166;106
038;004;001;024;02;272;171;101
038;004;001;025;01;124;67;57
038;004;098;001;01;384;125;259
038;004;098;001;02;376;190;186
038;004;098;001;03;376;205;171
038;004;098;001;04;376;179;197
038;004;098;002;01;60;33;27
038;004;098;003;01;86;41;45
038;004;098;004;01;347;140;207
038;004;098;004;02;344;160;184
038;004;098;005;01;190;95;95
038;004;098;006;01;220;105;115
038;004;098;007;01;180;89;91
038;004;098;008;01;294;136;158
038;004;098;009;01;124;59;65
038;004;098;010;01;321;151;170
038;004;098;011;01;400;168;232
038;004;098;011;02;397;208;189
038;004;098;012;01;226;107;119
038;004;098;013;01;237;131;106
038;004;098;014;01;257;103;154
038;004;098;014;02;256;129;127
038;004;098;015;01;91;38;53
038;004;098;016;01;233;114;119
038;004;098;017;01;296;132;164
038;004;098;017;02;288;143;145
038;004;098;018;01;266;131;135
038;004;098;019;01;240;100;140
038;004;098;019;02;234;101;133
038;004;098;020;01;266;119;147
038;004;098;021;01;74;40;34
038;004;098;022;01;61;37;24
038;004;098;023;01;56;25;31
038;005;098;001;01;221;109;112
038;005;098;002;01;199;100;99
038;005;098;003;01;337;153;184
038;005;098;004;01;312;149;163
038;005;098;005;01;231;129;102
038;005;098;006;01;66;40;26
038;005;098;007;01;381;147;234
038;005;098;007;02;376;187;189
038;005;098;007;03;376;192;184
038;005;098;007;04;376;187;189
038;005;098;008;01;146;73;73
038;005;098;009;01;141;72;69
038;005;098;010;01;246;96;150
038;005;098;010;02;240;105;135
038;005;098;011;01;275;145;130
038;005;098;012;01;335;153;182
038;006;098;001;01;365;171;194
038;006;098;001;02;360;193;167
038;006;098;002;01;144;71;73
038;006;098;003;01;226;103;123
038;006;098;004;01;185;87;98
038;006;098;005;01;64;38;26
038;006;098;006;01;443;177;266
038;006;098;006;02;440;216;224
038;006;098;007;01;161;84;77
038;006;098;008;01;127;60;67
038;006;098;009;01;192;82;110
038;006;098;010;01;143;72;71
038;006;098;011;01;149;75;74
038;006;098;012;01;338;139;199
038;006;098;012;02;336;167;169
038;006;098;013;01;218;106;112
038;006;098;014;01;126;66;60
038;006;098;015;01;268;124;144
038;006;098;016;01;144;64;80
038;006;098;017;01;219;104;115
038;006;098;018;01;91;48;43
038;006;098;019;01;104;54;50
038;007;098;001;01;351;163;188
038;007;098;002;01;75;39;36
038;007;098;003;01;387;182;205
038;007;098;004;01;280;105;175
038;007;098;004;02;274;142;132
038;007;098;005;01;275;128;147
038;007;098;006;01;408;128;280
038;007;098;006;02;400;164;236
038;007;098;006;03;400;207;193
038;007;098;006;04;400;184;216
038;007;098;007;01;348;149;199
038;007;098;008;01;368;171;197
038;007;098;008;02;368;148;220
038;007;098;008;03;362;203;159
038;007;098;009;01;248;120;128
038;007;098;009;02;243;118;125
038;007;098;010;01;77;41;36
038;007;098;011;01;259;106;153
038;007;098;011;02;256;125;131
038;007;098;012;01;66;41;25
038;007;098;013;01;63;33;30
039;001;001;001;01;448;214;234
039;001;001;001;02;447;242;205
039;001;001;002;01;424;177;247
039;001;001;002;02;416;225;191
039;001;001;003;01;432;177;255
039;001;001;003;02;432;208;224
039;001;001;003;03;429;218;211
039;001;001;004;01;424;156;268
039;001;001;004;02;416;222;194
039;001;001;004;03;416;231;185
039;001;001;004;04;416;200;216
039;001;001;005;01;408;176;232
039;001;001;005;02;402;225;177
039;001;001;006;01;303;140;163
039;001;001;007;01;352;144;208
039;001;001;007;02;346;169;177
039;001;001;008;01;272;100;172
039;001;001;008;02;272;138;134
039;001;001;009;01;416;155;261
039;001;001;009;02;416;232;184
039;001;001;010;01;432;196;236
039;001;001;010;02;430;205;225
039;001;001;011;01;149;72;77
039;001;001;012;01;51;32;19
039;001;001;013;01;338;180;158
039;001;001;014;01;298;173;125
039;001;001;015;01;148;77;71
039;001;001;016;01;392;198;194
039;001;001;017;01;375;194;181
039;001;001;018;01;70;44;26
039;001;001;019;01;117;61;56
039;001;098;001;01;362;158;204
039;001;098;001;02;360;211;149
039;001;098;002;01;176;87;89
039;001;098;003;01;396;182;214
039;001;098;004;01;207;95;112
039;001;098;005;01;328;156;172
039;001;098;006;01;173;86;87
039;006;001;001;01;400;116;284
039;006;001;001;02;400;184;216
039;006;001;001;03;393;207;186
039;006;001;001;04;392;185;207
039;006;001;001;05;392;199;193
039;006;001;002;01;243;117;126
039;006;001;003;01;361;165;196
039;006;001;004;01;131;66;65
039;006;001;005;01;340;166;174
039;006;001;006;01;248;131;117
039;006;001;007;01;220;105;115
039;006;001;008;01;335;153;182
039;006;001;009;01;280;116;164
039;006;001;009;02;273;153;120
039;006;001;010;01;251;73;178
039;006;001;010;02;248;137;111
039;006;001;011;01;353;178;175
039;006;001;012;01;247;122;125
039;006;001;013;01;183;93;90
039;006;001;014;01;106;52;54
039;006;001;015;01;102;57;45
039;006;001;016;01;352;196;156
039;006;001;017;01;228;113;115
039;006;001;018;01;352;123;229
039;006;001;018;02;352;172;180
039;006;001;018;03;352;182;170
039;006;001;018;04;352;158;194
039;006;001;019;01;324;156;168
039;006;001;020;01;386;186;200
039;006;001;021;01;332;154;178
039;006;001;022;01;271;144;127
039;006;001;022;02;264;120;144
039;006;001;023;01;398;220;178
039;006;001;026;01;261;143;118
039;006;098;001;01;139;71;68
039;006;098;002;01;363;195;168
039;006;098;003;01;234;108;126
039;006;098;004;01;391;184;207
039;006;098;005;01;100;51;49
039;006;098;006;01;372;181;191
039;006;098;007;01;165;76;89
039;006;098;008;01;280;93;187
039;006;098;008;02;274;138;136
039;006;098;009;01;193;96;97
039;006;098;010;01;201;100;101
039;007;098;001;01;256;116;140
039;007;098;001;02;250;136;114
039;007;098;002;01;172;77;95
039;007;098;003;01;262;134;128
039;007;098;004;01;232;112;120
039;007;098;004;02;227;142;85
039;007;098;005;01;289;161;128
039;007;098;006;01;338;149;189
039;007;098;006;02;336;182;154
039;007;098;007;01;360;181;179
039;007;098;008;01;149;74;75
039;007;098;009;01;171;91;80
039;007;098;010;01;272;119;153
039;007;098;011;01;334;170;164
039;007;098;012;01;331;149;182
039;007;098;013;01;356;149;207
039;007;098;013;02;352;187;165
039;007;098;014;01;69;46;23
039;007;098;015;01;77;35;42
040;001;001;001;01;440;222;218
040;001;001;001;02;440;224;216
040;001;001;001;03;440;208;232
040;001;001;001;04;440;216;224
040;001;001;001;05;440;220;220
040;001;001;001;06;440;202;238
040;001;001;001;07;440;221;219
040;001;001;001;08;440;220;220
040;001;001;001;09;440;197;243
040;001;001;001;10;440;223;217
040;001;001;001;11;438;194;244
040;001;001;002;01;416;210;206
040;001;001;002;02;416;216;200
040;001;001;002;03;416;219;197
040;001;001;002;04;416;184;232
040;001;001;002;05;416;191;225
040;001;001;002;06;410;212;198
040;001;001;003;01;408;194;214
040;001;001;003;02;408;208;200
040;001;001;003;03;408;204;204
040;001;001;003;04;408;179;229
040;001;001;003;05;408;215;193
040;001;001;003;06;408;197;211
040;001;001;003;07;408;205;203
040;001;001;003;08;408;194;214
040;001;001;003;09;404;205;199
040;001;001;003;10;400;186;214
040;001;001;004;01;424;195;229
040;001;001;004;02;424;204;220
040;001;001;004;03;424;206;218
040;001;001;004;04;424;218;206
040;001;001;004;05;424;211;213
040;001;001;004;06;424;206;218
040;001;001;004;07;424;194;230
040;001;001;004;08;420;223;197
040;001;001;004;09;416;200;216
040;001;001;005;01;448;206;242
040;001;001;005;02;447;241;206
040;001;001;005;03;440;214;226
040;001;001;006;01;432;214;218
040;001;001;006;02;432;216;216
040;001;001;006;03;432;201;231
040;001;001;006;04;432;239;193
040;001;001;006;05;432;192;240
040;001;001;006;06;432;217;215
040;001;001;007;01;440;206;234
040;001;001;007;02;440;214;226
040;001;001;007;03;440;217;223
040;001;001;007;04;440;205;235
040;001;001;007;05;440;188;252
040;001;001;007;06;440;196;244
040;001;001;007;07;440;202;238
040;001;001;007;08;434;199;235
040;001;001;008;01;400;191;209
040;001;001;008;02;400;206;194
040;001;001;008;03;400;203;197
040;001;001;008;04;400;190;210
040;001;001;008;05;400;180;220
040;001;001;008;06;400;212;188
040;001;001;008;07;400;204;196
040;001;001;008;08;392;195;197
040;001;001;009;01;293;151;142
040;001;001;009;02;288;157;131
040;001;001;010;01;440;237;203
040;001;001;010;02;437;227;210
040;001;001;010;03;432;213;219
040;001;001;010;04;432;206;226
040;001;001;010;05;432;226;206
040;001;001;011;01;408;191;217
040;001;001;011;02;408;210;198
040;001;001;011;03;408;200;208
040;001;001;011;04;408;215;193
040;001;001;011;05;408;187;221
040;001;001;011;06;408;189;219
040;001;001;011;07;408;208;200
040;001;001;011;08;405;206;199
040;001;001;011;09;400;180;220
040;001;001;012;01;419;211;208
040;001;001;012;02;416;195;221
040;001;001;012;03;416;238;178
040;001;001;012;04;416;218;198
040;001;001;012;05;416;209;207
040;001;001;013;01;368;186;182
040;001;001;013;02;365;186;179
040;001;001;013;03;360;190;170
040;001;001;013;04;360;189;171
040;001;001;014;01;349;205;144
040;001;001;015;01;415;210;205
040;001;001;015;02;408;195;213
040;001;001;015;03;408;196;212
040;001;001;016;01;448;233;215
040;001;001;016;02;448;239;209
040;001;001;016;03;441;231;210
040;001;001;017;01;417;220;197
040;001;001;017;02;416;222;194
040;001;001;018;01;384;205;179
040;001;001;018;02;382;209;173
040;001;001;018;03;376;191;185
040;001;001;018;04;376;193;183
040;001;001;018;05;376;195;181
040;001;001;019;01;424;214;210
040;001;001;019;02;424;210;214
040;001;001;019;03;424;212;212
040;001;001;019;04;424;237;187
040;001;001;019;05;420;206;214
040;001;001;019;06;416;197;219
040;001;001;019;07;416;202;214
040;001;001;019;08;416;175;241
040;001;001;020;01;392;183;209
040;001;001;020;02;392;179;213
040;001;001;020;03;392;183;209
040;001;001;020;04;390;214;176
040;001;001;021;01;309;136;173
040;001;001;021;02;304;141;163
040;001;001;022;01;171;84;87
040;001;001;023;01;253;138;115
040;001;001;024;01;234;119;115
040;001;001;024;02;232;108;124
040;001;001;025;01;230;95;135
040;001;001;026;01;264;102;162
040;001;001;027;01;164;95;69
040;001;001;028;01;84;38;46
040;001;098;001;01;400;222;178
040;001;098;001;02;398;222;176
040;001;098;001;03;392;203;189
040;001;098;001;04;392;197;195
040;001;098;001;05;392;209;183
040;001;098;002;01;405;198;207
040;001;098;003;01;365;185;180
040;001;098;004;01;432;216;216
040;001;098;004;02;432;233;199
040;001;098;004;03;428;223;205
040;001;098;005;01;400;186;214
040;001;098;005;02;400;172;228
040;001;098;005;03;400;198;202
040;001;098;005;04;400;195;205
040;001;098;005;05;398;192;206
040;001;098;005;06;392;191;201
040;001;098;006;01;320;162;158
040;001;098;006;02;312;150;162
040;001;098;006;03;312;168;144
040;001;098;007;01;312;148;164
040;001;098;007;02;308;150;158
040;001;098;007;03;304;142;162
040;001;098;008;01;318;183;135
040;001;098;009;01;222;146;76
040;001;098;010;01;325;175;150
040;001;098;011;01;285;150;135
040;002;098;001;01;434;232;202
040;002;098;002;01;404;199;205
040;002;098;003;01;268;151;117
040;002;098;004;01;338;193;145
040;002;098;005;01;102;48;54
040;002;098;006;01;337;199;138
040;002;098;007;01;416;201;215
040;002;098;007;02;411;216;195
040;002;098;007;03;408;223;185
040;002;098;007;04;408;201;207
040;002;098;007;05;408;197;211
040;002;098;008;01;368;200;168
040;002;098;008;02;368;185;183
040;002;098;008;03;367;194;173
040;002;098;008;04;360;167;193
040;002;098;009;01;376;184;192
040;002;098;010;01;408;210;198
040;002;098;010;02;408;190;218
040;002;098;010;03;408;195;213
040;002;098;010;04;400;199;201
040;002;098;010;05;400;178;222
040;002;098;011;01;233;137;96
040;002;098;012;01;401;216;185
040;002;098;013;01;376;193;183
040;002;098;013;02;370;210;160
040;002;098;013;03;368;188;180
040;002;098;013;04;368;197;171
040;002;098;014;01;98;65;33
040;002;098;015;01;384;195;189
040;002;098;015;02;384;188;196
040;002;098;015;03;379;170;209
040;002;098;015;04;376;194;182
040;002;098;016;01;130;88;42
040;002;098;017;01;320;167;153
040;002;098;017;02;312;165;147
040;002;098;018;01;276;173;103
040;002;098;019;01;43;30;13
040;002;098;020;01;85;51;34
040;003;098;001;01;280;141;139
040;003;098;001;02;272;135;137
040;003;098;002;01;419;225;194
040;003;098;002;02;416;218;198
040;003;098;002;03;416;213;203
040;003;098;002;04;416;225;191
040;003;098;003;01;158;89;69
040;003;098;004;01;360;193;167
040;003;098;004;02;360;211;149
040;003;098;004;03;352;192;160
040;003;098;005;01;78;50;28
040;003;098;006;01;99;60;39
040;003;098;007;01;65;49;16
040;003;098;008;01;205;128;77
040;003;098;009;01;45;33;12
040;003;098;010;01;262;147;115
040;003;098;011;01;229;113;116
040;003;098;011;02;224;116;108
040;003;098;012;01;368;173;195
040;003;098;012;02;368;178;190
040;003;098;012;03;367;177;190
040;003;098;013;01;327;164;163
040;003;098;013;02;320;159;161
040;003;098;014;01;253;126;127
040;003;098;014;02;248;130;118
040;003;098;015;01;440;230;210
040;003;098;015;02;440;223;217
040;003;098;015;03;440;217;223
040;003;098;015;04;440;231;209
040;003;098;015;05;440;221;219
040;003;098;015;06;436;198;238
040;003;098;016;01;424;205;219
040;003;098;016;02;417;214;203
040;003;098;016;03;416;214;202
040;003;098;016;04;416;215;201
040;003;098;017;01;130;85;45
040;003;098;019;01;393;236;157
040;003;098;020;01;57;39;18
040;003;098;021;01;77;59;18
040;003;098;022;01;60;39;21
041;001;098;001;01;101;54;47
041;001;098;002;01;260;139;121
041;001;098;003;01;408;206;202
041;001;098;003;02;403;201;202
041;001;098;004;01;268;151;117
041;001;098;004;02;264;162;102
041;001;098;005;01;155;107;48
041;001;098;006;01;92;56;36
041;001;098;007;01;52;34;18
041;001;098;008;01;248;131;117
041;001;098;008;02;248;153;95
041;001;098;009;01;170;108;62
041;001;098;010;01;431;272;159
041;001;098;011;01;50;32;18
041;001;098;012;01;196;103;93
041;001;098;013;01;318;171;147
041;001;098;014;01;227;142;85
041;001;098;014;02;224;145;79
041;001;098;015;01;431;238;193
041;001;098;016;01;123;75;48
041;001;098;017;01;79;44;35
041;001;098;018;01;69;44;25
041;001;098;019;01;291;153;138
041;001;098;020;01;101;66;35
041;001;098;021;01;239;175;64
041;001;098;022;01;167;109;58
041;001;098;024;01;323;222;101
041;002;098;001;01;234;138;96
041;002;098;002;01;450;255;195
041;002;098;002;02;450;236;214
041;002;098;002;03;448;257;191
041;002;098;003;01;178;115;63
041;002;098;004;01;129;77;52
041;002;098;005;01;189;115;74
041;002;098;006;01;122;69;53
041;002;098;007;01;150;87;63
041;002;098;008;01;99;61;38
041;002;098;009;01;49;26;23
041;002;098;010;01;113;74;39
041;002;098;011;01;234;135;99
041;002;098;012;01;441;261;180
041;002;098;013;01;46;26;20
041;002;098;014;01;106;53;53
041;002;098;015;01;292;149;143
041;002;098;016;01;207;111;96
041;002;098;017;01;168;89;79
041;002;098;018;01;312;202;110
041;002;098;020;01;90;51;39
041;003;098;001;01;139;68;71
041;003;098;002;01;171;85;86
041;003;098;003;01;138;57;81
041;003;098;004;01;87;35;52
041;003;098;005;01;262;123;139
041;003;098;005;02;256;114;142
041;003;098;006;01;227;121;106
041;003;098;007;01;89;53;36
041;003;098;008;01;320;177;143
041;003;098;009;01;118;71;47
041;003;098;010;01;370;223;147
041;003;098;011;01;50;25;25
041;003;098;012;01;312;173;139
041;003;098;012;02;311;187;124
041;003;098;013;01;295;162;133
041;003;098;014;01;133;77;56
041;003;098;015;01;47;23;24
041;004;001;001;01;424;242;182
041;004;001;001;02;424;215;209
041;004;001;001;03;424;225;199
041;004;001;001;04;424;216;208
041;004;001;001;05;424;215;209
041;004;001;001;06;424;213;211
041;004;001;001;07;424;210;214
041;004;001;001;08;424;211;213
041;004;001;001;09;424;255;169
041;004;001;001;10;424;207;217
041;004;001;001;11;424;230;194
041;004;001;001;12;424;191;233
041;004;001;001;13;424;246;178
041;004;001;001;14;420;239;181
041;004;001;001;15;416;230;186
041;004;001;001;16;416;215;201
041;004;001;002;01;448;229;219
041;004;001;002;02;448;250;198
041;004;001;002;03;447;251;196
041;004;001;002;04;440;239;201
041;004;001;002;05;440;218;222
041;004;001;002;06;440;258;182
041;004;001;002;07;440;246;194
041;004;001;003;01;352;192;160
041;004;001;003;02;352;222;130
041;004;001;003;03;345;195;150
041;004;001;004;01;416;242;174
041;004;001;005;01;239;156;83
041;004;001;005;02;232;140;92
041;004;001;006;01;376;225;151
041;004;001;006;02;371;215;156
041;004;001;006;03;368;204;164
041;004;001;006;04;368;221;147
041;004;001;007;01;196;99;97
041;004;001;009;01;389;212;177
041;004;001;009;02;384;205;179
041;004;001;009;03;384;222;162
041;004;001;009;04;384;228;156
041;004;001;011;01;272;141;131
041;004;001;011;02;272;162;110
041;004;001;012;01;182;99;83
041;004;001;013;01;54;30;24
041;004;001;014;01;416;206;210
041;004;001;014;02;410;199;211
041;004;098;001;01;288;169;119
041;004;098;002;01;328;179;149
041;004;098;003;01;128;75;53
041;004;098;004;01;164;94;70
041;004;098;005;01;181;102;79
041;004;098;006;01;164;101;63
041;004;098;007;01;400;234;166
041;004;098;007;02;394;223;171
041;004;098;007;03;392;210;182
041;004;098;007;04;392;216;176
041;004;098;008;01;235;128;107
041;004;098;008;02;232;122;110
041;004;098;009;01;182;87;95
041;004;098;010;01;352;161;191
041;004;098;010;02;346;152;194
041;004;098;011;01;424;190;234
041;004;098;012;01;292;100;192
041;004;098;013;01;230;113;117
041;004;098;014;01;258;132;126
041;004;098;015;01;315;201;114
041;004;098;016;01;350;170;180
041;004;098;017;01;225;113;112
041;004;098;018;01;135;78;57
041;004;098;019;01;399;229;170
041;004;098;020;01;195;111;84
041;004;098;021;01;152;96;56
041;004;098;022;01;68;36;32
041;004;098;023;01;173;107;66
041;004;098;024;01;48;28;20
041;004;098;025;01;275;141;134
041;005;098;001;01;336;162;174
041;005;098;001;02;331;154;177
041;005;098;002;01;151;81;70
041;005;098;003;01;181;90;91
041;005;098;004;01;112;58;54
041;005;098;005;01;76;44;32
042;001;098;001;01;306;159;147
042;001;098;002;01;375;164;211
042;001;098;003;01;336;171;165
042;001;098;003;02;330;167;163
042;001;098;004;01;438;214;224
042;001;098;004;02;432;205;227
042;001;098;005;01;336;165;171
042;001;098;005;02;336;168;168
042;001;098;006;01;336;172;164
042;001;098;006;02;334;173;161
042;001;098;007;01;264;127;137
042;001;098;007;02;260;141;119
042;001;098;008;01;324;182;142
042;001;098;009;01;409;226;183
042;001;098;009;02;408;216;192
042;001;098;010;01;376;216;160
042;001;098;010;02;376;209;167
042;001;098;010;03;369;196;173
042;001;098;010;04;368;200;168
042;001;098;010;05;368;209;159
042;001;098;011;01;390;240;150
042;001;098;012;01;282;132;150
042;001;098;020;01;123;76;47
042;002;001;001;01;416;242;174
042;002;001;001;02;416;234;182
042;002;001;001;03;409;247;162
042;002;001;001;04;408;241;167
042;002;001;001;05;408;235;173
042;002;001;002;01;440;250;190
042;002;001;002;02;440;244;196
042;002;001;002;03;440;242;198
042;002;001;002;04;440;280;160
042;002;001;002;05;440;256;184
042;002;001;002;06;440;253;187
042;002;001;002;07;432;246;186
042;002;001;003;01;416;188;228
042;002;001;003;02;412;217;195
042;002;001;003;03;408;217;191
042;002;001;004;01;368;207;161
042;002;001;004;02;368;215;153
042;002;001;004;03;365;201;164
042;002;001;005;01;368;203;165
042;002;001;005;02;368;206;162
042;002;001;005;03;363;199;164
042;002;001;006;01;400;221;179
042;002;001;006;02;400;215;185
042;002;001;007;01;409;217;192
042;002;001;007;02;408;216;192
042;002;001;008;01;252;138;114
042;002;001;009;01;171;80;91
042;002;001;010;01;140;80;60
042;002;001;011;01;435;225;210
042;002;001;011;02;432;225;207
042;002;001;012;01;89;63;26
042;002;001;013;01;114;65;49
042;002;001;014;01;177;94;83
042;002;001;015;01;424;220;204
042;002;001;015;02;424;202;222
042;002;001;015;03;416;201;215
042;002;001;015;04;416;206;210
042;002;001;016;01;316;173;143
042;002;001;016;02;312;150;162
042;002;001;017;01;295;141;154
042;002;001;018;01;408;233;175
042;002;001;018;02;408;199;209
042;002;001;018;03;407;205;202
042;002;001;018;04;400;206;194
042;002;001;019;01;272;141;131
042;002;001;019;02;267;127;140
042;002;001;020;01;402;193;209
042;002;001;021;01;142;73;69
042;002;001;022;01;82;49;33
042;002;001;023;01;152;77;75
042;002;001;024;01;187;105;82
042;002;001;025;01;342;179;163
042;002;001;026;01;195;101;94
042;002;001;027;01;252;138;114
042;002;001;027;02;248;132;116
042;002;001;028;01;240;116;124
042;002;001;028;02;238;100;138
042;002;001;029;01;268;141;127
042;002;001;030;01;228;116;112
042;002;001;031;01;99;54;45
042;002;001;032;01;240;119;121
042;002;098;002;01;126;57;69
042;002;098;003;01;93;58;35
043;001;001;001;01;432;190;242
043;001;001;001;02;432;200;232
043;001;001;001;03;427;210;217
043;001;001;001;04;424;198;226
043;001;001;002;01;364;172;192
043;001;001;003;01;424;197;227
043;001;001;004;01;360;201;159
043;001;001;004;02;360;185;175
043;001;001;004;03;355;170;185
043;001;001;005;01;297;135;162
043;001;001;005;02;296;179;117
043;001;001;006;01;277;113;164
043;001;001;007;01;448;242;206
043;001;001;008;01;240;117;123
043;001;001;008;02;234;122;112
043;001;001;009;01;392;220;172
043;001;001;009;02;392;214;178
043;001;001;009;03;388;213;175
043;001;001;010;01;433;222;211
043;001;001;011;01;408;219;189
043;001;001;011;02;408;205;203
043;001;001;011;03;408;199;209
043;001;001;011;04;408;230;178
043;001;001;011;05;404;237;167
043;001;001;011;06;400;216;184
043;001;001;012;01;267;140;127
043;001;001;012;02;264;147;117
043;001;001;013;01;219;122;97
043;001;001;014;01;352;184;168
043;001;001;014;02;352;165;187
043;001;001;014;03;344;180;164
043;001;001;015;01;259;145;114
043;001;001;016;01;290;139;151
043;001;001;017;01;427;223;204
043;001;001;018;01;360;176;184
043;001;001;018;02;360;173;187
043;001;001;018;03;360;199;161
043;001;001;018;04;357;179;178
043;001;001;019;01;408;213;195
043;001;001;019;02;408;210;198
043;001;001;019;03;408;241;167
043;001;001;020;01;416;198;218
043;001;001;020;02;416;207;209
043;001;001;020;03;416;225;191
043;001;001;020;04;412;224;188
043;001;001;021;01;201;100;101
043;001;001;022;01;384;192;192
043;001;001;022;02;384;209;175
043;001;001;022;03;380;196;184
043;001;001;023;01;296;163;133
043;001;001;023;02;291;158;133
043;001;001;024;01;250;131;119
043;002;098;001;01;344;196;148
043;002;098;001;02;339;180;159
043;002;098;002;01;445;222;223
043;002;098;002;02;440;236;204
043;002;098;002;03;440;225;215
043;002;098;002;04;440;218;222
043;002;098;003;01;344;193;151
043;002;098;003;02;344;184;160
043;002;098;003;03;344;193;151
043;002;098;003;04;339;174;165
043;002;098;004;01;354;196;158
043;002;098;005;01;240;146;94
043;002;098;005;02;236;128;108
043;002;098;006;01;315;165;150
043;002;098;008;01;69;39;30
043;002;098;009;01;132;74;58
043;002;098;010;01;71;43;28
043;002;098;011;01;90;46;44
043;003;098;001;01;424;226;198
043;003;098;002;01;232;131;101
043;003;098;002;02;230;120;110
043;003;098;003;01;352;187;165
043;003;098;003;02;352;190;162
043;003;098;003;03;348;174;174
043;003;098;004;01;200;102;98
043;003;098;005;01;375;184;191
043;003;098;005;02;368;199;169
043;003;098;006;01;259;152;107
043;003;098;007;01;329;193;136
043;003;098;008;01;274;159;115
043;003;098;009;01;293;172;121
043;003;098;011;01;226;107;119
043;004;098;001;01;433;246;187
043;004;098;001;02;432;279;153
043;004;098;002;01;237;148;89
043;004;098;003;01;380;229;151
043;004;098;003;02;376;229;147
043;004;098;003;03;376;240;136
043;004;098;004;01;325;176;149
043;004;098;004;02;320;206;114
043;004;098;005;01;408;213;195
043;004;098;005;02;406;234;172
043;004;098;005;03;400;242;158
043;004;098;005;04;400;203;197
043;004;098;006;01;360;206;154
043;004;098;006;02;359;203;156
043;004;098;007;01;342;189;153
043;004;098;007;02;336;193;143
043;004;098;008;01;411;243;168
043;004;098;008;02;408;235;173
043;004;098;009;01;440;251;189
043;004;098;009;02;436;243;193
043;004;098;010;01;411;241;170
043;004;098;011;01;222;133;89
043;004;098;012;01;147;92;55
043;004;098;013;01;178;93;85
043;004;098;014;01;116;77;39
043;004;098;015;01;176;95;81
043;004;098;016;01;140;79;61
043;004;098;017;01;109;67;42
043;004;098;018;01;158;96;62
043;005;098;001;01;386;190;196
043;005;098;002;01;416;210;206
043;005;098;002;02;409;222;187
043;005;098;003;01;448;242;206
043;005;098;003;02;448;244;204
043;005;098;003;03;443;238;205
043;005;098;004;01;325;167;158
043;005;098;004;02;320;165;155
043;005;098;005;01;278;153;125
043;005;098;005;02;272;146;126
043;005;098;006;01;317;159;158
043;005;098;006;02;312;162;150
043;005;098;007;01;248;131;117
043;005;098;007;02;247;143;104
043;005;098;008;01;272;124;148
043;005;098;008;02;271;119;152
043;005;098;009;01;334;182;152
043;005;098;010;01;417;211;206
043;005;098;011;01;134;76;58
043;005;098;012;01;315;174;141
043;005;098;013;01;193;102;91
043;005;098;014;01;127;70;57
043;005;098;015;01;98;74;24
043;006;098;001;01;280;139;141
043;006;098;001;02;278;150;128
043;006;098;002;01;384;205;179
043;006;098;002;02;381;204;177
043;006;098;002;03;376;198;178
043;006;098;003;01;410;207;203
043;006;098;004;01;134;72;62
043;006;098;005;01;243;140;103
043;006;098;006;01;274;151;123
043;006;098;007;01;75;44;31
043;006;098;008;01;142;78;64
043;006;098;009;01;164;97;67
043;007;098;001;01;400;210;190
043;007;098;001;02;400;204;196
043;007;098;001;03;395;213;182
043;007;098;001;04;392;213;179
043;007;098;002;01;351;181;170
043;007;098;002;02;344;172;172
043;007;098;002;03;344;158;186
043;007;098;003;01;325;178;147
043;007;098;004;01;127;72;55
043;007;098;005;01;153;90;63
043;007;098;006;01;78;54;24
043;007;098;007;01;63;35;28
043;007;098;008;01;118;76;42
043;008;098;001;01;320;165;155
043;008;098;001;02;312;158;154
043;008;098;002;01;145;83;62
043;008;098;003;01;175;90;85
043;008;098;004;01;360;187;173
043;008;098;004;02;356;173;183
043;008;098;005;01;312;159;153
043;008;098;005;02;305;149;156
043;008;098;005;03;304;171;133
043;008;098;007;01;344;188;156
043;008;098;007;02;337;190;147
043;008;098;008;01;422;218;204
043;008;098;009;01;261;153;108
043;008;098;010;01;98;58;40
043;008;098;011;01;73;41;32
043;008;098;012;01;142;89;53
043;008;098;013;01;123;76;47
043;009;098;001;01;444;259;185
043;009;098;001;02;440;276;164
043;009;098;002;01;382;213;169
043;009;098;003;01;315;177;138
043;009;098;003;02;312;187;125
043;009;098;003;03;312;189;123
043;009;098;004;01;333;176;157
043;009;098;004;02;328;196;132
043;009;098;005;01;384;215;169
043;009;098;005;02;376;209;167
043;009;098;005;03;376;209;167
043;009;098;005;04;376;227;149
043;009;098;005;05;376;223;153
043;009;098;006;01;362;205;157
043;009;098;006;02;360;220;140
043;009;098;007;01;289;162;127
043;009;098;007;02;288;176;112
043;009;098;008;01;262;152;110
043;009;098;009;01;143;89;54
043;009;098;010;01;122;78;44
044;001;098;001;01;440;227;213
044;001;098;001;02;438;235;203
044;001;098;002;01;353;173;180
044;001;098;002;02;352;172;180
044;001;098;003;01;122;63;59
044;001;098;004;01;438;222;216
044;001;098;004;02;432;210;222
044;001;098;004;03;432;204;228
044;001;098;005;01;254;147;107
044;001;098;006;01;384;218;166
044;001;098;007;01;233;109;124
044;001;098;007;02;232;112;120
044;001;098;008;01;367;175;192
044;001;098;008;02;360;198;162
044;001;098;008;03;360;166;194
044;001;098;009;01;436;229;207
044;001;098;009;02;432;231;201
044;001;098;010;01;221;124;97
044;001;098;011;01;185;95;90
044;001;098;012;01;91;50;41
044;001;098;013;01;158;95;63
044;001;098;014;01;96;54;42
044;002;001;001;01;328;175;153
044;002;001;001;02;323;186;137
044;002;001;001;03;320;179;141
044;002;001;002;01;448;250;198
044;002;001;002;02;448;244;204
044;002;001;002;03;448;239;209
044;002;001;002;04;448;242;206
044;002;001;002;05;448;271;177
044;002;001;002;06;448;240;208
044;002;001;002;07;441;247;194
044;002;001;002;08;440;256;184
044;002;001;003;01;408;228;180
044;002;001;003;02;408;212;196
044;002;001;003;03;407;239;168
044;002;001;004;01;392;202;190
044;002;001;004;02;392;196;196
044;002;001;004;03;390;202;188
044;002;001;004;04;384;209;175
044;002;001;004;05;384;202;182
044;002;001;005;01;408;236;172
044;002;001;005;02;408;256;152
044;002;001;005;03;408;214;194
044;002;001;005;04;408;245;163
044;002;001;005;05;408;238;170
044;002;001;005;06;402;226;176
044;002;001;006;01;408;238;170
044;002;001;006;02;408;219;189
044;002;001;006;03;408;209;199
044;002;001;006;04;408;188;220
044;002;001;006;05;408;223;185
044;002;001;006;06;408;217;191
044;002;001;006;07;408;187;221
044;002;001;006;08;404;226;178
044;002;001;006;09;400;234;166
044;002;001;007;01;448;205;243
044;002;001;007;02;442;208;234
044;002;001;007;03;440;209;231
044;002;001;007;04;440;213;227
044;002;001;007;05;440;213;227
044;002;001;008;01;416;215;201
044;002;001;008;02;416;193;223
044;002;001;008;03;416;229;187
044;002;001;008;04;409;207;202
044;002;001;008;05;408;195;213
044;002;001;009;01;400;218;182
044;002;001;009;02;392;195;197
044;002;001;009;03;392;199;193
044;002;001;009;04;392;206;186
044;002;001;010;01;437;268;169
044;002;001;010;02;432;243;189
044;002;001;010;03;432;269;163
044;002;001;011;01;402;218;184
044;002;001;011;02;400;201;199
044;002;001;011;03;400;204;196
044;002;001;011;04;400;229;171
044;002;001;011;05;400;211;189
044;002;001;011;06;400;231;169
044;002;001;012;01;400;211;189
044;002;001;012;02;395;210;185
044;002;001;013;01;228;137;91
044;002;001;014;01;325;171;154
044;002;001;014;02;320;184;136
044;002;001;015;01;365;175;190
044;002;001;015;02;360;191;169
044;002;001;015;03;360;181;179
044;002;001;016;01;368;186;182
044;002;001;016;02;366;203;163
044;002;001;016;03;360;192;168
044;002;001;017;01;197;108;89
044;002;001;018;01;406;204;202
044;002;001;018;02;400;204;196
044;002;001;019;01;303;162;141
044;002;001;019;02;296;165;131
044;002;001;020;01;411;240;171
044;002;001;020;02;408;181;227
044;002;001;021;01;378;212;166
044;002;001;021;02;376;195;181
044;002;001;022;01;440;240;200
044;002;001;022;02;440;238;202
044;002;001;022;03;434;243;191
044;002;001;023;01;344;187;157
044;002;001;023;02;342;181;161
044;002;001;024;01;269;145;124
044;002;001;024;02;264;147;117
044;002;001;025;01;391;181;210
044;002;001;025;02;384;185;199
044;002;001;025;03;384;194;190
044;002;001;026;01;328;171;157
044;002;001;026;02;328;190;138
044;002;001;026;03;322;168;154
044;002;001;027;01;356;189;167
044;002;001;027;02;352;195;157
044;002;001;028;01;344;192;152
044;002;001;029;01;315;166;149
044;002;001;029;02;312;172;140
044;002;001;029;03;312;177;135
044;002;001;030;01;261;152;109
044;002;001;032;01;431;241;190
044;002;001;032;02;424;234;190
044;002;001;032;03;424;261;163
044;002;001;033;01;292;171;121
044;002;001;034;01;441;253;188
044;002;001;035;01;365;198;167
044;002;001;036;01;146;90;56
044;002;001;037;01;360;194;166
044;002;001;037;02;352;174;178
044;002;001;037;03;352;222;130
044;002;001;038;01;440;213;227
044;002;001;038;02;440;223;217
044;002;001;038;03;440;240;200
044;002;001;038;04;440;208;232
044;002;001;038;05;440;215;225
044;002;001;038;06;440;237;203
044;002;001;038;07;439;196;243
044;002;001;038;08;432;201;231
044;002;001;038;09;432;237;195
044;002;001;038;10;432;203;229
044;002;001;038;11;432;244;188
044;002;001;039;01;448;224;224
044;002;001;039;02;445;205;240
044;002;001;039;03;440;226;214
044;002;001;039;04;440;244;196
044;002;001;039;05;440;217;223
044;002;001;040;01;236;136;100
044;002;001;040;02;232;128;104
044;002;001;041;01;430;250;180
044;002;001;042;01;335;197;138
044;002;001;043;01;206;123;83
044;002;001;044;01;145;77;68
044;002;001;045;01;79;48;31
044;002;001;046;01;382;217;165
044;002;001;047;01;330;191;139
044;002;001;048;01;440;243;197
044;002;001;049;01;259;135;124
044;002;001;049;02;256;147;109
044;002;098;001;01;346;162;184
044;002;098;001;02;344;182;162
044;002;098;001;03;344;177;167
044;002;098;002;01;232;113;119
044;002;098;002;02;230;127;103
044;002;098;003;01;269;143;126
044;002;098;003;02;264;141;123
044;002;098;004;01;335;175;160
044;002;098;005;01;382;220;162
044;002;098;005;02;376;224;152
044;002;098;006;01;181;103;78
044;002;098;007;01;364;210;154
044;002;098;007;02;360;203;157
044;002;098;008;01;250;165;85
044;002;098;008;02;248;149;99
044;002;098;009;01;151;83;68
044;003;098;001;01;156;103;53
044;003;098;002;01;148;89;59
044;003;098;003;01;252;129;123
044;003;098;003;02;248;138;110
044;003;098;004;01;327;183;144
044;003;098;004;02;320;154;166
044;003;098;004;03;320;175;145
044;003;098;005;01;414;234;180
044;003;098;006;01;376;189;187
044;003;098;006;02;375;194;181
044;003;098;006;03;368;184;184
044;003;098;006;04;368;177;191
044;003;098;006;05;368;216;152
044;003;098;007;01;393;199;194
044;003;098;007;02;392;214;178
044;003;098;008;01;84;54;30
044;003;098;009;01;126;83;43
044;003;098;010;01;421;219;202
044;003;098;010;02;416;212;204
044;003;098;010;03;416;236;180
044;003;098;011;01;427;227;200
044;003;098;011;02;424;250;174
044;003;098;011;03;424;246;178
044;003;098;011;04;424;242;182
044;003;098;012;01;218;141;77
044;003;098;013;01;305;180;125
044;003;098;014;01;208;120;88
044;004;098;001;01;407;200;207
044;004;098;002;01;384;198;186
044;004;098;002;02;384;186;198
044;004;098;002;03;384;195;189
044;004;098;002;04;384;202;182
044;004;098;002;05;383;202;181
044;004;098;003;01;424;176;248
044;004;098;003;02;420;201;219
044;004;098;004;01;248;114;134
044;004;098;004;02;248;121;127
044;004;098;005;01;352;184;168
044;004;098;005;02;352;200;152
044;004;098;005;03;352;179;173
044;004;098;005;04;344;169;175
044;004;098;006;01;406;208;198
044;004;098;007;01;398;191;207
044;004;098;007;02;392;191;201
044;004;098;008;01;438;257;181
044;004;098;009;01;400;213;187
044;004;098;009;02;395;202;193
044;004;098;010;01;145;86;59
044;004;098;011;01;256;150;106
044;004;098;011;02;253;137;116
044;004;098;012;01;367;204;163
044;004;098;013;01;352;188;164
044;004;098;013;02;352;214;138
044;004;098;014;01;349;178;171
044;004;098;014;02;344;203;141
044;004;098;015;01;91;48;43
044;004;098;016;01;121;84;37
044;004;098;017;01;217;133;84
044;004;098;018;01;74;56;18
044;005;098;001;01;246;135;111
044;005;098;002;01;250;144;106
044;005;098;003;01;218;121;97
044;005;098;004;01;413;235;178
044;005;098;004;02;408;206;202
044;005;098;004;03;408;207;201
044;005;098;004;04;408;207;201
044;005;098;004;05;408;220;188
044;005;098;005;01;274;132;142
044;005;098;005;02;272;140;132
044;005;098;006;01;392;216;176
044;005;098;006;02;384;199;185
044;005;098;006;03;384;218;166
044;005;098;006;04;384;211;173
044;005;098;007;01;376;197;179
044;005;098;007;02;376;208;168
044;005;098;007;03;376;214;162
044;005;098;008;01;336;187;149
044;005;098;008;02;333;181;152
044;005;098;009;01;222;130;92
044;005;098;010;01;354;188;166
044;005;098;010;02;352;194;158
044;005;098;010;03;352;194;158
044;005;098;011;01;220;123;97
044;005;098;012;01;352;184;168
044;005;098;012;02;350;207;143
044;005;098;012;03;344;190;154
044;005;098;013;01;232;129;103
044;005;098;013;02;230;132;98
044;005;098;014;01;248;115;133
044;005;098;014;02;247;129;118
044;005;098;015;01;228;130;98
044;005;098;015;02;224;119;105
044;005;098;016;01;254;148;106
044;005;098;017;01;163;79;84
044;005;098;021;01;219;120;99
045;002;001;001;01;368;185;183
045;002;001;001;02;362;200;162
045;002;001;001;03;360;199;161
045;002;001;002;01;352;170;182
045;002;001;002;02;346;184;162
045;002;001;002;03;344;178;166
045;002;001;002;04;344;196;148
045;002;001;003;01;416;238;178
045;002;001;003;02;416;235;181
045;002;001;003;03;416;220;196
045;002;001;003;04;414;215;199
045;002;001;003;05;408;249;159
045;002;001;004;01;248;131;117
045;002;001;004;02;242;145;97
045;002;001;005;01;384;187;197
045;002;001;005;02;384;208;176
045;002;001;005;03;381;206;175
045;002;001;005;04;376;215;161
045;002;001;006;01;369;182;187
045;002;001;006;02;368;200;168
045;002;001;007;01;364;198;166
045;002;001;008;01;449;232;217
045;002;001;008;02;448;273;175
045;002;001;009;01;400;207;193
045;002;001;009;02;398;201;197
045;002;001;009;03;392;191;201
045;002;001;009;04;392;215;177
045;002;001;010;01;449;245;204
045;002;001;011;01;392;207;185
045;002;001;012;01;232;127;105
045;002;001;014;01;237;128;109
045;002;001;015;01;159;93;66
045;002;098;001;01;395;212;183
045;002;098;001;02;392;193;199
045;002;098;002;01;194;113;81
045;002;098;003;01;294;139;155
045;002;098;003;02;288;125;163
045;002;098;004;01;105;55;50
045;002;098;005;01;328;187;141
045;002;098;005;02;320;172;148
045;005;098;001;01;302;149;153
045;005;098;001;02;296;155;141
045;005;098;002;01;302;149;153
045;005;098;003;01;232;124;108
045;005;098;003;02;228;125;103
045;005;098;004;01;304;163;141
045;005;098;005;01;396;194;202
045;005;098;005;02;392;213;179
045;005;098;006;01;368;178;190
045;005;098;006;02;368;190;178
045;005;098;006;03;366;187;179
045;005;098;006;04;360;174;186
045;005;098;007;01;201;129;72
045;008;098;001;01;368;187;181
045;008;098;001;02;360;168;192
045;008;098;003;01;448;223;225
045;008;098;003;02;446;232;214
045;008;098;003;03;440;210;230
045;008;098;004;01;288;137;151
045;008;098;004;02;284;125;159
045;008;098;005;01;428;230;198
045;008;098;006;01;416;219;197
045;008;098;006;02;410;215;195
045;008;098;007;01;257;135;122
045;008;098;007;02;256;120;136
045;008;098;008;01;232;119;113
045;008;098;008;02;227;121;106
045;008;098;009;01;364;188;176
045;008;098;010;01;379;186;193
045;008;098;010;02;376;182;194
045;011;098;001;01;258;154;104
045;011;098;002;01;304;178;126
045;011;098;002;02;298;161;137
045;011;098;003;01;254;142;112
045;011;098;003;02;248;128;120
045;011;098;004;01;304;152;152
045;011;098;004;02;304;151;153
045;011;098;004;03;299;165;134
045;011;098;005;01;328;181;147
045;011;098;005;02;324;164;160
045;011;098;005;03;320;160;160
045;011;098;006;01;362;200;162
045;011;098;007;01;292;161;131
045;011;098;007;02;288;130;158
045;011;098;008;01;362;203;159
045;011;098;008;02;360;184;176
045;011;098;008;03;360;199;161
045;011;098;009;01;412;219;193
045;011;098;010;01;272;157;115
045;011;098;010;02;272;158;114
045;011;098;011;01;180;114;66
045;011;098;012;01;213;142;71
045;011;098;013;01;64;43;21
045;011;098;014;01;292;180;112
046;001;001;001;01;416;200;216
046;001;001;001;02;416;235;181
046;001;001;001;03;412;189;223
046;001;001;002;01;386;193;193
046;001;001;003;01;272;138;134
046;001;001;003;02;269;139;130
046;001;098;001;01;238;136;102
046;001;098;001;02;232;121;111
046;001;098;002;01;404;203;201
046;001;098;003;01;356;165;191
046;001;098;004;01;389;212;177
046;001;098;005;01;99;63;36
046;001;098;006;01;138;79;59
046;001;098;007;01;200;98;102
046;001;098;008;01;226;120;106
046;001;098;009;01;231;114;117
046;001;098;010;01;223;108;115
046;001;098;011;01;258;134;124
046;001;098;012;01;175;95;80
046;001;098;013;01;259;135;124
046;001;098;014;01;81;45;36
046;001;098;015;01;169;81;88
046;001;098;016;01;235;124;111
046;001;098;016;02;232;116;116
046;001;098;017;01;270;133;137
046;001;098;018;01;90;48;42
046;001;098;019;01;45;28;17
046;002;001;001;01;327;158;169
046;002;001;001;02;320;140;180
046;002;001;002;01;310;164;146
046;002;001;002;02;304;154;150
046;002;001;002;03;304;152;152
046;002;001;003;01;392;184;208
046;002;001;004;01;314;175;139
046;002;001;004;02;312;148;164
046;002;001;005;01;410;184;226
046;002;001;006;01;315;138;177
046;002;001;006;02;312;150;162
046;002;001;007;01;369;192;177
046;002;001;008;01;285;145;140
046;002;001;009;01;387;198;189
046;002;001;010;01;319;148;171
046;002;001;011;01;95;51;44
046;002;001;012;01;122;57;65
046;002;001;013;01;137;67;70
046;002;001;014;01;367;190;177
046;002;001;015;01;138;78;60
046;002;001;016;01;102;48;54
046;002;098;001;01;320;156;164
046;002;098;001;02;316;145;171
046;002;098;002;01;376;198;178
046;002;098;002;02;372;172;200
046;002;098;003;01;160;102;58
046;002;098;004;01;134;74;60
046;002;098;005;01;290;155;135
046;002;098;006;01;252;125;127
046;002;098;007;01;302;166;136
046;003;001;001;01;432;228;204
046;003;001;001;02;432;213;219
046;003;001;001;03;430;234;196
046;003;001;001;04;424;188;236
046;003;001;001;05;424;224;200
046;003;001;002;01;344;175;169
046;003;001;002;02;344;204;140
046;003;001;002;03;344;190;154
046;003;001;002;04;342;179;163
046;003;001;003;01;368;183;185
046;003;001;003;02;368;188;180
046;003;001;003;03;368;155;213
046;003;001;003;04;365;198;167
046;003;001;004;01;304;176;128
046;003;001;004;02;301;121;180
046;003;001;004;03;296;145;151
046;003;001;005;01;235;111;124
046;003;001;006;01;283;154;129
046;003;001;007;01;264;140;124
046;003;001;007;02;260;140;120
046;003;001;008;01;314;158;156
046;003;001;009;01;163;93;70
046;003;001;010;01;288;137;151
046;003;001;011;01;319;164;155
046;003;001;012;01;152;87;65
046;003;001;013;01;256;129;127
046;003;001;014;01;213;97;116
046;003;001;020;01;124;60;64
046;003;098;001;01;352;170;182
046;003;098;002;01;256;120;136
046;003;098;002;02;252;115;137
046;003;098;003;01;211;110;101
046;003;098;004;01;302;150;152
046;003;098;005;01;323;174;149
046;003;098;006;01;320;170;150
046;003;098;007;01;276;143;133
046;003;098;007;02;272;149;123
046;003;098;008;01;183;93;90
046;003;098;009;01;281;140;141
046;003;098;010;01;370;176;194
046;003;098;011;01;248;136;112
046;003;098;011;02;247;111;136
046;003;098;012;01;324;163;161
046;003;098;013;01;226;103;123
046;003;098;014;01;289;140;149
046;003;098;014;02;288;136;152
046;003;098;015;01;278;154;124
046;003;098;016;01;171;86;85
046;003;098;017;01;156;78;78
046;003;098;018;01;205;120;85
046;003;098;019;01;100;49;51
046;003;098;021;01;238;124;114
046;003;098;022;01;258;123;135
046;003;098;023;01;130;66;64
046;003;098;024;01;153;80;73
046;003;098;025;01;246;136;110
046;003;098;026;01;106;49;57
046;003;098;027;01;113;49;64
046;003;098;028;01;240;104;136
046;003;098;029;01;340;177;163
046;003;098;030;01;209;118;91
046;003;098;031;01;307;173;134
046;003;098;032;01;278;130;148
046;003;098;033;01;113;55;58
046;003;098;034;01;141;73;68
046;003;098;035;01;321;141;180
046;003;098;036;01;139;63;76
046;003;098;037;01;288;137;151
046;003;098;038;01;112;63;49
046;003;098;039;01;60;33;27
046;003;098;040;01;248;130;118
046;004;001;001;01;376;173;203
046;004;001;001;02;373;184;189
046;004;001;001;03;368;186;182
046;004;001;001;04;368;194;174
046;004;001;002;01;379;198;181
046;004;001;003;01;344;178;166
046;004;001;003;02;337;158;179
046;004;001;004;01;115;58;57
046;004;001;005;01;288;147;141
046;004;001;005;02;281;141;140
046;004;001;006;01;240;124;116
046;004;001;006;02;235;122;113
046;004;001;007;01;303;153;150
046;004;001;008;01;245;115;130
046;004;001;009;01;115;60;55
046;004;001;010;01;296;156;140
046;004;001;010;02;289;155;134
046;004;098;001;01;296;152;144
046;004;098;001;02;295;136;159
046;004;098;002;01;240;130;110
046;004;098;003;01;298;145;153
046;004;098;004;01;89;48;41
046;004;098;005;01;331;178;153
046;004;098;006;01;256;136;120
046;004;098;006;02;254;133;121
046;004;098;007;01;322;166;156
046;004;098;008;01;84;40;44
046;004;098;009;01;49;17;32
046;004;098;010;01;105;51;54
046;004;098;011;01;115;57;58
046;004;098;013;01;107;62;45
046;005;001;001;01;288;154;134
046;005;001;001;02;284;146;138
046;005;001;002;01;238;127;111
046;005;001;002;02;232;107;125
046;005;001;003;01;256;121;135
046;005;001;003;02;248;126;122
046;005;001;004;01;271;137;134
046;005;001;005;01;205;97;108
046;005;001;006;01;412;208;204
046;005;001;007;01;223;107;116
046;005;001;008;01;25;15;10
046;005;098;001;01;350;151;199
046;005;098;001;02;344;175;169
046;005;098;001;03;344;153;191
046;005;098;002;01;384;169;215
046;005;098;002;02;381;167;214
046;005;098;003;01;359;191;168
046;005;098;003;02;352;174;178
046;005;098;004;01;256;119;137
046;005;098;004;02;252;112;140
046;005;098;005;01;119;66;53
046;005;098;006;01;130;64;66
046;005;098;007;01;405;185;220
046;005;098;008;01;312;149;163
046;005;098;008;02;309;150;159
046;005;098;009;01;72;44;28
046;005;098;010;01;44;27;17
046;006;001;001;01;444;205;239
046;006;001;001;02;440;219;221
046;006;001;002;01;259;110;149
046;006;001;002;02;256;140;116
046;006;001;003;01;238;129;109
046;006;001;004;01;240;115;125
046;006;001;004;02;238;129;109
046;006;001;005;01;372;194;178
046;006;001;006;01;161;82;79
046;006;001;007;01;99;53;46
046;006;001;008;01;370;174;196
046;006;001;009;01;97;47;50
046;006;098;001;01;90;49;41
046;006;098;002;01;368;179;189
046;006;098;002;02;361;160;201
046;006;098;003;01;390;185;205
046;006;098;004;01;342;167;175
046;006;098;005;01;410;180;230
046;006;098;006;01;37;22;15
046;007;098;001;01;375;184;191
046;007;098;002;01;240;123;117
046;007;098;002;02;232;99;133
046;007;098;003;01;357;158;199
046;007;098;004;01;202;91;111
046;007;098;005;01;396;212;184
046;007;098;005;02;392;202;190
046;007;098;005;03;392;191;201
046;007;098;006;01;366;200;166
046;007;098;006;02;360;148;212
046;007;098;006;03;360;138;222
046;007;098;007;01;296;145;151
046;007;098;007;02;288;142;146
046;007;098;008;01;412;215;197
046;007;098;009;01;305;156;149
046;007;098;010;01;131;74;57
046;007;098;011;01;218;116;102
046;007;098;012;01;99;49;50
046;007;098;013;01;88;40;48
046;007;098;014;01;225;128;97
046;008;098;001;01;299;164;135
046;008;098;002;01;377;218;159
046;008;098;003;01;417;218;199
046;008;098;004;01;162;99;63
046;008;098;005;01;289;163;126
046;008;098;006;01;60;38;22
046;008;098;007;01;194;108;86
046;008;098;008;01;178;114;64
046;008;098;009;01;90;53;37
046;008;098;010;01;188;96;92
046;009;098;001;01;204;105;99
046;009;098;002;01;332;178;154
046;009;098;003;01;412;195;217
046;009;098;004;01;213;118;95
046;009;098;005;01;213;109;104
046;009;098;006;01;162;83;79
046;009;098;007;01;119;60;59
046;010;098;001;01;288;145;143
046;010;098;001;02;285;138;147
046;010;098;002;01;424;213;211
046;010;098;002;02;422;216;206
046;010;098;002;03;416;205;211
046;010;098;003;01;277;136;141
046;010;098;003;02;272;141;131
046;010;098;004;01;241;134;107
046;010;098;004;02;240;116;124
046;010;098;005;01;266;131;135
046;010;098;007;01;293;147;146
046;010;098;008;01;232;110;122
046;010;098;008;02;229;109;120
046;010;098;009;01;336;164;172
046;010;098;010;01;364;178;186
046;010;098;011;01;321;156;165
046;010;098;012;01;321;155;166
046;010;098;013;01;145;65;80
046;010;098;014;01;123;67;56
046;010;098;015;01;118;59;59
046;010;098;016;01;145;74;71
047;001;001;001;01;432;214;218
047;001;001;001;02;432;214;218
047;001;001;001;03;424;224;200
047;001;001;001;04;424;199;225
047;001;001;002;01;384;199;185
047;001;001;002;02;381;208;173
047;001;001;002;03;376;213;163
047;001;001;002;04;376;180;196
047;001;001;003;01;400;204;196
047;001;001;003;02;400;197;203
047;001;001;003;03;400;192;208
047;001;001;003;04;400;205;195
047;001;001;003;05;392;205;187
047;001;001;004;01;416;187;229
047;001;001;004;02;416;213;203
047;001;001;004;03;416;184;232
047;001;001;004;04;415;200;215
047;001;001;004;05;408;186;222
047;001;001;005;01;384;203;181
047;001;001;005;02;384;197;187
047;001;001;005;03;379;207;172
047;001;098;001;01;320;159;161
047;001;098;001;02;320;155;165
047;001;098;001;03;316;159;157
047;001;098;002;01;320;147;173
047;001;098;002;02;317;145;172
047;001;098;003;01;336;193;143
047;001;098;004;01;409;184;225
047;001;098;004;02;408;207;201
047;001;098;005;01;347;169;178
047;001;098;006;01;317;152;165
047;001;098;007;01;122;65;57
047;002;001;001;01;304;199;105
047;002;001;001;02;304;189;115
047;002;001;001;03;296;174;122
047;002;001;002;01;413;216;197
047;002;001;002;02;408;227;181
047;002;001;003;01;440;236;204
047;002;001;003;02;435;249;186
047;002;001;004;01;427;220;207
047;002;001;004;02;424;229;195
047;002;001;005;01;382;199;183
047;002;001;005;02;376;173;203
047;002;001;005;03;376;192;184
047;002;001;005;04;376;201;175
047;002;001;006;01;384;213;171
047;002;001;006;02;384;213;171
047;002;001;006;03;384;216;168
047;002;001;006;04;383;190;193
047;002;001;006;05;376;204;172
047;002;001;007;01;360;158;202
047;002;001;007;02;353;169;184
047;002;001;007;03;352;176;176
047;002;001;008;01;393;224;169
047;002;001;008;02;392;204;188
047;002;001;008;03;392;225;167
047;002;001;009;01;392;192;200
047;002;001;009;02;392;193;199
047;002;001;009;03;389;193;196
047;002;001;009;04;384;184;200
047;002;001;010;01;448;207;241
047;002;001;010;02;442;223;219
047;002;001;010;03;440;200;240
047;002;001;010;04;440;199;241
047;002;001;010;05;440;217;223
047;002;001;010;06;440;193;247
047;002;001;011;01;392;197;195
047;002;001;011;02;392;214;178
047;002;001;011;03;387;185;202
047;002;001;011;04;384;190;194
047;002;001;011;05;384;188;196
047;002;001;011;06;384;185;199
047;002;001;011;07;384;213;171
047;002;001;012;01;382;196;186
047;002;001;012;02;376;198;178
047;002;001;013;01;344;176;168
047;002;001;013;02;344;163;181
047;002;001;013;03;338;173;165
047;002;001;014;01;416;184;232
047;002;001;014;02;416;202;214
047;002;001;014;03;416;206;210
047;002;001;014;04;416;195;221
047;002;001;014;05;413;186;227
047;002;001;015;01;387;206;181
047;002;001;015;02;384;193;191
047;002;001;015;03;384;213;171
047;002;001;016;01;362;180;182
047;002;001;016;02;360;193;167
047;002;001;016;03;360;169;191
047;002;001;016;04;360;167;193
047;002;001;017;01;344;178;166
047;002;001;017;02;336;170;166
047;002;001;017;03;336;180;156
047;002;001;018;01;314;133;181
047;002;001;019;01;327;179;148
047;002;001;019;02;320;150;170
047;002;001;019;03;320;168;152
047;002;001;020;01;406;199;207
047;002;001;020;02;400;214;186
047;002;001;021;01;385;219;166
047;002;001;022;01;248;120;128
047;002;001;022;02;241;120;121
047;002;001;023;01;304;155;149
047;002;001;024;01;206;100;106
047;002;001;025;01;191;107;84
047;002;001;026;01;252;141;111
047;002;001;027;01;152;83;69
047;002;001;028;01;414;174;240
047;002;001;029;01;106;52;54
047;002;001;030;01;114;53;61
047;002;001;032;01;248;112;136
047;002;001;032;02;245;98;147
047;002;001;033;01;59;28;31
047;002;001;036;01;66;36;30
047;002;001;037;01;238;116;122
047;005;098;001;01;336;159;177
047;005;098;001;02;333;157;176
047;005;098;001;03;328;147;181
047;005;098;002;01;303;150;153
047;005;098;003;01;384;165;219
047;005;098;003;02;382;182;200
047;005;098;004;01;256;111;145
047;005;098;004;02;253;97;156
047;005;098;005;01;431;206;225
047;005;098;006;01;138;66;72
047;005;098;007;01;157;69;88
047;005;098;008;01;434;191;243
047;005;098;009;01;269;136;133
048;003;001;001;01;416;235;181
048;003;001;001;02;410;246;164
048;003;001;002;01;352;187;165
048;003;001;002;02;352;163;189
048;003;001;002;03;352;190;162
048;003;001;002;04;349;201;148
048;003;001;003;01;449;240;209
048;003;001;003;02;448;205;243
048;003;001;003;03;448;229;219
048;003;001;004;01;392;179;213
048;003;001;004;02;392;180;212
048;003;001;004;03;387;197;190
048;003;001;004;04;384;208;176
048;003;001;005;01;413;200;213
048;003;001;005;02;408;199;209
048;003;001;005;03;408;201;207
048;003;001;005;04;408;258;150
048;003;001;006;01;352;151;201
048;003;001;006;02;352;156;196
048;003;001;006;03;348;161;187
048;003;001;006;04;344;169;175
048;003;001;007;01;388;217;171
048;003;001;008;01;155;82;73
048;003;001;009;01;213;116;97
048;003;098;001;01;424;208;216
048;003;098;001;02;424;220;204
048;003;098;002;01;312;148;164
048;003;098;002;02;305;124;181
048;003;098;003;01;415;206;209
048;003;098;004;01;266;150;116
048;003;098;004;02;264;119;145
048;003;098;005;01;340;146;194
048;003;098;006;01;304;138;166
048;003;098;006;02;299;160;139
048;003;098;007;01;282;157;125
048;003;098;007;02;280;145;135
048;003;098;008;01;363;174;189
048;003;098;008;02;360;181;179
048;003;098;009;01;436;246;190
048;003;098;010;01;295;147;148
048;003;098;010;02;288;150;138
048;003;098;011;01;362;177;185
048;003;098;011;02;360;177;183
048;003;098;011;03;360;163;197
048;003;098;011;04;360;184;176
048;003;098;012;01;336;186;150
048;003;098;012;02;333;181;152
048;003;098;013;01;207;111;96
048;003;098;014;01;367;194;173
048;003;098;015;01;241;139;102
048;004;001;001;01;360;197;163
048;004;001;001;02;359;161;198
048;004;001;002;01;394;196;198
048;004;001;002;02;392;227;165
048;004;001;003;01;448;231;217
048;004;001;003;02;444;214;230
048;004;001;004;01;416;226;190
048;004;001;004;02;416;227;189
048;004;001;004;03;411;199;212
048;004;001;004;04;408;212;196
048;004;001;005;01;448;210;238
048;004;001;005;02;443;199;244
048;004;001;005;03;440;211;229
048;004;001;005;04;440;222;218
048;004;001;006;01;424;226;198
048;004;001;006;02;416;224;192
048;004;001;006;03;416;218;198
048;004;001;007;01;358;180;178
048;004;001;007;02;352;180;172
048;004;001;007;03;352;164;188
048;004;001;008;01;177;92;85
048;004;001;009;01;312;145;167
048;004;001;009;02;308;159;149
048;004;001;010;01;238;129;109
048;004;001;011;01;105;43;62
048;004;001;012;01;208;97;111
048;004;001;013;01;314;172;142
048;004;098;001;01;153;77;76
048;004;098;002;01;280;134;146
048;004;098;002;02;274;146;128
048;004;098;004;01;385;219;166
048;004;098;005;01;41;24;17
048;004;098;006;01;84;40;44
048;004;098;007;01;124;60;64
048;006;001;001;01;343;185;158
048;006;001;001;02;336;167;169
048;006;001;001;03;336;175;161
048;006;001;001;04;336;177;159
048;006;001;002;01;440;232;208
048;006;001;002;02;440;204;236
048;006;001;002;03;440;213;227
048;006;001;002;04;434;199;235
048;006;001;004;01;408;210;198
048;006;001;004;02;404;220;184
048;006;001;005;01;376;198;178
048;006;001;005;02;376;208;168
048;006;001;005;03;368;184;184
048;006;001;005;04;368;205;163
048;006;001;006;01;253;148;105
048;006;001;007;01;372;200;172
048;006;001;008;01;293;145;148
048;006;098;001;01;248;154;94
048;006;098;003;01;65;39;26
048;006;098;004;01;298;195;103
048;006;098;005;01;401;239;162
048;006;098;007;01;165;99;66
048;007;098;001;01;435;206;229
048;007;098;002;01;290;137;153
048;007;098;002;02;288;139;149
048;007;098;003;01;304;155;149
048;007;098;003;02;303;133;170
048;007;098;004;01;447;214;233
048;007;098;005;01;358;215;143
048;007;098;006;01;177;89;88
048;007;098;007;01;152;75;77
048;008;098;001;01;286;151;135
048;008;098;001;02;280;134;146
048;008;098;002;01;69;37;32
048;008;098;003;01;440;203;237
048;008;098;003;02;440;216;224
048;008;098;003;03;432;236;196
048;008;098;003;04;432;240;192
048;008;098;004;01;247;126;121
048;008;098;005;01;332;179;153
048;008;098;005;02;328;182;146
048;008;098;006;01;380;220;160
048;008;098;006;02;376;181;195
048;008;098;007;01;400;227;173
048;008;098;007;02;397;196;201
048;008;098;007;03;392;207;185
048;008;098;008;01;434;255;179
048;008;098;008;02;432;240;192
048;008;098;009;01;352;159;193
048;008;098;009;02;351;176;175
048;008;098;010;01;328;168;160
048;008;098;010;02;322;167;155
048;008;098;011;01;113;60;53
048;008;098;012;01;131;68;63
048;008;098;013;01;258;124;134
048;008;098;014;01;152;77;75
048;008;098;017;01;40;25;15
048;008;098;018;01;106;69;37
048;008;098;019;01;157;96;61
048;009;098;001;01;450;199;251
048;009;098;001;02;449;230;219
048;009;098;002;01;400;182;218
048;009;098;003;01;272;137;135
048;009;098;003;02;265;132;133
048;009;098;004;01;302;152;150
048;009;098;005;01;122;66;56
048;009;098;006;01;415;220;195
048;009;098;006;02;408;191;217
048;009;098;006;03;408;204;204
048;009;098;007;01;436;224;212
048;009;098;008;01;127;67;60
049;001;001;001;01;400;191;209
049;001;001;001;02;400;204;196
049;001;001;001;03;394;201;193
049;001;001;002;01;213;109;104
049;001;001;003;01;84;55;29
049;001;001;004;01;236;117;119
049;001;001;005;01;313;176;137
049;001;001;006;01;352;176;176
049;001;001;006;02;350;188;162
049;001;001;006;03;344;192;152
049;001;001;006;04;344;193;151
049;001;001;007;01;201;105;96
049;001;001;008;01;100;62;38
049;001;001;009;01;341;175;166
049;001;001;010;01;211;112;99
049;001;001;011;01;328;179;149
049;001;001;011;02;328;164;164
049;001;001;011;03;326;175;151
049;001;001;012;01;352;176;176
049;001;001;012;02;345;173;172
049;001;001;013;01;446;257;189
049;001;001;014;01;273;147;126
049;001;001;015;01;261;134;127
049;001;001;016;01;386;201;185
049;001;001;017;01;117;59;58
049;001;001;018;01;161;90;71
049;001;001;019;01;34;22;12
049;001;098;001;01;327;174;153
049;001;098;001;02;320;179;141
049;001;098;002;01;336;170;166
049;001;098;002;02;336;178;158
049;001;098;003;01;259;156;103
049;001;098;005;01;312;182;130
049;001;098;005;02;306;172;134
049;001;098;005;03;304;162;142
049;001;098;006;01;257;141;116
049;001;098;007;01;160;105;55
049;001;098;008;01;400;196;204
049;001;098;008;02;393;209;184
049;001;098;009;01;97;46;51
049;001;098;010;01;87;47;40
049;001;098;011;01;184;104;80
049;001;098;012;01;340;193;147
049;001;098;014;01;400;212;188
049;001;098;014;02;400;200;200
049;001;098;014;03;400;205;195
049;001;098;014;04;400;181;219
049;001;098;014;05;400;238;162
049;001;098;014;06;397;222;175
049;001;098;015;01;76;43;33
049;001;098;016;01;59;47;12
049;001;098;018;01;291;154;137
049;001;098;019;01;295;155;140
049;001;098;020;01;320;203;117
049;001;098;020;02;318;193;125
049;001;098;021;01;156;91;65
049;001;098;022;01;317;202;115
049;001;098;024;01;123;82;41
049;001;098;025;01;272;141;131
049;001;098;025;02;265;174;91
049;002;001;001;01;416;217;199
049;002;001;001;02;416;222;194
049;002;001;001;03;416;204;212
049;002;001;001;04;416;217;199
049;002;001;001;05;416;217;199
049;002;001;001;06;416;244;172
049;002;001;001;07;412;207;205
049;002;001;001;08;408;185;223
049;002;001;001;09;408;222;186
049;002;001;001;10;408;219;189
049;002;001;001;11;408;222;186
049;002;001;002;01;392;210;182
049;002;001;002;02;386;219;167
049;002;001;002;03;384;213;171
049;002;001;003;01;320;192;128
049;002;001;003;02;313;175;138
049;002;001;003;03;312;189;123
049;002;001;004;01;392;212;180
049;002;001;004;02;392;186;206
049;002;001;004;03;392;221;171
049;002;001;004;04;385;213;172
049;002;001;004;05;384;182;202
049;002;001;005;01;395;219;176
049;002;001;005;02;392;210;182
049;002;001;005;03;392;221;171
049;002;001;005;04;392;213;179
049;002;001;005;05;392;207;185
049;002;001;006;01;408;207;201
049;002;001;006;02;408;223;185
049;002;001;006;03;407;220;187
049;002;001;006;04;400;224;176
049;002;001;006;05;400;234;166
049;002;001;006;06;400;217;183
049;002;001;007;01;396;226;170
049;002;001;007;02;392;213;179
049;002;001;007;03;392;230;162
049;002;001;007;04;392;213;179
049;002;001;008;01;400;239;161
049;002;001;008;02;400;218;182
049;002;001;008;03;400;224;176
049;002;001;008;04;396;234;162
049;002;001;008;05;392;217;175
049;002;001;008;06;392;229;163
049;002;001;009;01;424;217;207
049;002;001;009;02;424;223;201
049;002;001;009;03;424;201;223
049;002;001;009;04;424;218;206
049;002;001;009;05;424;202;222
049;002;001;009;06;421;235;186
049;002;001;009;07;416;196;220
049;002;001;010;01;392;180;212
049;002;001;010;02;392;180;212
049;002;001;010;03;392;163;229
049;002;001;010;04;392;182;210
049;002;001;010;05;392;161;231
049;002;001;010;06;391;181;210
049;002;001;011;01;416;209;207
049;002;001;011;02;416;177;239
049;002;001;011;03;416;202;214
049;002;001;011;04;416;217;199
049;002;001;011;05;413;218;195
049;002;001;012;01;448;213;235
049;002;001;012;02;448;231;217
049;002;001;012;03;448;233;215
049;002;001;012;04;448;210;238
049;002;001;012;05;445;233;212
049;002;001;012;06;440;220;220
049;002;001;013;01;448;222;226
049;002;001;013;02;448;216;232
049;002;001;013;03;445;216;229
049;002;001;013;04;440;211;229
049;002;001;014;01;417;208;209
049;002;001;014;02;416;203;213
049;002;001;014;03;416;217;199
049;002;001;014;04;416;185;231
049;002;001;014;05;416;178;238
049;002;001;014;06;416;187;229
049;002;001;015;01;384;192;192
049;002;001;015;02;384;173;211
049;002;001;015;03;383;165;218
049;002;001;015;04;376;168;208
049;002;001;016;01;416;212;204
049;002;001;016;02;416;189;227
049;002;001;016;03;416;189;227
049;002;001;016;04;416;191;225
049;002;001;016;05;416;203;213
049;002;001;016;06;408;173;235
049;002;001;016;07;408;216;192
049;002;001;016;08;408;207;201
049;002;001;017;01;360;185;175
049;002;001;017;02;360;191;169
049;002;001;017;03;360;175;185
049;002;001;017;04;357;195;162
049;002;001;018;01;440;216;224
049;002;001;018;02;437;210;227
049;002;001;018;03;432;221;211
049;002;001;018;04;432;205;227
049;002;001;018;05;432;237;195
049;002;001;018;06;432;211;221
049;002;001;018;07;432;183;249
049;002;001;018;08;432;244;188
049;002;001;018;09;432;231;201
049;002;001;019;01;376;217;159
049;002;001;019;02;376;185;191
049;002;001;019;03;375;211;164
049;002;001;019;04;368;202;166
049;002;001;019;05;368;208;160
049;002;001;020;01;368;206;162
049;002;001;020;02;368;199;169
049;002;001;020;03;368;210;158
049;002;001;020;04;365;214;151
049;002;001;020;05;360;213;147
049;002;001;021;01;437;226;211
049;002;001;021;02;432;193;239
049;002;001;021;03;432;206;226
049;002;001;021;04;432;209;223
049;002;001;021;05;432;228;204
049;002;001;021;06;432;187;245
049;002;001;021;07;432;222;210
049;002;001;022;01;352;162;190
049;002;001;022;02;344;158;186
049;002;001;022;03;344;161;183
049;002;001;023;01;400;206;194
049;002;001;023;02;400;170;230
049;002;001;023;03;392;210;182
049;002;001;023;04;392;213;179
049;002;001;024;01;352;185;167
049;002;001;024;02;352;194;158
049;002;001;024;03;347;181;166
049;002;001;024;04;344;188;156
049;002;001;025;01;400;234;166
049;002;001;025;02;400;193;207
049;002;001;025;03;400;205;195
049;002;001;025;04;399;219;180
049;002;001;025;05;392;210;182
049;002;001;026;01;440;223;217
049;002;001;026;02;440;244;196
049;002;001;026;03;440;230;210
049;002;001;026;04;433;203;230
049;002;001;026;05;432;218;214
049;002;001;026;06;432;233;199
049;002;001;026;07;432;203;229
049;002;001;026;08;432;231;201
049;002;001;027;01;392;174;218
049;002;001;027;02;392;167;225
049;002;001;027;03;385;183;202
049;002;001;027;04;384;180;204
049;002;001;027;05;384;205;179
049;002;001;028;01;408;197;211
049;002;001;028;02;408;206;202
049;002;001;028;03;400;203;197
049;002;001;028;04;400;220;180
049;002;001;028;05;400;213;187
049;002;001;028;06;400;219;181
049;002;001;028;07;400;193;207
049;002;001;028;08;400;214;186
049;002;001;028;09;400;185;215
049;002;001;029;01;427;235;192
049;002;001;029;02;424;228;196
049;002;001;029;03;424;223;201
049;002;001;029;04;424;242;182
049;002;001;030;01;416;192;224
049;002;001;030;02;415;190;225
049;002;001;030;03;408;193;215
049;002;001;030;04;408;199;209
049;002;001;030;05;408;219;189
049;002;001;030;06;408;191;217
049;002;001;031;01;400;238;162
049;002;001;031;02;400;240;160
049;002;001;031;03;400;240;160
049;002;001;031;04;394;208;186
049;002;001;032;01;428;216;212
049;002;001;032;02;424;219;205
049;002;001;032;03;424;236;188
049;002;001;033;01;432;221;211
049;002;001;033;02;432;215;217
049;002;001;033;03;432;223;209
049;002;001;033;04;430;228;202
049;002;001;034;01;440;213;227
049;002;001;034;02;440;245;195
049;002;001;034;03;435;205;230
049;002;001;034;04;432;203;229
049;002;001;034;05;432;208;224
049;002;001;034;06;432;212;220
049;002;001;035;01;376;215;161
049;002;001;035;02;376;212;164
049;002;001;035;03;375;213;162
049;002;001;036;01;350;204;146
049;002;001;036;02;344;171;173
049;002;001;037;01;312;148;164
049;002;001;037;02;312;153;159
049;002;001;038;01;108;63;45
049;002;001;039;01;304;156;148
049;002;001;039;02;302;148;154
049;002;001;039;03;296;165;131
049;002;001;040;01;350;171;179
049;002;001;040;02;344;169;175
049;002;001;041;01;360;206;154
049;002;001;042;01;241;172;69
049;002;001;043;01;183;102;81
049;002;001;044;01;432;247;185
049;002;001;044;02;428;229;199
049;002;001;044;03;424;206;218
049;002;001;044;04;424;222;202
049;002;001;045;01;450;235;215
049;002;001;045;02;449;234;215
049;002;001;046;01;374;196;178
049;002;001;046;02;368;205;163
049;002;001;047;01;392;196;196
049;002;001;047;02;390;162;228
049;002;001;048;01;73;40;33
049;002;001;049;01;249;126;123
049;002;001;050;01;450;434;16
049;002;001;050;02;450;437;13
049;002;001;050;03;449;424;25
049;002;001;051;01;396;200;196
049;002;001;051;02;392;196;196
049;002;001;051;03;392;205;187
049;002;001;052;01;400;201;199
049;002;001;052;02;395;214;181
049;002;001;052;03;392;197;195
049;002;001;052;04;392;217;175
049;002;001;052;05;392;207;185
049;002;001;053;01;353;189;164
049;002;001;053;02;352;201;151
049;002;001;053;03;352;205;147
049;002;001;053;04;352;208;144
049;002;001;054;01;408;213;195
049;002;001;054;02;408;198;210
049;002;001;054;03;404;207;197
049;002;001;054;04;400;198;202
049;002;001;054;05;400;196;204
049;002;001;054;06;400;214;186
049;002;001;054;07;400;199;201
049;002;001;055;01;440;219;221
049;002;001;055;02;439;226;213
049;002;001;055;03;432;207;225
049;002;001;055;04;432;226;206
049;002;001;055;05;432;221;211
049;002;001;055;06;432;227;205
049;002;001;056;01;400;197;203
049;002;001;056;02;397;191;206
049;002;001;056;03;392;199;193
049;002;001;057;01;400;208;192
049;002;001;057;02;400;203;197
049;002;001;057;03;400;212;188
049;002;001;057;04;400;192;208
049;002;001;057;05;398;207;191
049;002;001;057;06;392;204;188
049;002;001;058;01;384;175;209
049;002;001;058;02;384;185;199
049;002;001;058;03;384;197;187
049;002;001;058;04;380;189;191
049;002;001;059;01;416;249;167
049;002;001;059;02;416;259;157
049;002;001;059;03;413;290;123
049;002;001;059;04;408;280;128
049;002;001;059;05;408;255;153
049;002;001;059;06;408;268;140
049;002;001;060;01;400;250;150
049;002;001;060;02;396;231;165
049;002;001;061;01;393;251;142
049;002;001;062;01;400;200;200
049;002;001;062;02;400;193;207
049;002;001;062;03;400;211;189
049;002;001;062;04;400;207;193
049;002;001;062;05;400;188;212
049;002;001;062;06;400;205;195
049;002;001;062;07;397;191;206
049;002;001;062;08;392;197;195
049;002;001;063;01;404;209;195
049;002;001;063;02;400;206;194
049;002;001;064;01;416;207;209
049;002;001;064;02;415;212;203
049;002;001;065;01;304;115;189
049;002;001;065;02;304;120;184
049;002;001;065;03;296;131;165
049;002;001;066;01;328;174;154
049;002;001;066;02;324;159;165
049;002;001;066;03;320;179;141
049;002;001;067;01;193;94;99
049;002;001;068;01;187;102;85
049;002;001;069;01;436;244;192
049;002;001;070;01;337;182;155
049;002;001;071;01;166;88;78
049;002;001;072;01;218;111;107
049;002;001;073;01;68;35;33
049;002;001;074;01;357;176;181
049;002;001;075;01;85;47;38
049;002;001;076;01;300;157;143
049;002;001;077;01;86;48;38
049;002;001;078;01;253;98;155
049;002;001;078;02;248;98;150
049;002;001;079;01;166;78;88
049;002;001;080;01;214;119;95
049;002;001;081;01;244;126;118
049;002;001;082;01;301;138;163
049;002;098;001;01;391;195;196
049;002;098;002;01;88;48;40
049;002;098;003;01;384;216;168
049;002;098;003;02;379;184;195
049;002;098;004;01;284;135;149
049;002;098;005;01;111;54;57
049;002;098;006;01;115;71;44
049;002;098;007;01;239;117;122
049;002;098;007;02;232;107;125
049;002;098;008;01;171;95;76
049;002;098;009;01;145;91;54
049;002;098;010;01;407;206;201
049;002;098;011;01;165;76;89
049;002;098;012;01;93;51;42
049;002;098;013;01;248;133;115
049;002;098;013;02;246;106;140
049;002;098;014;01;160;83;77
049;002;098;015;01;302;149;153
049;002;098;016;01;248;124;124
049;002;098;017;01;240;120;120
049;002;098;017;02;236;125;111
049;002;098;018;01;220;119;101
049;002;098;019;01;176;95;81
049;002;098;020;01;253;119;134
049;002;098;021;01;243;137;106
049;002;098;022;01;270;134;136
049;002;098;023;01;336;151;185
049;002;098;023;02;334;175;159
049;002;098;024;01;392;198;194
049;002;098;025;01;288;147;141
049;002;098;025;02;287;137;150
049;002;098;026;01;435;231;204
049;002;098;027;01;272;142;130
049;002;098;027;02;265;131;134
049;002;098;028;01;381;207;174
049;002;098;029;01;142;69;73
049;002;098;030;01;104;58;46
049;002;098;031;01;336;171;165
049;002;098;031;02;332;156;176
049;002;098;032;01;384;190;194
049;002;098;032;02;383;197;186
049;002;098;033;01;255;128;127
049;002;098;033;02;248;115;133
049;002;098;034;01;360;180;180
049;002;098;035;01;330;179;151
049;002;098;036;01;186;81;105
049;002;098;037;01;186;89;97
049;002;098;038;01;230;132;98
049;002;098;039;01;152;86;66
049;002;098;040;01;256;143;113
049;002;098;040;02;251;134;117
049;002;098;041;01;160;84;76
049;002;098;042;01;344;174;170
049;002;098;042;02;344;170;174
049;002;098;043;01;347;165;182
049;002;098;044;01;295;139;156
049;002;098;045;01;60;27;33
049;002;098;046;01;450;221;229
049;002;098;047;01;42;20;22
049;002;098;048;01;424;231;193
049;002;098;049;01;289;155;134
049;002;098;050;01;270;148;122
049;002;098;051;01;276;132;144
049;002;098;052;01;139;73;66
049;002;098;053;01;131;69;62
049;002;098;054;01;74;42;32
049;003;098;001;01;123;62;61
049;003;098;002;01;304;149;155
049;003;098;002;02;304;155;149
049;003;098;002;03;299;152;147
049;003;098;003;01;433;214;219
049;003;098;004;01;440;219;221
049;003;098;004;02;440;209;231
049;003;098;004;03;440;215;225
049;003;098;004;04;440;227;213
049;003;098;004;05;439;229;210
049;003;098;005;01;364;178;186
049;003;098;006;01;268;120;148
049;003;098;006;02;264;145;119
049;003;098;007;01;106;49;57
049;003;098;008;01;217;115;102
049;003;098;009;01;240;119;121
049;003;098;009;02;232;125;107
049;003;098;010;01;272;134;138
049;003;098;010;02;265;136;129
049;003;098;011;01;240;107;133
049;003;098;011;02;240;101;139
049;003;098;012;01;87;50;37
049;003;098;013;01;321;154;167
049;003;098;013;02;320;155;165
049;003;098;014;01;246;121;125
049;003;098;015;01;164;87;77
049;003;098;016;01;446;219;227
049;003;098;017;01;274;140;134
049;003;098;018;01;180;97;83
049;003;098;019;01;248;117;131
049;003;098;019;02;247;142;105
049;003;098;020;01;266;133;133
049;003;098;021;01;448;223;225
049;003;098;021;02;448;215;233
049;003;098;021;03;447;217;230
049;003;098;021;04;440;186;254
049;003;098;021;05;440;225;215
049;003;098;022;01;118;54;64
049;003;098;023;01;83;46;37
049;003;098;024;01;134;69;65
049;003;098;025;01;68;40;28
049;003;098;026;01;319;167;152
049;003;098;027;01;54;27;27
049;003;098;028;01;152;72;80
049;003;098;029;01;349;175;174
049;003;098;030;01;237;114;123
049;003;098;031;01;47;26;21
049;003;098;032;01;102;48;54
049;003;098;033;01;317;163;154
049;003;098;034;01;120;69;51
049;003;098;035;01;204;95;109
049;003;098;036;01;416;235;181
049;003;098;036;02;416;220;196
049;003;098;036;03;416;243;173
049;004;001;001;01;324;172;152
049;004;001;002;01;245;122;123
049;004;001;003;01;92;46;46
049;004;001;004;01;360;195;165
049;004;001;004;02;352;190;162
049;004;001;005;01;299;137;162
049;004;001;006;01;215;118;97
049;004;001;007;01;152;85;67
049;004;001;008;01;170;86;84
049;004;001;009;01;149;83;66
049;004;001;010;01;272;151;121
049;004;001;011;01;294;152;142
049;004;001;012;01;371;178;193
049;004;001;013;01;199;105;94
049;004;001;014;01;101;52;49
049;004;001;015;01;176;97;79
049;004;001;016;01;331;151;180
049;004;001;016;02;328;160;168
049;004;001;017;01;247;126;121
049;004;001;018;01;345;176;169
049;004;001;018;02;344;159;185
049;004;001;019;01;243;124;119
049;004;001;020;01;232;119;113
049;004;001;020;02;231;112;119
049;004;001;021;01;341;170;171
049;004;001;022;01;192;87;105
049;004;001;023;01;368;200;168
049;004;001;023;02;367;165;202
049;004;001;024;01;367;187;180
049;004;001;025;01;153;81;72
049;004;001;026;01;345;155;190
049;004;001;027;01;148;83;65
049;004;098;001;01;141;85;56
049;004;098;002;01;259;136;123
049;004;098;002;02;256;129;127
049;004;098;003;01;164;69;95
049;004;098;004;01;105;56;49
049;004;098;005;01;130;71;59
049;004;098;006;01;116;62;54
049;004;098;007;01;83;47;36
049;004;098;008;01;110;55;55
049;004;098;009;01;135;73;62
049;004;098;010;01;120;70;50
049;004;098;011;01;312;173;139
049;004;098;011;02;306;169;137
049;004;098;012;01;76;41;35
049;004;098;013;01;220;117;103
049;004;098;014;01;397;217;180
049;004;098;015;01;114;62;52
049;004;098;016;01;226;115;111
049;004;098;017;01;392;200;192
049;004;098;018;01;266;135;131
049;004;098;019;01;130;66;64
049;004;098;020;01;380;191;189
049;004;098;020;02;376;189;187
049;004;098;021;01;240;124;116
049;004;098;021;02;235;120;115
049;004;098;022;01;64;31;33
049;004;098;023;01;291;136;155
049;004;098;023;02;288;136;152
049;004;098;024;01;384;191;193
049;004;098;025;01;217;118;99
049;004;098;026;01;401;221;180
049;004;098;027;01;191;100;91
049;004;098;028;01;320;175;145
049;004;098;028;02;318;148;170
049;004;098;029;01;344;150;194
049;004;098;029;02;344;181;163
049;004;098;029;03;343;157;186
049;004;098;030;01;51;29;22
049;004;098;031;01;68;37;31
049;004;098;032;01;373;201;172
049;004;098;033;01;119;62;57
049;004;098;034;01;149;78;71
049;004;098;035;01;134;64;70
049;004;098;036;01;359;192;167
049;004;098;037;01;183;98;85
049;004;098;038;01;96;51;45
049;004;098;039;01;116;52;64
049;004;098;041;01;83;40;43
049;004;098;043;01;149;93;56
049;004;098;044;01;58;35;23
049;005;098;001;01;264;134;130
049;005;098;002;01;247;153;94
049;005;098;003;01;277;170;107
049;005;098;004;01;159;103;56
049;005;098;005;01;229;126;103
049;005;098;006;01;79;44;35
049;005;098;007;01;180;104;76
049;005;098;008;01;312;164;148
049;005;098;008;02;310;147;163
049;005;098;009;01;448;221;227
049;005;098;009;02;448;211;237
049;005;098;010;01;205;103;102
049;005;098;011;01;143;85;58
049;005;098;012;01;442;266;176
049;005;098;013;01;131;66;65
049;005;098;014;01;257;139;118
049;005;098;015;01;266;149;117
049;005;098;016;01;320;192;128
049;005;098;019;01;102;50;52
049;005;098;020;01;90;50;40
049;005;098;021;01;360;176;184
049;005;098;022;01;94;59;35
049;006;098;001;01;257;123;134
049;006;098;002;01;206;97;109
049;006;098;003;01;433;210;223
049;006;098;003;02;432;209;223
049;006;098;003;03;432;232;200
049;006;098;004;01;110;58;52
049;006;098;005;01;232;131;101
049;006;098;005;02;230;126;104
049;006;098;007;01;183;110;73
049;006;098;008;01;163;96;67
049;006;098;009;01;150;80;70
049;006;098;010;01;134;68;66
049;006;098;011;01;244;129;115
049;006;098;012;01;193;104;89
049;006;098;013;01;129;68;61
049;006;098;014;01;356;184;172
049;006;098;015;01;392;211;181
049;006;098;015;02;391;199;192
049;006;098;015;03;384;195;189
049;006;098;015;04;384;180;204
049;006;098;015;05;384;187;197
049;006;098;015;06;384;188;196
049;006;098;015;07;384;182;202
049;006;098;016;01;448;233;215
049;006;098;016;02;441;236;205
049;006;098;016;03;440;222;218
049;006;098;016;04;440;227;213
049;006;098;017;01;161;90;71
049;006;098;018;01;118;70;48
049;006;098;019;01;94;53;41
049;006;098;020;01;172;105;67
049;006;098;021;01;358;190;168
049;006;098;022;01;349;177;172
050;001;098;001;01;248;125;123
050;001;098;001;02;242;123;119
050;001;098;002;01;368;183;185
050;001;098;002;02;367;183;184
050;001;098;002;03;360;201;159
050;001;098;002;04;360;181;179
050;001;098;002;05;360;173;187
050;001;098;003;01;103;55;48
050;001;098;004;01;377;199;178
050;001;098;005;01;447;217;230
050;001;098;006;01;365;187;178
050;001;098;007;01;299;145;154
050;001;098;007;02;296;153;143
050;001;098;008;01;143;76;67
050;001;098;009;01;248;120;128
050;001;098;009;02;241;125;116
050;001;098;010;01;313;153;160
050;001;098;011;01;330;168;162
050;001;098;012;01;336;176;160
050;001;098;012;02;329;162;167
050;001;098;013;01;179;83;96
050;001;098;014;01;146;84;62
050;001;098;016;01;232;120;112
050;002;098;001;01;387;210;177
050;002;098;002;01;71;44;27
050;002;098;003;01;272;142;130
050;002;098;003;02;271;149;122
050;002;098;004;01;200;112;88
050;002;098;005;01;266;152;114
050;002;098;005;02;264;144;120
050;002;098;006;01;322;191;131
050;002;098;007;01;121;66;55
050;002;098;008;01;384;205;179
050;002;098;008;02;384;204;180
050;002;098;009;01;286;169;117
050;002;098;010;01;231;116;115
050;002;098;010;02;224;115;109
050;002;098;011;01;260;156;104
050;002;098;011;02;256;138;118
050;002;098;012;01;248;121;127
050;002;098;012;02;248;134;114
050;002;098;013;01;448;246;202
050;002;098;013;02;448;250;198
050;002;098;013;03;448;230;218
050;002;098;013;04;446;233;213
050;002;098;015;01;391;212;179
050;002;098;016;01;304;165;139
050;002;098;017;01;374;203;171
050;002;098;017;02;368;196;172
050;002;098;018;01;304;169;135
050;002;098;019;01;290;159;131
050;002;098;020;01;327;168;159
050;002;098;021;01;399;223;176
050;002;098;022;01;171;104;67
050;002;098;023;01;424;231;193
050;002;098;024;01;299;170;129
050;002;098;025;01;237;118;119
050;003;001;001;01;432;219;213
050;003;001;001;02;432;229;203
050;003;001;001;03;432;238;194
050;003;001;001;04;432;204;228
050;003;001;001;05;425;231;194
050;003;001;002;01;392;209;183
050;003;001;002;02;391;200;191
050;003;001;002;03;384;195;189
050;003;001;002;04;384;191;193
050;003;001;002;05;384;190;194
050;003;001;003;01;368;178;190
050;003;001;003;02;368;196;172
050;003;001;003;03;360;169;191
050;003;001;004;01;424;200;224
050;003;001;004;02;424;228;196
050;003;001;004;03;424;205;219
050;003;001;004;04;419;214;205
050;003;001;005;01;424;212;212
050;003;001;005;02;421;212;209
050;003;001;005;03;416;205;211
050;003;001;005;04;416;236;180
050;003;001;006;01;416;208;208
050;003;001;006;02;416;213;203
050;003;001;006;03;412;206;206
050;003;001;006;04;408;207;201
050;003;001;007;01;368;195;173
050;003;001;007;02;368;189;179
050;003;001;007;03;368;169;199
050;003;001;007;04;361;183;178
050;003;001;008;01;400;195;205
050;003;001;008;02;400;204;196
050;003;001;008;03;393;197;196
050;003;001;009;01;432;227;205
050;003;001;009;02;432;243;189
050;003;001;009;03;432;228;204
050;003;001;009;04;424;227;197
050;003;001;010;01;368;185;183
050;003;001;010;02;368;157;211
050;003;001;010;03;363;190;173
050;003;001;010;04;360;165;195
050;003;001;010;05;360;183;177
050;003;001;011;01;384;206;178
050;003;001;011;02;384;183;201
050;003;001;011;03;377;183;194
050;003;001;011;04;376;198;178
050;003;001;011;05;376;182;194
050;003;001;011;06;376;190;186
050;003;001;012;01;367;201;166
050;003;001;012;02;360;198;162
050;003;001;012;03;360;195;165
050;003;001;012;04;360;217;143
050;003;001;013;01;374;216;158
050;003;001;013;02;368;192;176
050;003;001;013;03;368;190;178
050;003;001;014;01;450;239;211
050;003;001;014;02;448;229;219
050;003;001;015;01;352;203;149
050;003;001;015;02;348;186;162
050;003;001;015;03;344;187;157
050;003;001;016;01;283;156;127
050;003;001;017;01;408;218;190
050;003;001;018;01;236;146;90
050;003;001;019;01;336;158;178
050;003;001;019;02;335;170;165
050;003;001;020;01;414;212;202
050;003;001;020;02;408;224;184
050;003;001;021;01;229;125;104
050;003;001;022;01;177;92;85
050;003;001;023;01;304;149;155
050;003;001;023;02;304;163;141
050;003;001;024;01;410;236;174
050;003;001;025;01;263;146;117
050;003;001;026;01;162;84;78
050;003;001;027;01;328;175;153
050;003;001;028;01;239;136;103
050;003;001;029;01;228;124;104
050;003;001;030;01;211;113;98
050;003;001;031;01;269;150;119
050;003;001;032;01;446;234;212
050;003;001;033;01;406;241;165
050;003;001;034;01;392;182;210
050;003;001;034;02;392;197;195
050;003;001;034;03;388;199;189
050;003;001;035;01;360;219;141
050;003;001;035;02;360;207;153
050;003;001;035;03;360;190;170
050;003;001;035;04;354;185;169
050;003;001;036;01;256;135;121
050;003;001;036;02;253;116;137
050;003;001;037;01;352;188;164
050;003;001;037;02;344;176;168
050;003;001;037;03;344;177;167
050;003;001;037;04;344;189;155
050;003;001;038;01;232;124;108
050;003;001;038;02;229;120;109
050;003;001;039;01;72;48;24
050;003;001;040;01;73;31;42
050;003;001;041;01;203;118;85
050;003;098;001;01;299;167;132
050;003;098;002;01;235;124;111
050;003;098;002;02;232;132;100
050;003;098;003;01;114;60;54
050;003;098;004;01;245;117;128
050;003;098;005;01;332;200;132
050;003;098;006;01;233;124;109
050;003;098;007;01;97;49;48
050;003;098;008;01;196;97;99
050;003;098;009;01;302;161;141
050;003;098;010;01;385;190;195
050;003;098;010;02;384;190;194
050;003;098;011;01;341;179;162
050;003;098;012;01;358;181;177
050;003;098;013;01;127;68;59
050;003;098;014;01;155;79;76
050;003;098;015;01;250;141;109
050;003;098;015;02;248;132;116
050;003;098;016;01;102;60;42
050;003;098;017;01;218;126;92
050;003;098;018;01;155;85;70
050;003;098;019;01;268;132;136
050;004;001;001;01;408;210;198
050;004;001;001;02;408;194;214
050;004;001;001;03;408;204;204
050;004;001;001;04;408;206;202
050;004;001;001;05;405;196;209
050;004;001;002;01;395;206;189
050;004;001;002;02;392;182;210
050;004;001;002;03;392;196;196
050;004;001;002;04;392;191;201
050;004;001;002;05;392;172;220
050;004;001;003;01;424;225;199
050;004;001;003;02;424;208;216
050;004;001;003;03;424;232;192
050;004;001;003;04;422;207;215
050;004;001;003;05;416;191;225
050;004;001;004;01;345;186;159
050;004;001;005;01;258;137;121
050;004;001;006;01;348;179;169
050;004;001;006;02;344;163;181
050;004;001;007;01;322;176;146
050;004;001;007;02;320;141;179
050;004;001;007;03;320;168;152
050;004;001;008;01;181;100;81
050;004;001;009;01;256;133;123
050;004;001;009;02;254;131;123
050;004;001;010;01;351;185;166
050;004;001;010;02;344;169;175
050;004;001;011;01;100;59;41
050;004;001;012;01;439;213;226
050;004;001;013;01;292;153;139
050;004;001;013;02;288;147;141
050;004;001;014;01;227;115;112
050;004;001;015;01;353;184;169
050;004;001;016;01;238;130;108
050;004;001;016;02;232;106;126
050;004;001;017;01;264;139;125
050;004;001;017;02;256;133;123
050;004;001;018;01;363;198;165
050;004;001;019;01;301;158;143
050;004;001;019;02;296;151;145
050;004;001;020;01;440;247;193
050;004;001;020;02;440;236;204
050;004;001;020;03;440;201;239
050;004;001;020;04;437;218;219
050;004;001;021;01;161;87;74
050;004;001;022;01;237;128;109
050;004;001;023;01;234;125;109
050;004;001;024;01;427;220;207
050;004;001;025;01;367;201;166
050;004;001;026;01;293;147;146
050;004;001;027;01;445;233;212
050;004;001;028;01;227;117;110
050;004;001;029;01;335;172;163
050;004;001;030;01;440;223;217
050;004;001;032;01;113;62;51
050;004;098;001;01;262;128;134
050;004;098;001;02;256;124;132
050;004;098;002;01;240;108;132
050;004;098;002;02;233;100;133
050;004;098;003;01;281;163;118
050;004;098;004;01;152;83;69
050;004;098;005;01;303;187;116
050;004;098;006;01;126;70;56
050;004;098;007;01;396;212;184
050;004;098;008;01;185;99;86
050;004;098;009;01;330;161;169
050;004;098;010;01;167;94;73
050;004;098;011;01;270;141;129
050;004;098;012;01;245;131;114
050;004;098;013;01;240;124;116
050;004;098;013;02;240;126;114
050;004;098;014;01;370;206;164
050;004;098;015;01;189;101;88
050;004;098;016;01;332;172;160
050;004;098;017;01;254;122;132
050;004;098;018;01;318;156;162
050;004;098;019;01;263;134;129
050;004;098;020;01;252;136;116
050;004;098;021;01;108;58;50
050;004;098;022;01;267;133;134
050;004;098;023;01;344;175;169
050;004;098;024;01;212;107;105
050;004;098;025;01;268;152;116
050;004;098;026;01;244;117;127
050;004;098;026;02;240;130;110
050;004;098;027;01;71;40;31
050;004;098;028;01;103;58;45
050;005;098;001;01;53;25;28
050;005;098;002;01;377;186;191
050;005;098;003;01;376;199;177
050;005;098;004;01;345;173;172
050;005;098;004;02;344;186;158
050;005;098;005;01;369;179;190
050;005;098;006;01;205;119;86
050;005;098;007;01;400;174;226
050;005;098;007;02;392;191;201
050;005;098;007;03;392;215;177
050;005;098;007;04;392;176;216
050;005;098;008;01;256;147;109
050;005;098;009;01;125;67;58
050;005;098;010;01;402;218;184
050;005;098;011;01;288;147;141
050;005;098;011;02;284;153;131
050;005;098;012;01;376;180;196
050;005;098;012;02;371;193;178
050;005;098;012;03;368;189;179
050;005;098;013;01;146;75;71
050;005;098;014;01;411;201;210
050;005;098;015;01;204;110;94
050;006;098;001;01;156;80;76
050;006;098;002;01;423;233;190
050;006;098;003;01;185;111;74
050;006;098;004;01;392;231;161
050;006;098;004;02;390;219;171
050;006;098;004;03;384;214;170
050;006;098;005;01;156;85;71
050;006;098;006;01;256;138;118
050;006;098;006;02;254;134;120
050;006;098;007;01;244;134;110
050;006;098;008;01;272;126;146
050;006;098;008;02;266;141;125
050;006;098;009;01;307;166;141
050;006;098;010;01;390;215;175
050;006;098;011;01;180;98;82
050;006;098;012;01;292;168;124
050;006;098;013;01;362;189;173
050;006;098;014;01;280;148;132
050;006;098;014;02;272;147;125
050;006;098;015;01;170;86;84
050;006;098;016;01;359;206;153
050;006;098;017;01;174;94;80
050;006;098;018;01;323;183;140
050;006;098;018;02;320;185;135
050;006;098;019;01;261;154;107
050;006;098;020;01;332;179;153
050;006;098;021;01;428;244;184
050;006;098;022;01;279;164;115
050;006;098;023;01;369;199;170
050;006;098;024;01;140;80;60
050;006;098;025;01;254;152;102
050;006;098;026;01;178;97;81
050;006;098;027;01;252;146;106
050;006;098;028;01;215;110;105
050;007;098;001;01;296;160;136
050;007;098;001;02;294;164;130
050;007;098;002;01;248;138;110
050;007;098;003;01;296;172;124
050;007;098;003;02;289;145;144
050;007;098;004;01;190;106;84
050;007;098;005;01;232;114;118
050;007;098;005;02;224;108;116
050;007;098;006;01;285;138;147
050;007;098;007;01;298;155;143
050;007;098;007;02;296;130;166
050;007;098;008;01;158;79;79
050;007;098;009;01;249;137;112
050;007;098;010;01;368;194;174
050;007;098;010;02;360;188;172
050;007;098;011;01;183;99;84
050;007;098;012;01;282;154;128
050;007;098;013;01;146;65;81
050;007;098;014;01;123;73;50
050;007;098;015;01;373;207;166
050;007;098;016;01;265;140;125
050;007;098;017;01;355;176;179
050;007;098;018;01;237;124;113
051;001;098;001;01;320;169;151
051;001;098;001;02;313;190;123
051;001;098;002;01;118;66;52
051;001;098;003;01;140;84;56
051;001;098;004;01;280;138;142
051;001;098;004;02;272;133;139
051;001;098;005;01;197;106;91
051;001;098;006;01;109;67;42
051;001;098;007;01;52;30;22
051;001;098;008;01;418;229;189
051;001;098;009;01;296;175;121
051;001;098;010;01;385;208;177
051;001;098;010;02;384;207;177
051;001;098;010;03;384;201;183
051;001;098;011;01;143;94;49
051;001;098;012;01;186;103;83
051;001;098;013;01;178;93;85
051;001;098;014;01;74;34;40
051;001;098;015;01;296;175;121
051;001;098;015;02;293;195;98
051;001;098;016;01;390;217;173
051;001;098;016;02;384;216;168
051;001;098;017;01;248;129;119
051;001;098;017;02;244;136;108
051;001;098;018;01;330;204;126
051;001;098;019;01;250;147;103
051;001;098;020;01;294;168;126
051;001;098;021;01;416;225;191
051;001;098;021;02;416;204;212
051;001;098;021;03;410;233;177
051;001;098;023;01;294;147;147
051;001;098;024;01;244;135;109
051;001;098;025;01;106;58;48
051;001;098;026;01;323;176;147
051;001;098;027;01;331;179;152
051;001;098;027;02;328;179;149
051;001;098;028;01;253;125;128
051;001;098;029;01;216;101;115
051;001;098;030;01;286;206;80
051;001;098;031;01;234;130;104
051;001;098;031;02;232;141;91
051;001;098;032;01;417;231;186
051;001;098;033;01;328;168;160
051;001;098;033;02;323;162;161
051;001;098;034;01;155;79;76
051;001;098;037;01;190;113;77
051;002;098;001;01;360;196;164
051;002;098;001;02;352;189;163
051;002;098;002;01;276;192;84
051;002;098;003;01;94;50;44
051;002;098;004;01;208;132;76
051;002;098;005;01;194;118;76
051;002;098;006;01;144;75;69
051;002;098;007;01;114;72;42
051;002;098;008;01;329;161;168
051;002;098;010;01;314;149;165
051;002;098;011;01;216;117;99
051;002;098;012;01;328;157;171
051;002;098;012;02;321;177;144
051;002;098;013;01;173;100;73
051;002;098;014;01;98;52;46
051;002;098;015;01;329;158;171
051;002;098;016;01;363;179;184
051;002;098;017;01;376;207;169
051;002;098;017;02;376;186;190
051;002;098;017;03;375;209;166
051;002;098;018;01;116;60;56
051;002;098;019;01;432;229;203
051;002;098;020;01;224;119;105
051;002;098;021;01;356;203;153
051;002;098;022;01;282;161;121
051;002;098;022;02;280;133;147
051;002;098;023;01;203;106;97
051;002;098;024;01;214;121;93
051;002;098;025;01;370;241;129
051;002;098;025;02;368;227;141
051;002;098;026;01;199;114;85
051;002;098;027;01;197;106;91
051;002;098;028;01;369;170;199
051;002;098;029;01;138;76;62
051;002;098;030;01;143;80;63
051;002;098;031;01;387;190;197
051;002;098;032;01;297;166;131
051;002;098;033;01;329;183;146
051;002;098;034;01;202;104;98
051;002;098;035;01;273;138;135
051;002;098;036;01;279;143;136
051;002;098;037;01;111;44;67
051;003;001;001;01;386;204;182
051;003;001;002;01;431;248;183
051;003;001;002;02;424;215;209
051;003;001;003;01;230;148;82
051;003;001;004;01;276;138;138
051;003;001;004;02;272;161;111
051;003;001;005;01;304;158;146
051;003;001;005;02;302;151;151
051;003;001;006;01;388;235;153
051;003;001;006;02;384;211;173
051;003;001;007;01;294;159;135
051;003;001;008;01;314;166;148
051;003;001;009;01;355;178;177
051;003;001;010;01;264;141;123
051;003;001;011;01;348;194;154
051;003;001;011;02;344;194;150
051;003;001;012;01;139;83;56
051;003;001;013;01;416;228;188
051;003;001;013;02;416;236;180
051;003;001;013;03;408;220;188
051;003;001;013;04;408;242;166
051;003;001;014;01;400;206;194
051;003;001;014;02;400;221;179
051;003;001;014;03;400;192;208
051;003;001;014;04;400;229;171
051;003;001;014;05;400;222;178
051;003;001;014;06;400;236;164
051;003;001;014;07;393;248;145
051;003;001;015;01;401;224;177
051;003;001;015;02;400;215;185
051;003;001;015;03;400;216;184
051;003;001;016;01;384;221;163
051;003;001;016;02;379;219;160
051;003;001;016;03;376;201;175
051;003;001;016;04;376;214;162
051;003;001;016;05;376;236;140
051;003;001;017;01;415;188;227
051;003;001;017;02;408;192;216
051;003;001;018;01;432;227;205
051;003;001;018;02;432;207;225
051;003;001;018;03;432;208;224
051;003;001;018;04;425;224;201
051;003;001;018;05;424;226;198
051;003;001;019;01;416;216;200
051;003;001;019;02;410;224;186
051;003;001;019;03;408;228;180
051;003;001;019;04;408;224;184
051;003;001;020;01;368;209;159
051;003;001;020;02;362;219;143
051;003;001;020;03;360;200;160
051;003;001;020;04;360;210;150
051;003;001;021;01;401;203;198
051;003;001;022;01;198;97;101
051;003;001;023;01;149;80;69
051;003;001;024;01;100;58;42
051;003;001;025;01;392;226;166
051;003;001;025;02;390;196;194
051;003;001;025;03;384;203;181
051;003;001;025;04;384;222;162
051;003;001;026;01;190;106;84
051;003;001;027;01;435;244;191
051;003;001;027;02;432;236;196
051;003;001;027;03;432;239;193
051;003;001;028;01;103;59;44
051;003;098;001;01;432;212;220
051;003;098;001;02;432;224;208
051;003;098;002;01;248;122;126
051;003;098;002;02;240;136;104
051;003;098;003;01;99;50;49
051;003;098;004;01;165;93;72
051;003;098;005;01;384;189;195
051;003;098;005;02;384;188;196
051;003;098;005;03;384;195;189
051;003;098;005;04;377;205;172
051;003;098;006;01;308;155;153
051;003;098;006;02;304;159;145
051;003;098;007;01;106;59;47
051;003;098;008;01;152;78;74
051;003;098;009;01;416;220;196
051;003;098;009;02;410;216;194
051;003;098;010;01;81;43;38
051;004;098;001;01;253;114;139
051;004;098;002;01;100;59;41
051;004;098;003;01;320;180;140
051;004;098;003;02;317;189;128
051;004;098;003;03;312;183;129
051;004;098;004;01;337;161;176
051;004;098;005;01;442;250;192
051;004;098;006;01;158;89;69
051;004;098;007;01;415;225;190
051;004;098;008;01;276;118;158
051;004;098;008;02;272;133;139
051;004;098;009;01;265;156;109
051;004;098;010;01;115;73;42
051;004;098;011;01;305;161;144
051;004;098;011;02;304;160;144
051;004;098;012;01;442;228;214
051;004;098;013;01;234;128;106
051;004;098;014;01;93;52;41
051;004;098;015;01;425;215;210
051;004;098;016;01;191;110;81
051;004;098;017;01;142;88;54
051;005;098;001;01;238;144;94
051;005;098;002;01;412;226;186
051;005;098;003;01;312;190;122
051;005;098;004;01;405;216;189
051;005;098;005;01;232;134;98
051;005;098;005;02;225;133;92
051;005;098;006;01;172;95;77
051;005;098;007;01;313;169;144
051;005;098;008;01;191;97;94
051;005;098;009;01;123;56;67
051;005;098;010;01;437;225;212
051;005;098;011;01;315;160;155
051;005;098;012;01;100;49;51
051;005;098;013;01;225;127;98
051;005;098;014;01;115;53;62
051;005;098;015;01;176;85;91
051;005;098;016;01;190;93;97
051;005;098;017;01;82;42;40
051;005;098;018;01;124;50;74
051;006;098;001;01;210;113;97
051;006;098;002;01;150;84;66
051;006;098;003;01;382;160;222
051;006;098;004;01;116;63;53
051;006;098;005;01;64;38;26
051;006;098;006;01;66;34;32
051;006;098;007;01;116;62;54
051;006;098;008;01;172;83;89
051;006;098;009;01;132;71;61
051;006;098;010;01;256;149;107
051;006;098;010;02;248;129;119
051;006;098;011;01;139;73;66
051;006;098;012;01;128;68;60
051;006;098;013;01;96;51;45
051;006;098;014;01;174;91;83
051;006;098;015;01;227;129;98
051;006;098;016;01;107;62;45
051;006;098;017;01;124;63;61
052;006;001;001;01;408;214;194
052;006;001;001;02;408;221;187
052;006;001;001;03;405;191;214
052;006;001;002;01;440;212;228
052;006;001;002;02;433;217;216
052;006;001;002;03;432;219;213
052;006;001;003;01;199;98;101
052;006;001;004;01;42;27;15
052;006;001;005;01;352;182;170
052;006;001;005;02;352;176;176
052;006;001;006;01;412;230;182
052;006;001;007;01;316;165;151
052;006;001;008;01;410;192;218
052;006;001;009;01;295;149;146
052;006;001;010;01;232;127;105
052;006;001;011;01;424;224;200
052;006;001;011;02;418;223;195
052;006;001;012;01;90;51;39
052;006;001;013;01;145;88;57
052;006;001;014;01;310;182;128
052;006;001;014;02;304;151;153
052;006;001;014;03;304;165;139
052;006;001;015;01;131;69;62
052;006;001;016;01;258;137;121
052;006;001;018;01;173;103;70
052;006;001;019;01;317;174;143
052;006;001;020;01;157;80;77
052;006;001;021;01;256;136;120
052;006;001;021;02;256;157;99
052;006;001;022;01;336;177;159
052;006;001;022;02;334;180;154
052;006;001;022;03;328;158;170
052;006;001;023;01;288;160;128
052;006;001;023;02;280;153;127
052;006;098;001;01;368;222;146
052;006;098;001;02;367;191;176
052;006;098;001;03;360;197;163
052;006;098;002;01;178;106;72
052;006;098;003;01;431;257;174
052;006;098;004;01;274;169;105
052;006;098;005;01;34;19;15
052;007;098;001;01;336;186;150
052;007;098;001;02;336;233;103
052;007;098;001;03;336;205;131
052;007;098;002;01;143;79;64
052;007;098;003;01;244;154;90
052;007;098;004;01;198;127;71
052;007;098;005;01;160;91;69
052;007;098;006;01;256;190;66
052;008;098;001;01;58;32;26
052;008;098;002;01;272;142;130
052;008;098;002;02;264;156;108
052;008;098;003;01;112;76;36
052;008;098;004;01;182;105;77
052;008;098;005;01;148;100;48
052;008;098;006;01;376;193;183
052;008;098;006;02;374;214;160
052;008;098;007;01;344;190;154
052;008;098;007;02;338;198;140
052;008;098;007;03;336;196;140
052;008;098;007;04;336;203;133
052;008;098;008;01;129;73;56
052;008;098;009;01;303;183;120
052;008;098;010;01;76;44;32
052;008;098;011;01;318;179;139
052;008;098;012;01;352;184;168
052;008;098;012;02;347;206;141
052;008;098;013;01;120;60;60
052;008;098;014;01;122;68;54
052;008;098;015;01;104;53;51
052;008;098;017;01;132;76;56
052;009;098;001;01;368;216;152
052;009;098;001;02;368;177;191
052;009;098;001;03;368;194;174
052;009;098;001;04;368;205;163
052;009;098;001;05;368;206;162
052;009;098;002;01;360;196;164
052;009;098;002;02;355;193;162
052;009;098;003;01;182;93;89
052;009;098;004;01;128;65;63
052;009;098;005;01;92;40;52
052;009;098;006;01;60;26;34
052;009;098;007;01;110;58;52
052;009;098;008;01;335;177;158
052;009;098;009;01;65;26;39
052;009;098;010;01;199;106;93
052;009;098;011;01;126;73;53
052;009;098;012;01;128;64;64
052;009;098;013;01;352;174;178
052;009;098;013;02;350;179;171
052;009;098;014;01;169;98;71
052;009;098;015;01;65;46;19
053;001;001;001;01;335;189;146
053;001;001;001;02;328;152;176
053;001;001;001;03;328;193;135
053;001;001;002;01;352;200;152
053;001;001;002;02;352;193;159
053;001;001;002;03;346;205;141
053;001;001;003;01;400;194;206
053;001;001;003;02;400;203;197
053;001;001;003;03;400;182;218
053;001;001;003;04;397;174;223
053;001;001;004;01;392;193;199
053;001;001;004;02;392;208;184
053;001;001;004;03;392;180;212
053;001;001;004;04;392;168;224
053;001;001;004;05;392;211;181
053;001;001;004;06;387;213;174
053;001;001;004;07;384;188;196
053;001;001;005;01;440;217;223
053;001;001;005;02;440;194;246
053;001;001;005;03;435;199;236
053;001;001;006;01;416;213;203
053;001;001;006;02;416;215;201
053;001;001;006;03;416;191;225
053;001;001;006;04;414;212;202
053;001;001;006;05;408;221;187
053;001;001;007;01;392;194;198
053;001;001;007;02;389;197;192
053;001;001;007;03;384;176;208
053;001;001;007;04;384;209;175
053;001;001;008;01;424;205;219
053;001;001;008;02;419;185;234
053;001;001;008;03;416;184;232
053;001;001;008;04;416;166;250
053;001;001;008;05;416;213;203
053;001;001;008;06;416;181;235
053;001;001;009;01;400;199;201
053;001;001;009;02;400;172;228
053;001;001;009;03;392;187;205
053;001;001;009;04;392;185;207
053;001;001;010;01;396;179;217
053;001;001;010;02;392;166;226
053;001;001;011;01;401;196;205
053;001;001;011;02;400;178;222
053;001;001;011;03;400;184;216
053;001;001;011;04;400;192;208
053;001;001;012;01;254;139;115
053;001;001;013;01;357;183;174
053;001;001;014;01;300;152;148
053;001;001;015;01;450;238;212
053;001;001;016;01;250;130;120
053;001;001;017;01;387;171;216
053;001;001;017;02;384;192;192
053;001;001;017;03;384;176;208
053;001;001;018;01;442;212;230
053;001;001;019;01;414;201;213
053;001;001;020;01;377;204;173
053;001;001;020;02;376;167;209
053;001;001;021;01;240;133;107
053;001;001;022;01;296;146;150
053;001;001;022;02;288;133;155
053;001;001;023;01;407;170;237
053;001;001;023;02;400;183;217
053;001;001;023;03;400;208;192
053;001;001;024;01;384;182;202
053;001;001;024;02;382;168;214
053;001;001;025;01;414;189;225
053;001;001;025;02;408;198;210
053;001;001;026;01;256;107;149
053;001;001;026;02;248;132;116
053;001;001;027;01;272;129;143
053;001;001;028;01;344;166;178
053;001;001;028;02;344;141;203
053;001;001;028;03;343;177;166
053;001;001;029;01;302;158;144
053;001;001;030;01;384;189;195
053;001;001;030;02;384;200;184
053;001;001;030;03;377;209;168
053;001;001;031;01;164;92;72
053;001;001;032;01;130;74;56
053;001;001;033;01;263;143;120
053;001;001;034;01;373;166;207
053;001;001;034;02;368;185;183
053;001;001;035;01;323;167;156
053;001;001;036;01;190;95;95
053;001;001;037;01;333;165;168
053;001;001;037;02;328;166;162
053;001;001;038;01;232;95;137
053;001;001;038;02;228;114;114
053;001;001;039;01;404;215;189
053;001;001;039;02;400;195;205
053;001;001;040;01;272;181;91
053;001;001;040;02;268;168;100
053;001;001;041;01;228;118;110
053;001;001;042;01;140;81;59
053;001;001;043;01;166;88;78
053;001;001;044;01;253;131;122
053;001;001;044;02;248;143;105
053;001;001;048;01;136;71;65
053;001;098;001;01;135;76;59
053;001;098;002;01;201;105;96
053;001;098;004;01;227;127;100
053;002;001;001;01;425;217;208
053;002;001;001;02;424;211;213
053;002;001;001;03;424;221;203
053;002;001;002;01;383;184;199
053;002;001;002;02;376;195;181
053;002;001;002;03;376;205;171
053;002;001;003;01;275;152;123
053;002;001;004;01;167;91;76
053;002;001;005;01;245;125;120
053;002;001;006;01;80;44;36
053;002;001;007;01;366;210;156
053;002;001;008;01;129;68;61
053;002;001;009;01;164;103;61
053;002;001;010;01;268;134;134
053;002;001;011;01;143;76;67
053;002;001;012;01;90;51;39
053;002;001;013;01;408;243;165
053;002;001;014;01;312;166;146
053;002;001;015;01;171;109;62
053;002;098;001;01;304;165;139
053;002;098;001;02;300;136;164
053;002;098;002;01;355;199;156
053;002;098;003;01;371;204;167
053;002;098;004;01;307;177;130
053;002;098;005;01;76;39;37
053;002;098;006;01;312;158;154
053;002;098;007;01;249;136;113
053;002;098;008;01;107;66;41
053;006;098;001;01;335;191;144
053;006;098;002;01;411;227;184
053;006;098;002;02;408;216;192
053;006;098;003;01;248;140;108
053;006;098;004;01;274;170;104
053;006;098;005;01;314;158;156
053;006;098;006;01;195;107;88
053;006;098;007;01;350;170;180
053;006;098;008;01;157;86;71
053;006;098;009;01;92;54;38
053;007;098;001;01;352;186;166
053;007;098;001;02;352;163;189
053;007;098;001;03;352;185;167
053;007;098;002;01;138;68;70
053;007;098;003;01;336;167;169
053;007;098;003;02;330;166;164
053;007;098;004;01;379;182;197
053;007;098;004;02;376;170;206
053;007;098;005;01;227;127;100
053;007;098;006;01;230;112;118
053;007;098;007;01;92;48;44
053;007;098;008;01;86;42;44
053;007;098;009;01;154;67;87
053;007;098;010;01;103;66;37
053;007;098;011;01;207;107;100
053;007;098;012;01;109;53;56
054;001;098;001;01;211;101;110
054;001;098;002;01;287;117;170
054;001;098;002;02;280;151;129
054;001;098;003;01;290;125;165
054;001;098;004;01;249;119;130
054;001;098;005;01;292;142;150
054;001;098;006;01;354;154;200
054;001;098;007;01;432;166;266
054;001;098;007;02;432;189;243
054;001;098;008;01;400;185;215
054;001;098;008;02;400;184;216
054;001;098;009;01;359;173;186
054;001;098;010;01;202;95;107
054;001;098;011;01;132;63;69
054;001;098;012;01;349;150;199
054;001;098;013;01;51;28;23
054;001;098;014;01;176;75;101
054;001;098;015;01;448;200;248
054;001;098;016;01;201;103;98
054;001;098;017;01;94;45;49
054;001;098;018;01;320;145;175
054;003;001;001;01;312;166;146
054;003;001;001;02;312;185;127
054;003;001;001;03;308;146;162
054;003;001;002;01;387;200;187
054;003;001;002;02;384;172;212
054;003;001;002;03;384;175;209
054;003;001;002;04;384;184;200
054;003;001;003;01;368;192;176
054;003;001;003;02;368;174;194
054;003;001;003;03;368;183;185
054;003;001;003;04;361;193;168
054;003;001;003;05;360;182;178
054;003;001;004;01;416;191;225
054;003;001;004;02;416;173;243
054;003;001;004;03;411;224;187
054;003;001;005;01;344;149;195
054;003;001;005;02;337;153;184
054;003;001;005;03;336;155;181
054;003;001;006;01;256;106;150
054;003;001;006;02;249;132;117
054;003;001;007;01;410;192;218
054;003;001;007;02;408;192;216
054;003;001;008;01;384;205;179
054;003;001;008;02;379;201;178
054;003;001;009;01;309;143;166
054;003;001;010;01;192;100;92
054;003;001;011;01;230;107;123
054;003;001;012;01;222;108;114
054;003;001;013;01;438;225;213
054;003;001;014;01;408;200;208
054;003;001;014;02;408;208;200
054;003;001;015;01;143;63;80
054;003;098;001;01;132;68;64
054;003;098;002;01;334;136;198
054;003;098;002;02;328;152;176
054;003;098;003;01;264;125;139
054;003;098;003;02;259;124;135
054;003;098;004;01;287;128;159
054;003;098;005;01;206;101;105
054;003;098;006;01;228;106;122
054;003;098;007;01;120;63;57
054;003;098;008;01;340;150;190
054;003;098;009;01;424;190;234
054;003;098;010;01;170;80;90
054;003;098;011;01;199;89;110
054;003;098;012;01;381;185;196
054;003;098;013;01;241;112;129
054;003;098;013;02;240;110;130
054;003;098;014;01;272;128;144
054;003;098;014;02;268;116;152
054;003;098;015;01;172;78;94
054;003;098;016;01;235;105;130
054;003;098;017;01;101;46;55
054;003;098;018;01;177;78;99
054;003;098;019;01;197;100;97
054;003;098;020;01;192;86;106
054;003;098;021;01;175;68;107
054;003;098;022;01;284;115;169
054;003;098;023;01;264;111;153
054;003;098;024;01;197;87;110
054;003;098;025;01;362;180;182
054;003;098;026;01;365;169;196
054;003;098;027;01;165;78;87
054;003;098;028;01;289;124;165
054;003;098;029;01;220;110;110
054;003;098;030;01;171;80;91
054;003;098;031;01;114;67;47
054;003;098;032;01;416;177;239
054;003;098;033;01;389;187;202
054;003;098;034;01;292;135;157
054;003;098;035;01;315;133;182
054;003;098;036;01;223;99;124
054;003;098;037;01;186;83;103
054;003;098;038;01;108;40;68
054;003;098;039;01;173;86;87
054;003;098;040;01;51;29;22
054;003;098;041;01;78;44;34
054;003;098;042;01;113;55;58
054;003;098;043;01;58;33;25
054;004;098;001;01;220;98;122
054;004;098;002;01;219;90;129
054;004;098;003;01;272;116;156
054;004;098;003;02;264;123;141
054;004;098;004;01;268;129;139
054;004;098;005;01;393;159;234
054;004;098;006;01;281;146;135
054;004;098;007;01;196;80;116
054;004;098;008;01;313;137;176
054;004;098;009;01;179;78;101
054;004;098;010;01;142;70;72
054;004;098;011;01;94;47;47
054;004;098;012;01;121;56;65
054;004;098;013;01;79;33;46
054;004;098;014;01;89;48;41
054;004;098;015;01;85;45;40
054;004;098;016;01;82;38;44
054;004;098;017;01;50;27;23
055;002;098;001;01;174;82;92
055;002;098;002;01;252;118;134
055;002;098;003;01;382;189;193
055;002;098;004;01;424;198;226
055;002;098;004;02;424;175;249
055;002;098;004;03;419;216;203
055;002;098;005;01;350;154;196
055;002;098;006;01;328;157;171
055;002;098;007;01;256;103;153
055;002;098;007;02;254;141;113
055;002;098;008;01;214;100;114
055;002;098;009;01;251;122;129
055;002;098;010;01;163;70;93
055;002;098;011;01;122;64;58
055;002;098;012;01;333;153;180
055;002;098;013;01;155;80;75
055;002;098;014;01;212;94;118
055;004;001;001;01;400;199;201
055;004;001;001;02;400;202;198
055;004;001;001;03;400;202;198
055;004;001;001;04;398;189;209
055;004;001;001;05;392;196;196
055;004;001;002;01;432;186;246
055;004;001;002;02;432;213;219
055;004;001;002;03;427;175;252
055;004;001;002;04;424;198;226
055;004;001;003;01;445;199;246
055;004;001;004;01;269;126;143
055;004;001;005;01;246;117;129
055;004;001;005;02;240;115;125
055;004;001;006;01;264;118;146
055;004;001;006;02;261;119;142
055;004;001;007;01;350;158;192
055;004;001;008;01;241;111;130
055;004;001;009;01;256;119;137
055;004;001;009;02;255;126;129
055;004;001;010;01;391;187;204
055;004;001;011;01;298;146;152
055;004;001;011;02;296;120;176
055;004;001;012;01;275;116;159
055;004;001;012;02;272;130;142
055;004;001;013;01;407;195;212
055;004;001;014;01;311;181;130
055;004;001;015;01;368;185;183
055;004;001;016;01;161;75;86
055;004;098;001;01;322;143;179
055;004;098;002;01;320;133;187
055;004;098;003;01;344;122;222
055;004;098;003;02;344;183;161
055;004;098;004;01;320;143;177
055;004;098;004;02;312;152;160
055;004;098;005;01;374;182;192
055;004;098;006;01;198;93;105
055;004;098;007;01;33;21;12
055;004;098;008;01;271;117;154
055;004;098;008;02;264;116;148
055;004;098;009;01;368;153;215
055;004;098;009;02;368;165;203
055;004;098;009;03;363;176;187
055;004;098;010;01;312;122;190
055;004;098;010;02;312;139;173
055;004;098;010;03;304;122;182
055;004;098;011;01;349;172;177
055;004;098;013;01;301;143;158
055;004;098;014;01;177;86;91
055;004;098;017;01;123;55;68
055;005;098;001;01;346;157;189
055;005;098;002;01;268;103;165
055;005;098;002;02;264;140;124
055;005;098;003;01;404;189;215
055;005;098;003;02;400;192;208
055;005;098;004;01;181;86;95
055;005;098;005;01;189;96;93
055;005;098;006;01;234;119;115
055;005;098;007;01;88;42;46
055;005;098;008;01;200;91;109
055;006;098;001;01;305;136;169
055;006;098;002;01;267;129;138
055;006;098;003;01;298;142;156
055;006;098;003;02;296;137;159
055;006;098;004;01;272;132;140
055;006;098;004;02;266;118;148
055;006;098;005;01;448;216;232
055;006;098;005;02;444;227;217
055;006;098;006;01;234;110;124
055;006;098;006;02;232;126;106
055;006;098;007;01;319;148;171
055;006;098;008;01;177;75;102
055;006;098;009;01;246;129;117
055;006;098;010;01;158;83;75
055;006;098;011;01;98;49;49
055;006;098;012;01;167;85;82
055;007;098;001;01;313;153;160
055;007;098;002;01;312;136;176
055;007;098;002;02;312;128;184
055;007;098;002;03;311;166;145
055;007;098;003;01;390;186;204
055;007;098;004;01;232;106;126
055;007;098;005;01;197;90;107
055;007;098;006;01;287;143;144
055;007;098;006;02;280;138;142
055;007;098;007;01;407;189;218
055;007;098;008;01;326;166;160
055;007;098;009;01;250;115;135
055;007;098;010;01;190;92;98
056;001;001;001;01;384;186;198
056;001;001;001;02;384;214;170
056;001;001;001;03;384;203;181
056;001;001;001;04;384;198;186
056;001;001;001;05;379;195;184
056;001;001;001;06;376;205;171
056;001;001;002;01;448;230;218
056;001;001;002;02;442;201;241
056;001;001;002;03;440;234;206
056;001;001;003;01;392;188;204
056;001;001;003;02;392;228;164
056;001;001;003;03;385;193;192
056;001;001;003;04;384;217;167
056;001;001;003;05;384;180;204
056;001;001;003;06;384;195;189
056;001;001;003;07;384;197;187
056;001;001;004;01;440;208;232
056;001;001;004;02;440;243;197
056;001;001;004;03;440;220;220
056;001;001;004;04;440;249;191
056;001;001;004;05;440;223;217
056;001;001;004;06;435;237;198
056;001;001;005;01;448;203;245
056;001;001;005;02;447;206;241
056;001;001;005;03;440;210;230
056;001;001;005;04;440;218;222
056;001;001;006;01;432;216;216
056;001;001;006;02;432;236;196
056;001;001;006;03;432;222;210
056;001;001;006;04;432;221;211
056;001;001;006;05;432;222;210
056;001;001;006;06;432;225;207
056;001;001;006;07;432;205;227
056;001;001;006;08;427;213;214
056;001;001;006;09;424;221;203
056;001;001;006;10;424;219;205
056;001;001;006;11;424;212;212
056;001;001;007;01;400;191;209
056;001;001;007;02;400;196;204
056;001;001;007;03;400;198;202
056;001;001;007;04;392;190;202
056;001;001;007;05;392;187;205
056;001;001;007;06;392;187;205
056;001;001;007;07;392;203;189
056;001;001;007;08;392;187;205
056;001;001;008;01;368;177;191
056;001;001;008;02;368;175;193
056;001;001;008;03;368;178;190
056;001;001;008;04;367;178;189
056;001;001;009;01;448;218;230
056;001;001;009;02;448;201;247
056;001;001;009;03;448;209;239
056;001;001;009;04;447;231;216
056;001;001;010;01;448;223;225
056;001;001;010;02;448;201;247
056;001;001;010;03;443;204;239
056;001;001;010;04;440;244;196
056;001;001;011;01;400;198;202
056;001;001;011;02;400;195;205
056;001;001;011;03;400;183;217
056;001;001;011;04;392;189;203
056;001;001;011;05;392;201;191
056;001;001;011;06;392;195;197
056;001;001;012;01;352;201;151
056;001;001;013;01;180;135;45
056;001;001;014;01;443;220;223
056;001;001;014;02;440;213;227
056;001;001;014;03;440;212;228
056;001;001;014;04;440;188;252
056;001;001;015;01;344;151;193
056;001;001;015;02;344;149;195
056;001;001;015;03;337;167;170
056;001;001;016;01;397;166;231
056;001;001;016;02;392;134;258
056;001;001;016;03;392;177;215
056;001;001;017;01;408;185;223
056;001;001;017;02;406;180;226
056;001;001;017;03;400;204;196
056;001;001;018;01;352;170;182
056;001;001;018;02;352;181;171
056;001;001;018;03;347;157;190
056;001;001;018;04;344;187;157
056;001;001;019;01;305;159;146
056;001;001;019;02;304;158;146
056;001;001;020;01;319;151;168
056;001;001;021;01;387;213;174
056;001;001;022;01;264;172;92
056;001;001;023;01;376;172;204
056;001;001;023;02;376;183;193
056;001;001;023;03;370;192;178
056;001;001;024;01;448;202;246
056;001;001;024;02;448;220;228
056;001;001;024;03;440;222;218
056;001;001;024;04;440;210;230
056;001;001;026;01;145;88;57
056;001;001;027;01;296;142;154
056;001;001;027;02;289;164;125
056;001;001;028;01;402;173;229
056;001;001;028;02;400;198;202
056;001;001;028;03;400;185;215
056;001;001;028;04;400;171;229
056;001;001;028;05;400;196;204
056;001;001;029;01;384;209;175
056;001;001;029;02;384;202;182
056;001;001;029;03;378;183;195
056;001;001;029;04;376;193;183
056;001;001;030;01;432;201;231
056;001;001;030;02;427;227;200
056;001;001;030;03;424;231;193
056;001;001;031;01;376;164;212
056;001;001;031;02;376;173;203
056;001;001;031;03;375;174;201
056;001;001;032;01;440;199;241
056;001;001;032;02;434;208;226
056;001;001;032;03;432;209;223
056;001;001;032;04;432;219;213
056;001;001;032;05;432;202;230
056;001;001;032;06;432;226;206
056;001;001;033;01;358;229;129
056;001;001;033;02;352;239;113
056;001;001;034;01;156;96;60
056;001;001;035;01;94;48;46
056;001;001;037;01;65;27;38
056;001;001;038;01;116;51;65
056;001;001;039;01;230;111;119
056;001;001;040;01;127;71;56
056;001;001;041;01;93;47;46
056;001;001;042;01;95;41;54
056;001;098;001;01;109;66;43
056;001;098;002;01;392;214;178
056;001;098;002;02;392;215;177
056;001;098;002;03;385;166;219
056;001;098;002;04;384;196;188
056;001;098;003;01;237;133;104
056;001;098;004;01;223;129;94
056;001;098;005;01;52;31;21
056;001;098;006;01;149;92;57
056;001;098;007;01;56;32;24
056;001;098;008;01;332;172;160
056;001;098;009;01;408;181;227
056;001;098;009;02;408;203;205
056;001;098;009;03;400;214;186
056;001;098;010;01;101;60;41
056;003;001;001;01;248;148;100
056;003;001;001;02;241;142;99
056;003;001;002;01;421;217;204
056;003;001;002;02;416;205;211
056;003;001;002;03;416;225;191
056;003;001;003;01;344;153;191
056;003;001;003;02;344;142;202
056;003;001;003;03;344;179;165
056;003;001;003;04;344;180;164
056;003;001;004;01;400;194;206
056;003;001;004;02;400;207;193
056;003;001;004;03;393;206;187
056;003;001;005;01;400;208;192
056;003;001;006;01;137;81;56
056;003;001;007;01;316;161;155
056;003;001;007;02;312;174;138
056;003;001;007;03;312;161;151
056;003;001;008;01;99;65;34
056;003;001;009;01;402;218;184
056;003;098;001;01;376;183;193
056;003;098;001;02;375;181;194
056;003;098;002;01;404;213;191
056;003;098;003;01;360;176;184
056;003;098;003;02;360;191;169
056;003;098;003;03;360;183;177
056;003;098;003;04;353;189;164
056;003;098;004;01;326;191;135
056;003;098;005;01;369;258;111
056;003;098;006;01;304;150;154
056;003;098;006;02;304;160;144
056;003;098;007;01;263;133;130
056;003;098;008;01;191;94;97
056;003;098;009;01;54;30;24
056;003;098;010;01;84;38;46
056;003;098;011;01;23;12;11
056;004;098;001;01;416;224;192
056;004;098;001;02;411;184;227
056;004;098;002;01;336;172;164
056;004;098;002;02;330;171;159
056;004;098;003;01;352;184;168
056;004;098;003;02;350;172;178
056;004;098;004;01;289;150;139
056;004;098;005;01;385;199;186
056;004;098;006;01;119;58;61
056;004;098;007;01;311;160;151
056;004;098;007;02;304;143;161
056;004;098;008;01;279;164;115
056;004;098;009;01;81;44;37
056;004;098;010;01;371;192;179
056;004;098;011;01;394;187;207
056;004;098;012;01;272;132;140
056;004;098;012;02;272;115;157
056;004;098;013;01;419;186;233
056;004;098;013;02;416;209;207
056;004;098;014;01;128;67;61
056;004;098;016;01;27;9;18
056;005;098;001;01;408;189;219
056;005;098;001;02;408;221;187
056;005;098;001;03;403;207;196
056;005;098;001;04;400;207;193
056;005;098;002;01;408;200;208
056;005;098;002;02;408;195;213
056;005;098;003;01;120;66;54
056;005;098;004;01;381;205;176
056;005;098;005;01;328;167;161
056;005;098;005;02;327;155;172
056;005;098;006;01;248;126;122
056;005;098;006;02;243;136;107
056;005;098;007;01;264;134;130
056;005;098;007;02;256;156;100
056;005;098;008;01;281;147;134
056;005;098;009;01;173;99;74
056;005;098;010;01;450;218;232
056;005;098;010;02;450;227;223
056;005;098;011;01;365;190;175
056;005;098;012;01;324;179;145
056;005;098;013;01;352;164;188
056;005;098;013;02;352;178;174
056;005;098;013;03;351;183;168
056;005;098;014;01;119;69;50
056;005;098;016;01;88;49;39
056;005;098;017;01;355;176;179
056;006;098;001;01;272;136;136
056;006;098;001;02;271;155;116
056;006;098;002;01;440;221;219
056;006;098;003;01;368;160;208
056;006;098;003;02;368;173;195
056;006;098;003;03;368;167;201
056;006;098;003;04;368;177;191
056;006;098;004;01;388;178;210
056;006;098;004;02;384;172;212
056;006;098;004;03;384;197;187
056;006;098;005;01;233;161;72
056;006;098;006;01;225;136;89
056;006;098;007;01;117;53;64
056;006;098;008;01;130;65;65
056;007;098;001;01;432;186;246
056;007;098;001;02;432;221;211
056;007;098;001;03;432;192;240
056;007;098;001;04;432;214;218
056;007;098;001;05;425;202;223
056;007;098;002;01;256;129;127
056;007;098;002;02;256;124;132
056;007;098;003;01;432;201;231
056;007;098;003;02;424;203;221
056;007;098;003;03;424;199;225
056;007;098;003;04;424;224;200
056;007;098;004;01;280;141;139
056;007;098;004;02;275;137;138
056;007;098;005;01;314;158;156
056;007;098;005;02;312;164;148
056;007;098;005;03;312;163;149
056;007;098;006;01;312;149;163
056;007;098;006;02;305;140;165
056;007;098;007;01;424;222;202
056;007;098;007;02;420;201;219
056;007;098;007;03;416;210;206
056;007;098;008;01;312;135;177
056;007;098;008;02;312;135;177
056;007;098;008;03;309;164;145
056;007;098;009;01;189;110;79
056;007;098;010;01;319;139;180
056;007;098;010;02;312;151;161
056;007;098;010;03;312;168;144
056;007;098;011;01;304;144;160
056;007;098;011;02;304;156;148
056;007;098;011;03;299;140;159
056;007;098;012;01;178;95;83
056;007;098;013;01;101;44;57
056;007;098;014;01;112;68;44
056;007;098;015;01;275;125;150
056;008;098;001;01;450;210;240
056;008;098;001;02;450;206;244
056;008;098;001;03;450;227;223
056;008;098;001;04;450;208;242
056;008;098;001;05;450;229;221
056;008;098;002;01;323;149;174
056;008;098;002;02;320;164;156
056;008;098;003;01;298;168;130
056;008;098;004;01;408;212;196
056;008;098;004;02;408;220;188
056;008;098;005;01;336;153;183
056;008;098;005;02;329;166;163
056;008;098;006;01;113;68;45
056;008;098;007;01;410;248;162
056;008;098;008;01;289;152;137
056;008;098;009;01;269;132;137
056;008;098;010;01;218;127;91
056;008;098;011;01;62;32;30
056;008;098;012;01;126;60;66
056;008;098;013;01;74;49;25
057;001;001;001;01;376;175;201
057;001;001;001;02;376;208;168
057;001;001;001;03;371;189;182
057;001;001;001;04;368;206;162
057;001;001;001;05;368;207;161
057;001;001;002;01;432;191;241
057;001;001;002;02;432;226;206
057;001;001;002;03;432;237;195
057;001;001;002;04;432;203;229
057;001;001;002;05;432;241;191
057;001;001;002;06;432;226;206
057;001;001;002;07;432;236;196
057;001;001;002;08;431;237;194
057;001;001;002;09;424;222;202
057;001;001;003;01;392;172;220
057;001;001;003;02;392;215;177
057;001;001;003;03;392;203;189
057;001;001;003;04;392;193;199
057;001;001;003;05;392;200;192
057;001;001;003;06;392;190;202
057;001;001;003;07;392;218;174
057;001;001;004;01;425;219;206
057;001;001;004;02;424;226;198
057;001;001;004;03;424;223;201
057;001;001;004;04;424;221;203
057;001;001;004;05;424;267;157
057;001;001;005;01;424;205;219
057;001;001;005;02;424;241;183
057;001;001;005;03;424;225;199
057;001;001;005;04;424;254;170
057;001;001;005;05;424;235;189
057;001;001;005;06;416;232;184
057;001;001;005;07;416;231;185
057;001;001;005;08;416;257;159
057;001;001;006;01;400;193;207
057;001;001;006;02;400;226;174
057;001;001;006;03;400;219;181
057;001;001;006;04;392;224;168
057;001;001;007;01;432;182;250
057;001;001;007;02;432;227;205
057;001;001;007;03;432;220;212
057;001;001;007;04;432;209;223
057;001;001;007;05;432;193;239
057;001;001;007;06;432;212;220
057;001;001;007;07;432;208;224
057;001;001;007;08;431;232;199
057;001;001;008;01;392;183;209
057;001;001;008;02;389;196;193
057;001;001;009;01;342;164;178
057;001;001;009;02;336;150;186
057;001;001;010;01;422;206;216
057;001;001;011;01;329;188;141
057;001;001;011;02;328;186;142
057;001;001;012;01;251;118;133
057;001;001;012;02;248;119;129
057;001;001;013;01;335;149;186
057;001;001;013;02;328;142;186
057;001;001;014;01;344;165;179
057;001;001;014;02;337;162;175
057;001;001;015;01;336;171;165
057;001;001;016;01;376;204;172
057;001;001;016;02;372;218;154
057;001;001;016;03;368;206;162
057;001;001;016;04;368;218;150
057;001;001;017;01;404;215;189
057;001;001;018;01;152;99;53
057;001;001;019;01;388;182;206
057;001;001;020;01;304;148;156
057;001;001;020;02;299;140;159
057;001;098;001;01;242;128;114
057;001;098;001;02;240;117;123
057;001;098;002;01;320;163;157
057;001;098;002;02;316;168;148
057;001;098;003;01;203;127;76
057;002;098;001;01;328;160;168
057;002;098;001;02;328;158;170
057;002;098;002;01;334;176;158
057;002;098;003;01;338;167;171
057;002;098;004;01;144;89;55
057;002;098;005;01;384;184;200
057;002;098;005;02;381;211;170
057;002;098;006;01;237;105;132
057;002;098;006;02;232;97;135
057;002;098;007;01;405;215;190
057;002;098;008;01;282;172;110
057;002;098;008;02;280;173;107
057;002;098;009;01;89;55;34
057;003;098;001;01;266;153;113
057;003;098;001;02;264;124;140
057;003;098;002;01;378;175;203
057;003;098;002;02;376;194;182
057;003;098;003;01;450;216;234
057;003;098;003;02;448;203;245
057;003;098;004;01;296;141;155
057;003;098;004;02;296;137;159
057;003;098;005;01;88;48;40
057;003;098;006;01;141;78;63
057;003;098;007;01;352;151;201
057;003;098;007;02;347;171;176
057;003;098;008;01;111;58;53
057;003;098;009;01;179;89;90
057;003;098;010;01;53;34;19
057;003;098;012;01;61;41;20
057;004;098;001;01;432;222;210
057;004;098;001;02;425;207;218
057;004;098;002;01;390;208;182
057;004;098;003;01;160;93;67
057;004;098;004;01;273;145;128
057;004;098;005;01;289;154;135
057;004;098;005;02;288;160;128
057;004;098;006;01;432;225;207
057;004;098;006;02;424;227;197
057;004;098;007;01;179;93;86
057;004;098;008;01;112;60;52
057;004;098;009;01;136;70;66
057;004;098;010;01;261;123;138
057;004;098;011;01;344;154;190
057;004;098;011;02;336;183;153
057;004;098;011;03;336;186;150
057;004;098;012;01;142;85;57
057;004;098;013;01;340;183;157
057;004;098;014;01;378;228;150
057;004;098;015;01;183;106;77
057;004;098;016;01;211;113;98
057;004;098;017;01;117;74;43
057;004;098;018;01;380;185;195
057;004;098;019;01;163;95;68
057;004;098;020;01;116;72;44
057;004;098;021;01;123;82;41
057;004;098;022;01;86;50;36
057;005;098;001;01;308;141;167
057;005;098;001;02;304;140;164
057;005;098;002;01;440;218;222
057;005;098;002;02;432;198;234
057;005;098;003;01;442;231;211
057;005;098;004;01;132;73;59
057;005;098;005;01;97;49;48
057;005;098;006;01;108;62;46
057;005;098;007;01;358;149;209
057;005;098;007;02;352;174;178
057;005;098;010;01;63;36;27
058;002;001;001;01;408;222;186
058;002;001;001;02;407;221;186
058;002;001;002;01;296;151;145
058;002;001;002;02;292;143;149
058;002;001;003;01;289;176;113
058;002;001;003;02;288;161;127
058;002;001;004;01;400;197;203
058;002;001;004;02;400;223;177
058;002;001;004;03;394;196;198
058;002;001;004;04;392;204;188
058;002;001;005;01;420;236;184
058;002;001;005;02;416;224;192
058;002;001;006;01;272;147;125
058;002;001;006;02;265;151;114
058;002;001;007;01;238;114;124
058;002;001;008;01;403;245;158
058;002;001;009;01;264;157;107
058;002;001;009;02;263;157;106
058;002;001;010;01;435;255;180
058;002;001;011;01;64;29;35
058;002;098;001;01;232;115;117
058;002;098;001;02;225;121;104
058;002;098;002;01;176;120;56
058;002;098;003;01;367;170;197
058;002;098;003;02;360;179;181
058;002;098;003;03;360;175;185
058;002;098;004;01;128;89;39
058;003;098;001;01;136;70;66
058;003;098;002;01;339;181;158
058;003;098;002;02;336;170;166
058;003;098;002;03;336;192;144
058;003;098;003;01;450;229;221
058;003;098;003;02;449;236;213
058;003;098;003;03;448;226;222
058;003;098;004;01;374;206;168
058;003;098;005;01;158;98;60
058;003;098;006;01;117;72;45
058;003;098;007;01;116;65;51
058;003;098;008;01;448;276;172
058;003;098;008;02;445;251;194
058;003;098;009;01;278;157;121
058;003;098;010;01;246;154;92
058;003;098;010;02;240;147;93
058;003;098;011;01;258;145;113
058;003;098;011;02;256;145;111
058;003;098;012;01;83;52;31
058;003;098;013;01;119;61;58
059;005;001;001;01;376;195;181
059;005;001;001;02;368;193;175
059;005;001;001;03;368;150;218
059;005;001;001;04;368;198;170
059;005;001;002;01;338;164;174
059;005;001;002;02;336;187;149
059;005;001;002;03;336;161;175
059;005;001;003;01;436;197;239
059;005;001;004;01;354;171;183
059;005;001;004;02;352;154;198
059;005;001;005;01;145;76;69
059;005;001;006;01;269;139;130
059;005;001;007;01;124;61;63
059;005;001;008;01;288;135;153
059;005;001;008;02;288;139;149
059;005;001;009;01;327;164;163
059;005;001;009;02;320;154;166
059;005;001;010;01;165;75;90
059;005;098;001;01;320;152;168
059;005;098;001;02;312;136;176
059;005;098;002;01;372;167;205
059;005;098;002;02;368;187;181
059;005;098;002;03;368;148;220
059;005;098;003;01;134;67;67
059;005;098;004;01;440;209;231
059;005;098;004;02;434;202;232
059;005;098;005;01;256;117;139
059;005;098;005;02;254;112;142
059;005;098;006;01;299;148;151
059;005;098;007;01;422;192;230
059;005;098;008;01;370;201;169
059;005;098;009;01;336;182;154
059;005;098;009;02;332;145;187
059;005;098;010;01;299;145;154
059;005;098;011;01;250;118;132
059;005;098;011;02;248;100;148
059;005;098;012;01;421;172;249
059;010;098;001;01;247;116;131
059;010;098;002;01;158;79;79
059;010;098;003;01;370;187;183
059;010;098;003;02;368;171;197
059;010;098;003;03;368;155;213
059;010;098;004;01;423;204;219
059;010;098;005;01;440;216;224
059;012;098;001;01;210;105;105
059;012;098;002;01;398;175;223
059;012;098;002;02;392;170;222
059;012;098;003;01;304;132;172
059;012;098;003;02;297;137;160
059;012;098;004;01;344;127;217
059;012;098;004;02;336;154;182
059;012;098;005;01;392;181;211
059;012;098;006;01;360;147;213
059;012;098;006;02;360;180;180
059;012;098;007;01;112;49;63
060;001;001;001;01;347;170;177
060;001;001;001;02;344;175;169
060;001;001;002;01;242;122;120
060;001;001;002;02;240;118;122
060;001;001;003;01;232;107;125
060;001;001;003;02;231;99;132
060;001;001;004;01;303;152;151
060;001;001;005;01;295;143;152
060;001;001;006;01;344;161;183
060;001;001;006;02;343;155;188
060;001;001;007;01;272;135;137
060;001;001;007;02;272;141;131
060;001;001;009;01;37;17;20
060;001;098;001;01;245;109;136
060;001;098;002;01;252;130;122
060;001;098;003;01;300;147;153
060;001;098;004;01;267;168;99
060;001;098;005;01;337;191;146
060;001;098;006;01;108;62;46
060;001;098;007;01;322;192;130
060;001;098;008;01;265;134;131
060;001;098;009;01;390;183;207
060;001;098;009;02;384;186;198
060;001;098;010;01;196;106;90
060;001;098;011;01;328;154;174
060;001;098;011;02;325;131;194
060;001;098;012;01;444;221;223
060;001;098;013;01;288;133;155
060;001;098;013;02;280;129;151
060;001;098;014;01;349;166;183
060;001;098;015;01;344;152;192
060;001;098;015;02;339;152;187
060;001;098;016;01;172;81;91
060;001;098;017;01;265;143;122
060;001;098;018;01;77;49;28
060;001;098;020;01;140;75;65
060;002;001;001;01;428;240;188
060;002;001;002;01;248;120;128
060;002;001;002;02;240;112;128
060;002;001;003;01;109;57;52
060;002;001;004;01;116;53;63
060;002;001;005;01;354;187;167
060;002;001;006;01;76;40;36
060;002;098;001;01;342;202;140
060;002;098;002;01;133;68;65
060;002;098;003;01;167;82;85
060;002;098;004;01;242;135;107
060;002;098;005;01;264;144;120
060;002;098;006;01;227;114;113
060;002;098;007;01;427;200;227
060;002;098;008;01;392;195;197
060;002;098;009;01;419;196;223
060;002;098;010;01;386;189;197
060;002;098;011;01;70;44;26
060;007;001;001;01;432;226;206
060;007;001;001;02;426;192;234
060;007;001;001;03;424;219;205
060;007;001;001;04;424;179;245
060;007;001;001;05;424;209;215
060;007;001;001;06;424;244;180
060;007;001;002;01;404;183;221
060;007;001;002;02;400;204;196
060;007;001;002;03;400;226;174
060;007;001;003;01;272;170;102
060;007;001;003;02;268;155;113
060;007;001;004;01;376;202;174
060;007;001;004;02;376;188;188
060;007;001;004;03;374;194;180
060;007;001;005;01;280;165;115
060;007;001;005;02;274;165;109
060;007;001;006;01;329;159;170
060;007;001;006;02;328;152;176
060;007;001;006;03;328;191;137
060;007;001;007;01;376;206;170
060;007;001;007;02;371;187;184
060;007;001;007;03;368;206;162
060;007;001;007;04;368;199;169
060;007;001;009;01;360;184;176
060;007;001;009;02;355;179;176
060;007;001;009;03;352;173;179
060;007;001;009;04;352;171;181
060;007;001;010;01;408;172;236
060;007;001;010;02;408;185;223
060;007;001;010;03;408;182;226
060;007;001;010;04;408;180;228
060;007;001;010;05;408;210;198
060;007;001;010;06;408;171;237
060;007;001;010;07;407;157;250
060;007;001;010;08;400;198;202
060;007;001;010;09;400;177;223
060;007;001;011;01;450;198;252
060;007;001;011;02;450;221;229
060;007;001;011;03;448;220;228
060;007;001;011;04;448;198;250
060;007;001;011;05;448;208;240
060;007;001;011;06;448;166;282
060;007;001;011;07;448;216;232
060;007;001;011;08;448;231;217
060;007;001;011;09;448;232;216
060;007;001;012;01;400;213;187
060;007;001;012;02;397;217;180
060;007;001;012;03;392;204;188
060;007;001;012;04;392;223;169
060;007;001;013;01;392;172;220
060;007;001;013;02;390;194;196
060;007;001;013;03;384;165;219
060;007;001;013;04;384;167;217
060;007;001;013;05;384;174;210
060;007;001;013;06;384;182;202
060;007;001;014;01;316;179;137
060;007;001;014;02;312;151;161
060;007;001;014;03;312;173;139
060;007;001;015;01;324;183;141
060;007;001;015;02;320;185;135
060;007;001;015;03;320;178;142
060;007;001;016;01;216;112;104
060;007;001;017;01;416;202;214
060;007;001;017;02;411;197;214
060;007;001;017;03;408;209;199
060;007;001;018;01;416;204;212
060;007;001;018;02;416;217;199
060;007;001;018;03;415;229;186
060;007;001;019;01;320;155;165
060;007;001;019;02;320;149;171
060;007;001;019;03;318;174;144
060;007;001;020;01;347;186;161
060;007;001;020;02;344;154;190
060;007;001;020;03;344;165;179
060;007;001;020;04;344;173;171
060;007;001;021;01;368;198;170
060;007;001;021;02;368;184;184
060;007;001;021;03;362;197;165
060;007;001;021;04;360;169;191
060;007;001;021;05;360;197;163
060;007;001;022;01;264;144;120
060;007;001;022;02;256;149;107
060;007;001;023;01;235;143;92
060;007;001;023;02;232;122;110
060;007;001;024;01;215;114;101
060;007;001;025;01;368;170;198
060;007;001;026;01;342;185;157
060;007;098;001;01;115;54;61
060;007;098;002;01;279;138;141
060;007;098;003;01;169;90;79
060;007;098;004;01;191;87;104
060;007;098;005;01;301;131;170
060;007;098;006;01;369;170;199
060;007;098;007;01;342;155;187
060;007;098;007;02;336;182;154
060;007;098;008;01;306;148;158
060;007;098;009;01;248;124;124
060;007;098;009;02;246;115;131
060;007;098;010;01;301;137;164
060;007;098;011;01;240;99;141
060;007;098;011;02;238;111;127
060;007;098;012;01;142;73;69
060;007;098;013;01;219;99;120
060;007;098;014;01;447;206;241
060;011;001;001;01;443;201;242
060;011;001;001;02;440;208;232
060;011;001;002;01;249;165;84
060;011;001;002;02;248;151;97
060;011;001;003;01;416;211;205
060;011;001;003;02;416;222;194
060;011;001;005;01;360;170;190
060;011;001;005;02;360;146;214
060;011;001;006;01;195;93;102
060;011;001;007;01;272;140;132
060;011;001;007;02;270;116;154
060;011;001;008;01;210;101;109
060;011;001;009;01;92;47;45
060;011;001;010;01;368;175;193
060;011;001;010;02;364;204;160
060;011;001;010;03;360;162;198
060;014;098;001;01;273;141;132
060;014;098;002;01;176;84;92
060;014;098;003;01;293;133;160
060;014;098;004;01;320;140;180
060;014;098;004;02;316;170;146
060;014;098;004;03;312;159;153
060;014;098;005;01;312;165;147
060;014;098;005;02;304;152;152
060;014;098;005;03;304;129;175
060;014;098;006;01;272;121;151
060;014;098;006;02;270;135;135
060;014;098;007;01;333;156;177
060;014;098;007;02;328;161;167
060;014;098;008;01;230;117;113
060;014;098;012;01;152;71;81
061;008;001;001;01;360;188;172
061;008;001;001;02;357;173;184
061;008;001;002;01;360;167;193
061;008;001;002;02;360;181;179
061;008;001;002;03;360;139;221
061;008;001;002;04;357;173;184
061;008;001;003;01;408;185;223
061;008;001;003;02;408;210;198
061;008;001;003;03;404;177;227
061;008;001;004;01;61;35;26
061;008;098;001;01;373;167;206
061;008;098;002;01;378;185;193
061;008;098;003;01;267;129;138
061;009;098;001;01;440;193;247
061;009;098;002;01;441;212;229
061;009;098;003;01;307;143;164
061;009;098;003;02;304;136;168
061;009;098;004;01;335;161;174
061;009;098;004;02;328;141;187
061;009;098;005;01;203;97;106
061;009;098;006;01;448;199;249
061;009;098;006;02;447;211;236
061;009;098;007;01;374;172;202
061;009;098;008;01;271;137;134
061;009;098;009;01;231;116;115
061;009;098;010;01;232;128;104
061;009;098;010;02;229;103;126
062;001;001;001;01;416;201;215
062;001;001;001;02;416;197;219
062;001;001;001;03;416;232;184
062;001;001;001;04;416;201;215
062;001;001;001;05;409;233;176
062;001;001;001;06;408;206;202
062;001;001;001;07;408;199;209
062;001;001;001;08;408;215;193
062;001;001;001;09;408;214;194
062;001;001;001;10;408;197;211
062;001;001;002;01;424;198;226
062;001;001;002;02;424;231;193
062;001;001;002;03;424;222;202
062;001;001;002;04;424;208;216
062;001;001;002;05;424;181;243
062;001;001;002;06;424;227;197
062;001;001;002;07;423;215;208
062;001;001;002;08;416;233;183
062;001;001;002;09;416;171;245
062;001;001;002;10;416;205;211
062;001;001;002;11;416;211;205
062;001;001;002;12;416;217;199
062;001;001;003;01;449;170;279
062;001;001;003;02;448;199;249
062;001;001;003;03;448;193;255
062;001;001;003;04;448;197;251
062;001;001;004;01;392;199;193
062;001;001;004;02;392;194;198
062;001;001;004;03;392;198;194
062;001;001;004;04;385;223;162
062;001;001;005;01;450;214;236
062;001;001;005;02;450;212;238
062;001;001;005;03;450;233;217
062;001;001;005;04;450;222;228
062;001;001;005;05;448;233;215
062;001;001;006;01;424;205;219
062;001;001;006;02;424;233;191
062;001;001;006;03;421;196;225
062;001;001;006;04;416;204;212
062;001;001;006;05;416;216;200
062;001;001;007;01;408;218;190
062;001;001;007;02;408;210;198
062;001;001;007;03;408;202;206
062;001;001;007;04;408;222;186
062;001;001;007;05;408;223;185
062;001;001;007;06;408;208;200
062;001;001;007;07;403;226;177
062;001;001;007;08;400;177;223
062;001;001;008;01;440;195;245
062;001;001;008;02;433;193;240
062;001;001;008;03;432;178;254
062;001;001;008;04;432;217;215
062;001;001;008;05;432;215;217
062;001;001;009;01;417;221;196
062;001;001;010;01;432;222;210
062;001;001;010;02;431;215;216
062;001;001;010;03;424;214;210
062;001;001;010;04;424;202;222
062;001;001;010;05;424;201;223
062;001;001;010;06;424;226;198
062;001;001;010;07;424;205;219
062;001;001;010;08;424;208;216
062;001;001;011;01;440;214;226
062;001;001;011;02;440;198;242
062;001;001;011;03;440;198;242
062;001;001;011;04;435;218;217
062;001;001;011;05;432;191;241
062;001;001;012;01;408;210;198
062;001;001;012;02;408;203;205
062;001;001;012;03;404;214;190
062;001;001;012;04;400;210;190
062;001;001;013;01;435;219;216
062;001;001;013;02;432;220;212
062;001;001;013;03;432;214;218
062;001;001;013;04;432;242;190
062;001;001;013;05;432;233;199
062;001;001;014;01;424;235;189
062;001;001;014;02;424;227;197
062;001;001;014;03;424;212;212
062;001;001;014;04;424;231;193
062;001;001;014;05;424;241;183
062;001;001;014;06;419;222;197
062;001;001;014;07;416;227;189
062;001;001;014;08;416;233;183
062;001;001;015;01;408;224;184
062;001;001;015;02;407;217;190
062;001;001;015;03;400;193;207
062;001;001;015;04;400;211;189
062;001;001;015;05;400;225;175
062;001;001;015;06;400;211;189
062;001;001;015;07;400;202;198
062;001;001;015;08;400;206;194
062;001;001;016;01;408;199;209
062;001;001;016;02;408;206;202
062;001;001;016;03;408;218;190
062;001;001;016;04;408;198;210
062;001;001;016;05;408;188;220
062;001;001;016;06;408;220;188
062;001;001;016;07;406;212;194
062;001;001;017;01;416;224;192
062;001;001;017;02;416;214;202
062;001;001;017;03;416;206;210
062;001;001;017;04;416;219;197
062;001;001;017;05;408;198;210
062;001;001;017;06;408;223;185
062;001;001;017;07;408;198;210
062;001;001;017;08;408;209;199
062;001;001;017;09;408;222;186
062;001;001;017;10;408;199;209
062;001;001;017;11;408;217;191
062;001;001;018;01;416;238;178
062;001;001;018;02;416;223;193
062;001;001;018;03;416;214;202
062;001;001;018;04;412;205;207
062;001;001;018;05;408;188;220
062;001;001;018;06;408;202;206
062;001;001;018;07;408;200;208
062;001;001;018;08;408;222;186
062;001;001;018;09;408;228;180
062;001;001;018;10;408;243;165
062;001;001;019;01;424;213;211
062;001;001;019;02;424;221;203
062;001;001;019;03;424;197;227
062;001;001;019;04;424;210;214
062;001;001;019;05;424;189;235
062;001;001;019;06;424;212;212
062;001;001;019;07;424;202;222
062;001;001;019;08;423;213;210
062;001;001;019;09;416;220;196
062;001;001;019;10;416;201;215
062;001;001;019;11;416;218;198
062;001;001;020;01;376;203;173
062;001;001;020;02;375;218;157
062;001;001;021;01;445;261;184
062;001;001;022;01;312;165;147
062;001;001;022;02;308;156;152
062;001;001;023;01;285;155;130
062;001;001;023;02;280;145;135
062;001;001;024;01;357;192;165
062;001;001;025;01;236;143;93
062;001;001;026;01;384;203;181
062;001;001;026;02;379;205;174
062;001;001;027;01;424;218;206
062;001;001;027;02;424;232;192
062;001;001;027;03;420;202;218
062;001;001;027;04;416;210;206
062;001;001;027;05;416;208;208
062;001;001;027;06;416;219;197
062;001;001;028;01;365;198;167
062;001;001;029;01;258;146;112
062;001;001;029;02;256;131;125
062;001;001;030;01;216;116;100
062;001;001;031;01;348;180;168
062;001;001;031;02;344;190;154
062;001;001;032;01;296;157;139
062;001;001;032;02;295;155;140
062;001;001;033;01;404;231;173
062;001;001;034;01;264;145;119
062;001;001;034;02;263;129;134
062;001;001;035;01;302;177;125
062;001;001;035;02;296;152;144
062;001;001;036;01;381;208;173
062;001;001;037;01;424;234;190
062;001;001;038;01;338;168;170
062;001;001;038;02;336;152;184
062;001;001;038;03;336;179;157
062;001;001;039;01;353;195;158
062;001;001;040;01;317;174;143
062;001;001;041;01;435;225;210
062;001;001;041;02;432;202;230
062;001;001;041;03;432;213;219
062;001;001;041;04;432;224;208
062;001;001;042;01;425;211;214
062;001;001;042;02;424;209;215
062;001;001;042;03;424;204;220
062;001;001;042;04;424;186;238
062;001;001;042;05;424;203;221
062;001;001;042;06;424;221;203
062;001;001;042;07;424;206;218
062;001;001;043;01;416;225;191
062;001;001;043;02;415;228;187
062;001;001;043;03;408;222;186
062;001;001;044;01;276;132;144
062;001;001;044;02;272;131;141
062;001;001;045;01;347;205;142
062;001;001;045;02;344;195;149
062;001;001;047;01;163;88;75
062;001;001;048;01;426;242;184
062;001;001;048;02;424;247;177
062;001;001;049;01;440;223;217
062;001;001;049;02;438;212;226
062;001;001;049;03;432;215;217
062;001;001;050;01;424;190;234
062;001;001;050;02;424;215;209
062;001;001;050;03;416;190;226
062;001;001;051;01;352;160;192
062;001;001;051;02;352;157;195
062;001;001;051;03;345;136;209
062;001;001;052;01;328;159;169
062;001;001;052;02;328;151;177
062;001;001;052;03;323;126;197
062;001;098;001;01;336;166;170
062;001;098;001;02;336;166;170
062;001;098;001;03;330;169;161
062;001;098;002;01;147;84;63
062;001;098;003;01;253;142;111
062;001;098;004;01;195;107;88
062;001;098;005;01;439;217;222
062;001;098;005;02;432;240;192
062;001;098;006;01;360;180;180
062;001;098;006;02;355;201;154
062;001;098;007;01;364;192;172
062;001;098;008;01;372;194;178
062;001;098;009;01;240;118;122
062;001;098;010;01;200;107;93
062;001;098;011;01;340;197;143
062;001;098;012;01;271;145;126
062;001;098;013;01;222;100;122
062;001;098;014;01;417;227;190
062;001;098;015;01;176;89;87
062;001;098;016;01;442;291;151
062;001;098;017;01;71;40;31
062;001;098;018;01;304;172;132
062;001;098;018;02;304;154;150
062;001;098;018;03;299;163;136
062;001;098;019;01;248;123;125
062;001;098;019;02;248;117;131
062;001;098;020;01;232;107;125
062;001;098;020;02;228;111;117
062;001;098;021;01;178;88;90
062;001;098;022;01;442;238;204
062;001;098;023;01;175;91;84
062;001;098;024;01;264;134;130
062;001;098;024;02;256;139;117
062;001;098;025;01;168;82;86
062;001;098;026;01;118;66;52
062;001;098;027;01;194;101;93
062;001;098;028;01;395;218;177
062;001;098;029;01;393;234;159
062;001;098;030;01;416;205;211
062;001;098;030;02;413;203;210
062;001;098;031;01;152;86;66
062;001;098;032;01;64;35;29
062;001;098;033;01;103;47;56
062;001;098;034;01;127;70;57
062;001;098;035;01;66;46;20
062;001;098;036;01;82;51;31
062;004;001;001;01;444;221;223
062;004;001;001;02;440;214;226
062;004;001;001;03;440;216;224
062;004;001;001;04;440;203;237
062;004;001;001;05;440;207;233
062;004;001;001;06;440;237;203
062;004;001;002;01;400;231;169
062;004;001;002;02;400;189;211
062;004;001;002;03;400;197;203
062;004;001;002;04;400;204;196
062;004;001;002;05;400;222;178
062;004;001;003;01;446;211;235
062;004;001;003;02;440;229;211
062;004;001;003;03;440;271;169
062;004;001;003;04;440;228;212
062;004;001;004;01;448;240;208
062;004;001;004;02;448;243;205
062;004;001;004;03;448;246;202
062;004;001;004;04;448;250;198
062;004;001;004;05;443;253;190
062;004;001;005;01;392;221;171
062;004;001;005;02;392;245;147
062;004;001;005;03;392;220;172
062;004;001;005;04;392;223;169
062;004;001;005;05;392;212;180
062;004;001;005;06;386;238;148
062;004;001;005;07;384;224;160
062;004;001;006;01;401;221;180
062;004;001;007;01;280;147;133
062;004;001;007;02;278;155;123
062;004;001;008;01;349;189;160
062;004;001;008;02;344;187;157
062;004;001;008;03;344;184;160
062;004;001;009;01;387;180;207
062;004;001;009;02;384;183;201
062;004;001;009;03;384;216;168
062;004;001;010;01;304;174;130
062;004;001;010;02;304;164;140
062;004;001;011;01;315;190;125
062;004;001;012;01;437;212;225
062;004;001;012;02;432;226;206
062;004;001;012;03;432;202;230
062;004;001;012;04;432;216;216
062;004;001;013;01;402;236;166
062;004;001;014;01;385;233;152
062;004;001;015;01;344;167;177
062;004;001;015;02;339;175;164
062;004;001;015;03;336;176;160
062;004;001;015;04;336;187;149
062;004;001;016;01;198;122;76
062;004;001;017;01;277;154;123
062;004;001;018;01;240;143;97
062;004;001;018;02;236;143;93
062;004;001;019;01;333;187;146
062;005;098;001;01;255;140;115
062;005;098;002;01;361;180;181
062;005;098;002;02;360;189;171
062;005;098;003;01;212;103;109
062;005;098;004;01;449;233;216
062;005;098;005;01;69;37;32
062;005;098;006;01;333;168;165
062;005;098;007;01;400;226;174
062;005;098;007;02;400;209;191
062;005;098;007;03;392;224;168
062;005;098;008;01;311;171;140
062;005;098;009;01;232;143;89
062;005;098;009;02;229;139;90
062;005;098;010;01;228;138;90
062;005;098;011;01;173;90;83
062;005;098;012;01;144;82;62
062;005;098;013;01;143;82;61
062;005;098;014;01;207;120;87
062;005;098;015;01;156;94;62
062;005;098;016;01;315;174;141
062;005;098;017;01;203;113;90
062;005;098;018;01;280;137;143
062;005;098;018;02;280;156;124
062;005;098;019;01;252;124;128
062;005;098;020;01;173;90;83
062;005;098;021;01;142;85;57
062;005;098;022;01;146;101;45
062;005;098;026;01;190;136;54
062;005;098;027;01;164;99;65
062;005;098;028;01;60;42;18
062;006;098;001;01;346;174;172
062;006;098;002;01;282;134;148
062;006;098;003;01;174;94;80
062;006;098;004;01;379;198;181
062;006;098;004;02;376;204;172
062;006;098;004;03;376;172;204
062;006;098;004;04;376;187;189
062;006;098;004;05;376;209;167
062;006;098;004;06;376;184;192
062;006;098;006;01;210;113;97
062;006;098;007;01;232;115;117
062;006;098;007;02;229;128;101
062;006;098;008;01;421;223;198
062;006;098;009;01;303;141;162
062;006;098;010;01;96;48;48
062;006;098;011;01;312;166;146
062;006;098;011;02;311;162;149
062;006;098;012;01;360;213;147
062;006;098;012;02;360;192;168
062;006;098;013;01;392;192;200
062;006;098;013;02;385;207;178
062;006;098;014;01;117;69;48
062;006;098;015;01;112;55;57
062;006;098;016;01;289;125;164
062;006;098;017;01;332;170;162
062;006;098;017;02;328;158;170
062;006;098;019;01;139;72;67
062;006;098;020;01;41;22;19
062;007;098;001;01;152;91;61
062;007;098;002;01;352;202;150
062;007;098;002;02;350;200;150
062;007;098;003;01;326;174;152
062;007;098;004;01;211;118;93
062;007;098;005;01;389;192;197
062;007;098;006;01;247;134;113
062;007;098;007;01;208;120;88
062;007;098;008;01;107;58;49
062;007;098;009;01;143;84;59
062;007;098;010;01;45;20;25
062;007;098;011;01;135;73;62
062;007;098;012;01;248;140;108
062;007;098;012;02;240;137;103
062;007;098;013;01;248;113;135
062;007;098;013;02;245;133;112
062;007;098;014;01;357;185;172
062;007;098;014;02;352;183;169
062;007;098;016;01;250;129;121
062;007;098;016;02;248;130;118
062;007;098;017;01;359;171;188
062;007;098;018;01;210;110;100
062;007;098;019;01;291;160;131
062;007;098;020;01;148;80;68
062;007;098;021;01;305;164;141
062;008;098;001;01;221;112;109
062;008;098;002;01;238;127;111
062;008;098;003;01;340;188;152
062;008;098;004;01;132;80;52
062;008;098;005;01;403;216;187
062;008;098;006;01;147;77;70
062;008;098;007;01;156;81;75
062;008;098;008;01;354;173;181
062;008;098;008;02;352;184;168
062;008;098;009;01;233;120;113
062;008;098;011;01;306;145;161
062;008;098;011;02;304;160;144
062;008;098;012;01;256;131;125
062;008;098;013;01;128;72;56
062;008;098;014;01;246;134;112
062;008;098;015;01;256;121;135
062;008;098;015;02;248;127;121
062;008;098;016;01;246;126;120
062;008;098;017;01;390;204;186
062;008;098;018;01;403;215;188
062;008;098;018;02;400;193;207
062;008;098;018;03;400;206;194
062;008;098;019;01;97;56;41
062;008;098;020;01;240;119;121
062;008;098;020;02;232;125;107
062;008;098;021;01;450;219;231
062;008;098;022;01;372;198;174
062;008;098;023;01;352;187;165
062;008;098;023;02;344;182;162
062;008;098;024;01;211;109;102
062;008;098;025;01;233;119;114
062;008;098;026;01;152;68;84
062;008;098;027;01;392;208;184
062;008;098;027;02;392;187;205
062;008;098;027;03;386;206;180
062;008;098;027;04;384;203;181
062;008;098;028;01;448;238;210
062;008;098;028;02;448;268;180
062;008;098;028;03;446;222;224
062;008;098;028;04;440;241;199
062;008;098;028;05;440;222;218
062;008;098;028;06;440;265;175
062;008;098;028;07;440;226;214
062;008;098;032;01;236;134;102
062;008;098;034;01;80;43;37
062;008;098;035;01;235;113;122
062;008;098;036;01;167;94;73
062;009;098;001;01;196;103;93
062;009;098;002;01;200;106;94
062;009;098;003;01;365;183;182
062;009;098;003;02;360;166;194
062;009;098;003;03;360;193;167
062;009;098;003;04;360;182;178
062;009;098;004;01;156;105;51
062;009;098;005;01;248;127;121
062;009;098;005;02;248;135;113
062;009;098;006;01;337;169;168
062;009;098;007;01;245;126;119
062;009;098;008;01;137;72;65
062;009;098;009;01;326;194;132
062;009;098;009;02;320;177;143
062;009;098;010;01;418;216;202
062;009;098;011;01;408;233;175
062;009;098;011;02;408;203;205
062;009;098;011;03;400;246;154
062;009;098;012;01;221;126;95
062;009;098;013;01;312;158;154
062;009;098;014;01;233;129;104
062;009;098;015;01;317;169;148
062;009;098;016;01;303;168;135
062;009;098;017;01;319;149;170
062;009;098;018;01;441;204;237
062;009;098;019;01;129;69;60
063;003;001;001;01;312;154;158
063;003;001;001;02;304;160;144
063;003;001;001;03;304;180;124
063;003;001;002;01;400;216;184
063;003;001;002;02;394;212;182
063;003;001;002;03;392;205;187
063;003;001;002;04;392;220;172
063;003;001;003;01;408;197;211
063;003;001;003;02;404;226;178
063;003;001;003;03;400;194;206
063;003;001;004;01;448;235;213
063;003;001;004;02;441;246;195
063;003;001;005;01;100;56;44
063;003;001;006;01;63;34;29
063;003;001;007;01;280;152;128
063;003;001;008;01;272;150;122
063;003;001;008;02;269;163;106
063;003;001;009;01;125;72;53
063;003;001;010;01;320;161;159
063;003;001;010;02;320;177;143
063;003;001;010;03;316;179;137
063;003;001;011;01;256;143;113
063;003;001;011;02;255;160;95
063;003;001;012;01;70;35;35
063;003;001;013;01;188;95;93
063;003;001;014;01;173;99;74
063;003;001;015;01;297;175;122
063;003;001;016;01;390;197;193
063;003;001;017;01;120;78;42
063;003;001;018;01;126;66;60
063;003;001;019;01;183;93;90
063;003;001;020;01;180;105;75
063;003;001;021;01;440;260;180
063;003;001;022;01;194;110;84
063;003;001;023;01;334;174;160
063;003;001;023;02;328;184;144
063;003;001;023;03;328;167;161
063;003;001;024;01;171;80;91
063;003;001;026;01;349;193;156
063;003;001;026;02;344;199;145
063;003;001;027;01;155;80;75
063;003;001;028;01;290;147;143
063;003;001;029;01;90;51;39
063;003;001;030;01;360;188;172
063;003;001;030;02;360;184;176
063;003;001;030;03;360;181;179
063;003;001;030;04;353;181;172
063;003;001;031;01;405;234;171
063;003;001;033;01;249;151;98
063;003;001;034;01;127;70;57
063;003;001;037;01;115;67;48
063;003;001;038;01;88;40;48
063;003;001;039;01;172;107;65
063;003;001;040;01;257;143;114
063;003;001;041;01;134;74;60
063;003;098;001;01;298;149;149
063;003;098;002;01;247;141;106
063;003;098;003;01;273;126;147
063;003;098;003;02;272;150;122
063;003;098;004;01;316;153;163
063;003;098;004;02;312;171;141
063;003;098;005;01;141;90;51
063;003;098;006;01;78;41;37
063;003;098;007;01;114;61;53
063;003;098;008;01;201;104;97
063;003;098;009;01;318;174;144
063;003;098;010;01;120;74;46
063;003;098;011;01;441;279;162
063;003;098;012;01;224;125;99
063;003;098;013;01;208;132;76
063;003;098;014;01;307;206;101
063;003;098;016;01;124;66;58
063;003;098;017;01;195;116;79
063;003;098;019;01;116;62;54
063;005;098;001;01;400;216;184
063;005;098;001;02;400;203;197
063;005;098;001;03;396;198;198
063;005;098;002;01;336;170;166
063;005;098;002;02;330;169;161
063;005;098;003;01;283;144;139
063;005;098;004;01;222;143;79
063;005;098;005;01;442;218;224
063;005;098;006;01;227;114;113
063;005;098;007;01;135;72;63
063;005;098;008;01;127;61;66
063;005;098;010;01;124;68;56
063;005;098;011;01;368;217;151
063;005;098;012;01;200;120;80
063;005;098;013;01;76;48;28
063;005;098;014;01;339;194;145
063;005;098;015;01;251;163;88
063;005;098;016;01;168;92;76
063;005;098;017;01;131;78;53
063;005;098;018;01;72;46;26
063;005;098;020;01;155;101;54
063;005;098;021;01;117;85;32
063;005;098;022;01;192;112;80
063;005;098;024;01;291;170;121
063;005;098;024;02;288;176;112
063;006;098;001;01;337;183;154
063;006;098;002;01;107;62;45
063;006;098;003;01;288;152;136
063;006;098;003;02;285;150;135
063;006;098;004;01;228;122;106
063;006;098;005;01;185;88;97
063;006;098;006;01;336;171;165
063;006;098;007;01;130;67;63
063;006;098;008;01;221;134;87
063;006;098;009;01;245;140;105
063;006;098;010;01;162;88;74
063;006;098;011;01;210;127;83
063;006;098;012;01;117;63;54
063;006;098;013;01;392;192;200
063;006;098;013;02;392;213;179
063;006;098;013;03;390;194;196
063;006;098;014;01;104;50;54
063;006;098;015;01;206;109;97
063;006;098;017;01;293;166;127
063;006;098;018;01;197;110;87
063;006;098;019;01;384;204;180
063;006;098;019;02;384;210;174
063;006;098;019;03;382;230;152
063;006;098;020;01;335;173;162
063;006;098;020;02;328;179;149
063;006;098;021;01;378;208;170
063;006;098;022;01;119;74;45
063;006;098;023;01;370;203;167
063;006;098;024;01;157;91;66
063;006;098;025;01;244;115;129
063;006;098;026;01;193;100;93
063;006;098;027;01;144;82;62
063;006;098;028;01;400;199;201
063;006;098;028;02;397;194;203
063;006;098;028;03;392;211;181
063;006;098;028;04;392;212;180
063;006;098;029;01;446;215;231
063;006;098;029;02;440;211;229
063;006;098;030;01;244;135;109
063;006;098;030;02;240;133;107
063;006;098;031;01;112;65;47
063;006;098;032;01;241;153;88
063;006;098;033;01;130;69;61
063;006;098;035;01;99;61;38
063;007;098;001;01;79;40;39
063;007;098;002;01;88;41;47
063;007;098;003;01;276;146;130
063;007;098;004;01;296;150;146
063;007;098;005;01;307;168;139
063;007;098;006;01;288;155;133
063;007;098;006;02;281;156;125
063;007;098;007;01;434;271;163
063;007;098;008;01;344;211;133
063;007;098;008;02;343;208;135
063;007;098;008;03;336;209;127
063;007;098;009;01;112;68;44
063;007;098;010;01;438;245;193
063;007;098;011;01;101;57;44
063;007;098;012;01;317;174;143
063;007;098;012;02;312;187;125
063;007;098;013;01;248;164;84
063;007;098;014;01;231;125;106
063;007;098;014;02;224;132;92
063;007;098;015;01;214;137;77
063;007;098;016;01;423;209;214
063;007;098;017;01;56;41;15
063;007;098;018;01;158;80;78
063;007;098;019;01;60;42;18
063;007;098;020;01;106;60;46
064;001;001;001;01;432;220;212
064;001;001;001;02;428;256;172
064;001;001;001;03;424;249;175
064;001;001;002;01;432;237;195
064;001;001;002;02;432;226;206
064;001;001;002;03;432;234;198
064;001;001;002;04;425;246;179
064;001;001;003;01;328;157;171
064;001;001;003;02;328;181;147
064;001;001;003;03;324;165;159
064;001;001;004;01;387;191;196
064;001;001;004;02;384;201;183
064;001;001;004;03;384;181;203
064;001;001;004;04;384;213;171
064;001;001;005;01;178;82;96
064;001;001;006;01;368;185;183
064;001;001;006;02;368;159;209
064;001;001;006;03;368;189;179
064;001;001;006;04;368;174;194
064;001;001;006;05;365;204;161
064;001;001;007;01;432;221;211
064;001;001;007;02;432;236;196
064;001;001;007;03;427;222;205
064;001;001;007;04;424;232;192
064;001;001;007;05;424;241;183
064;001;001;007;06;424;230;194
064;001;001;007;07;424;245;179
064;001;001;008;01;411;213;198
064;001;001;008;02;408;229;179
064;001;001;008;03;408;229;179
064;001;001;009;01;448;242;206
064;001;001;009;02;447;214;233
064;001;001;009;03;440;213;227
064;001;001;009;04;440;211;229
064;001;001;009;05;440;237;203
064;001;001;010;01;424;233;191
064;001;001;010;02;424;238;186
064;001;001;010;03;418;222;196
064;001;001;011;01;416;192;224
064;001;001;011;02;416;203;213
064;001;001;011;03;411;204;207
064;001;001;012;01;400;203;197
064;001;001;012;02;397;211;186
064;001;001;012;03;392;193;199
064;001;001;013;01;337;178;159
064;001;001;013;02;336;188;148
064;001;001;014;01;439;239;200
064;001;001;015;01;446;246;200
064;001;001;016;01;328;170;158
064;001;001;016;02;322;173;149
064;001;001;016;03;320;180;140
064;001;001;017;01;344;170;174
064;001;001;017;02;336;190;146
064;001;001;018;01;304;167;137
064;001;001;018;02;296;157;139
064;001;001;019;01;411;220;191
064;001;001;019;02;408;225;183
064;001;001;020;01;293;143;150
064;001;001;020;02;288;165;123
064;001;001;021;01;368;189;179
064;001;001;021;02;363;199;164
064;001;001;021;03;360;206;154
064;001;001;022;01;313;178;135
064;001;001;023;01;169;84;85
064;001;001;024;01;192;103;89
064;001;001;025;01;62;42;20
064;001;001;026;01;99;61;38
064;001;098;001;01;203;117;86
064;001;098;002;01;168;95;73
064;001;098;003;01;300;172;128
064;001;098;003;02;296;155;141
064;001;098;004;01;188;91;97
064;001;098;005;01;245;151;94
064;001;098;005;02;240;133;107
064;001;098;006;01;344;191;153
064;001;098;006;02;343;196;147
064;001;098;007;01;304;164;140
064;001;098;008;01;295;166;129
064;001;098;009;01;390;215;175
064;001;098;010;01;185;92;93
064;001;098;011;01;264;157;107
064;001;098;012;01;374;197;177
064;001;098;013;01;281;146;135
064;001;098;014;01;139;68;71
064;001;098;015;01;344;178;166
064;001;098;016;01;305;168;137
064;001;098;017;01;272;156;116
064;001;098;018;01;252;134;118
064;001;098;018;02;248;137;111
064;001;098;019;01;432;248;184
064;001;098;020;01;244;129;115
064;001;098;021;01;336;170;166
064;001;098;021;02;333;180;153
064;001;098;021;03;328;174;154
064;001;098;022;01;386;205;181
064;001;098;023;01;280;162;118
064;001;098;023;02;276;156;120
064;001;098;024;01;328;157;171
064;001;098;024;02;324;169;155
064;001;098;024;03;320;167;153
064;001;098;025;01;111;62;49
064;001;098;026;01;214;113;101
064;001;098;027;01;192;100;92
064;001;098;028;01;161;90;71
064;001;098;029;01;167;98;69
064;001;098;030;01;296;157;139
064;001;098;031;01;309;164;145
064;001;098;031;02;304;179;125
064;001;098;032;01;323;154;169
064;001;098;032;02;320;179;141
064;001;098;032;03;320;164;156
064;001;098;033;01;349;198;151
064;001;098;034;01;226;140;86
064;001;098;035;01;236;122;114
064;001;098;038;01;264;148;116
064;001;098;038;02;256;149;107
064;001;098;040;01;172;100;72
064;001;098;042;01;167;112;55
064;002;001;001;01;344;171;173
064;002;001;001;02;344;179;165
064;002;001;001;03;344;172;172
064;002;001;001;04;340;171;169
064;002;001;002;01;448;229;219
064;002;001;002;02;444;236;208
064;002;001;002;03;440;225;215
064;002;001;003;01;95;55;40
064;002;001;004;01;336;179;157
064;002;001;004;02;329;156;173
064;002;001;005;01;291;154;137
064;002;001;006;01;383;193;190
064;002;001;006;02;376;192;184
064;002;001;007;01;307;162;145
064;002;001;008;01;221;125;96
064;002;001;009;01;304;162;142
064;002;001;009;02;304;163;141
064;002;001;009;03;303;162;141
064;002;001;010;01;151;87;64
064;003;098;001;01;319;172;147
064;003;098;001;02;312;186;126
064;003;098;002;01;68;34;34
064;003;098;003;01;285;159;126
064;003;098;003;02;280;175;105
064;003;098;004;01;240;143;97
064;003;098;004;02;234;141;93
064;003;098;005;01;236;148;88
064;003;098;006;01;214;120;94
064;003;098;007;01;136;88;48
064;003;098;008;01;215;131;84
064;003;098;009;01;68;38;30
064;003;098;010;01;402;224;178
064;003;098;011;01;218;116;102
064;003;098;012;01;363;222;141
064;003;098;012;02;360;210;150
064;003;098;013;01;255;162;93
064;003;098;013;02;248;155;93
064;003;098;014;01;356;182;174
064;003;098;015;01;337;161;176
064;003;098;016;01;311;197;114
064;003;098;017;01;235;151;84
064;003;098;018;01;444;247;197
064;003;098;019;01;434;222;212
064;003;098;020;01;181;94;87
064;003;098;021;01;398;221;177
064;003;098;021;02;392;193;199
064;003;098;021;03;392;222;170
064;003;098;022;01;182;111;71
064;003;098;023;01;277;159;118
064;003;098;024;01;353;170;183
064;003;098;025;01;240;125;115
064;003;098;025;02;237;117;120
064;003;098;026;01;227;115;112
064;003;098;026;02;224;114;110
064;003;098;027;01;287;134;153
064;003;098;028;01;319;177;142
064;003;098;029;01;424;207;217
064;003;098;029;02;419;248;171
064;003;098;029;03;416;231;185
064;003;098;030;01;88;55;33
064;003;098;031;01;83;53;30
064;003;098;032;01;121;77;44
064;003;098;033;01;106;66;40
064;003;098;034;01;88;57;31
064;004;098;001;01;339;198;141
064;004;098;003;01;361;185;176
064;004;098;004;01;380;194;186
064;004;098;004;02;376;222;154
064;004;098;005;01;368;159;209
064;004;098;005;02;366;174;192
064;004;098;006;01;185;96;89
064;004;098;007;01;446;248;198
064;004;098;008;01;420;228;192
064;004;098;009;01;212;113;99
064;005;098;001;01;304;158;146
064;005;098;002;01;216;121;95
064;005;098;003;01;366;184;182
064;005;098;004;01;296;160;136
064;005;098;004;02;292;147;145
064;005;098;005;01;384;194;190
064;005;098;005;02;383;205;178
064;005;098;006;01;352;192;160
064;005;098;006;02;345;194;151
064;005;098;007;01;245;132;113
064;005;098;007;02;240;135;105
064;005;098;008;01;138;73;65
064;005;098;009;01;77;42;35
064;005;098;010;01;201;108;93
064;005;098;011;01;179;97;82
064;005;098;012;01;65;40;25
064;006;098;001;01;317;163;154
064;006;098;001;02;312;185;127
064;006;098;002;01;330;179;151
064;006;098;003;01;303;162;141
064;006;098;003;02;296;159;137
064;006;098;004;01;256;144;112
064;006;098;004;02;255;158;97
064;006;098;005;01;349;173;176
064;006;098;005;02;344;187;157
064;006;098;006;01;264;129;135
064;006;098;006;02;261;146;115
064;006;098;007;01;384;206;178
064;006;098;007;02;384;204;180
064;006;098;008;01;345;185;160
064;006;098;009;01;115;62;53
064;006;098;010;01;262;143;119
064;006;098;011;01;235;134;101
064;006;098;012;01;427;222;205
064;006;098;012;02;424;236;188
064;006;098;013;01;119;72;47
064;006;098;015;01;130;79;51
064;006;098;016;01;197;131;66
064;006;098;017;01;71;44;27
065;002;001;001;01;376;196;180
065;002;001;001;02;375;191;184
065;002;001;001;03;368;173;195
065;002;001;001;04;368;189;179
065;002;001;001;05;368;201;167
065;002;001;002;01;440;210;230
065;002;001;002;02;440;217;223
065;002;001;002;03;435;213;222
065;002;001;002;04;432;213;219
065;002;001;003;01;416;241;175
065;002;001;003;02;415;239;176
065;002;001;003;03;408;230;178
065;002;001;004;01;344;204;140
065;002;001;004;02;340;172;168
065;002;001;004;03;336;175;161
065;002;001;005;01;368;192;176
065;002;001;005;02;368;187;181
065;002;001;005;03;365;191;174
065;002;001;005;04;360;206;154
065;002;001;006;01;424;211;213
065;002;001;006;02;424;223;201
065;002;001;006;03;424;226;198
065;002;001;006;04;421;194;227
065;002;001;006;05;416;241;175
065;002;001;006;06;416;214;202
065;002;001;006;07;416;227;189
065;002;001;006;08;416;232;184
065;002;001;007;01;412;195;217
065;002;001;007;02;408;197;211
065;002;001;007;03;408;192;216
065;002;001;007;04;408;196;212
065;002;001;008;01;448;261;187
065;002;001;008;02;448;232;216
065;002;001;008;03;448;211;237
065;002;001;008;04;448;223;225
065;002;001;008;05;448;218;230
065;002;001;008;06;448;240;208
065;002;001;008;07;448;245;203
065;002;001;008;08;443;225;218
065;002;001;009;01;416;197;219
065;002;001;009;02;416;208;208
065;002;001;009;03;413;209;204
065;002;001;009;04;408;193;215
065;002;001;009;05;408;208;200
065;002;001;009;06;408;215;193
065;002;001;010;01;448;226;222
065;002;001;010;02;441;210;231
065;002;001;010;03;440;189;251
065;002;001;010;04;440;218;222
065;002;001;011;01;432;215;217
065;002;001;011;02;432;234;198
065;002;001;011;03;432;198;234
065;002;001;011;04;427;216;211
065;002;001;011;05;424;203;221
065;002;001;011;06;424;220;204
065;002;001;012;01;384;180;204
065;002;001;012;02;384;197;187
065;002;001;012;03;384;187;197
065;002;001;012;04;377;179;198
065;002;001;013;01;445;235;210
065;002;001;013;02;440;215;225
065;002;001;013;03;440;231;209
065;002;001;013;04;440;243;197
065;002;001;014;01;440;222;218
065;002;001;014;02;440;227;213
065;002;001;014;03;440;185;255
065;002;001;014;04;440;221;219
065;002;001;014;05;438;236;202
065;002;001;014;06;432;256;176
065;002;001;014;07;432;234;198
065;002;001;015;01;376;216;160
065;002;001;015;02;376;203;173
065;002;001;015;03;372;186;186
065;002;001;015;04;368;185;183
065;002;001;015;05;368;220;148
065;002;001;016;01;384;230;154
065;002;001;016;02;381;210;171
065;002;001;016;03;376;210;166
065;002;001;016;04;376;229;147
065;002;001;017;01;367;244;123
065;002;001;017;02;360;206;154
065;002;001;017;03;360;215;145
065;002;001;018;01;394;220;174
065;002;001;018;02;392;237;155
065;002;001;019;01;242;163;79
065;002;001;020;01;170;101;69
065;002;001;021;01;411;225;186
065;002;001;022;01;445;240;205
065;002;001;022;02;440;236;204
065;002;001;022;03;440;260;180
065;002;001;023;01;416;171;245
065;002;001;023;02;410;189;221
065;002;001;023;03;408;179;229
065;002;001;023;04;408;177;231
065;002;001;023;05;408;193;215
065;002;001;023;06;408;217;191
065;002;001;023;07;408;195;213
065;002;001;024;01;376;187;189
065;002;001;024;02;373;190;183
065;002;001;024;03;368;172;196
065;002;001;024;04;368;200;168
065;002;001;025;01;249;120;129
065;002;001;025;02;248;141;107
065;002;001;026;01;308;165;143
065;002;001;027;01;121;63;58
065;002;001;028;01;244;128;116
065;002;001;029;01;140;81;59
065;002;001;030;01;302;149;153
065;002;001;030;02;296;149;147
065;002;001;031;01;270;150;120
065;002;001;032;01;363;167;196
065;002;001;032;02;360;187;173
065;002;001;033;01;135;66;69
065;002;098;001;01;272;153;119
065;002;098;002;01;390;217;173
065;002;098;003;01;185;110;75
065;002;098;004;01;260;126;134
065;002;098;005;01;66;39;27
065;002;098;006;01;85;49;36
065;002;098;007;01;183;105;78
065;002;098;008;01;173;104;69
065;002;098;009;01;240;130;110
065;002;098;009;02;237;133;104
065;002;098;010;01;333;186;147
065;002;098;010;02;328;173;155
065;002;098;010;03;328;176;152
065;002;098;011;01;360;189;171
065;002;098;011;02;360;215;145
065;002;098;012;01;385;186;199
065;002;098;013;01;164;90;74
065;002;098;014;01;435;227;208
065;002;098;015;01;213;131;82
065;002;098;016;01;129;66;63
065;002;098;017;01;216;119;97
065;002;098;018;01;385;229;156
065;002;098;019;01;334;190;144
065;002;098;020;01;368;202;166
065;002;098;020;02;360;220;140
065;002;098;020;03;360;194;166
065;002;098;020;04;360;205;155
065;002;098;021;01;151;85;66
065;002;098;022;01;312;176;136
065;002;098;022;02;305;178;127
065;002;098;023;01;332;184;148
065;002;098;024;01;313;174;139
065;002;098;025;01;145;89;56
065;002;098;026;01;330;182;148
065;002;098;027;01;425;236;189
065;002;098;028;01;266;137;129
065;002;098;029;01;193;97;96
065;002;098;030;01;184;96;88
065;002;098;031;01;198;105;93
065;002;098;032;01;182;97;85
065;002;098;033;01;165;98;67
065;002;098;034;01;360;221;139
065;002;098;035;01;103;64;39
065;002;098;036;01;112;64;48
065;002;098;037;01;167;86;81
065;002;098;038;01;160;92;68
065;002;098;039;01;176;89;87
065;002;098;040;01;202;105;97
065;002;098;041;01;96;59;37
065;002;098;042;01;121;70;51
065;002;098;043;01;147;70;77
065;002;098;044;01;358;199;159
065;002;098;045;01;403;223;180
065;002;098;046;01;408;236;172
065;002;098;046;02;403;224;179
065;002;098;047;01;378;264;114
065;002;098;048;01;331;177;154
065;002;098;049;01;203;113;90
065;002;098;050;01;261;130;131
065;002;098;050;02;256;131;125
065;002;098;051;01;142;82;60
065;002;098;052;01;111;58;53
065;002;098;053;01;110;57;53
065;002;098;054;01;105;73;32
065;002;098;058;01;228;136;92
065;003;098;001;01;125;66;59
065;003;098;002;01;131;82;49
065;003;098;003;01;244;140;104
065;003;098;005;01;161;95;66
065;003;098;006;01;302;142;160
065;003;098;007;01;127;62;65
065;003;098;008;01;163;88;75
065;003;098;009;01;125;66;59
065;003;098;010;01;336;178;158
065;003;098;010;02;332;190;142
065;003;098;011;01;368;210;158
065;003;098;011;02;365;194;171
065;003;098;011;03;360;218;142
065;003;098;012;01;308;194;114
065;003;098;013;01;297;165;132
065;003;098;013;02;296;159;137
065;003;098;014;01;158;89;69
065;003;098;015;01;129;80;49
065;004;098;001;01;440;199;241
065;004;098;001;02;433;201;232
065;004;098;001;03;432;234;198
065;004;098;002;01;392;151;241
065;004;098;002;02;386;173;213
065;004;098;002;03;384;209;175
065;004;098;003;01;396;193;203
065;004;098;003;02;392;190;202
065;004;098;004;01;328;169;159
065;004;098;004;02;321;189;132
065;004;098;004;03;320;169;151
065;004;098;005;01;416;196;220
065;004;098;005;02;408;206;202
065;004;098;006;01;373;176;197
065;004;098;007;01;297;158;139
065;004;098;008;01;352;172;180
065;004;098;008;02;352;183;169
065;004;098;009;01;236;106;130
065;004;098;009;02;232;121;111
065;004;098;010;01;181;117;64
065;004;098;011;01;112;61;51
065;005;098;001;01;424;197;227
065;005;098;002;01;401;202;199
065;005;098;003;01;256;115;141
065;005;098;003;02;253;139;114
065;005;098;004;01;312;159;153
065;005;098;004;02;311;164;147
065;005;098;005;01;344;195;149
065;005;098;005;02;339;160;179
065;005;098;006;01;317;178;139
065;005;098;007;01;88;53;35
065;005;098;008;01;149;108;41
065;005;098;009;01;101;63;38
065;005;098;010;01;57;40;17
065;007;098;001;01;376;177;199
065;007;098;001;02;376;146;230
065;007;098;001;03;376;183;193
065;007;098;001;04;373;185;188
065;007;098;002;01;375;191;184
065;007;098;003;01;328;186;142
065;007;098;003;02;324;192;132
065;007;098;004;01;376;192;184
065;007;098;004;02;373;195;178
065;007;098;004;03;368;220;148
065;007;098;005;01;389;173;216
065;007;098;005;02;384;203;181
065;007;098;006;01;104;64;40
065;007;098;007;01;81;58;23
065;007;098;008;01;115;78;37
065;007;098;010;01;75;49;26
066;001;001;001;01;448;227;221
066;001;001;001;02;443;233;210
066;001;001;001;03;440;236;204
066;001;001;001;04;440;248;192
066;001;001;001;05;440;234;206
066;001;001;002;01;445;197;248
066;001;001;002;02;440;195;245
066;001;001;002;03;440;209;231
066;001;001;003;01;312;154;158
066;001;001;003;02;305;137;168
066;001;001;003;03;304;147;157
066;001;001;004;01;448;232;216
066;001;001;004;02;448;212;236
066;001;001;004;03;448;216;232
066;001;001;004;04;448;205;243
066;001;001;004;05;443;201;242
066;001;001;004;06;440;226;214
066;001;001;004;07;440;228;212
066;001;001;004;08;440;198;242
066;001;001;006;01;432;217;215
066;001;001;006;02;425;206;219
066;001;001;006;03;424;195;229
066;001;001;006;04;424;208;216
066;001;001;006;05;424;207;217
066;001;001;006;06;424;203;221
066;001;001;006;07;424;222;202
066;001;001;006;08;424;246;178
066;001;001;007;01;299;168;131
066;001;001;008;01;392;186;206
066;001;001;008;02;392;197;195
066;001;001;008;03;387;170;217
066;001;001;008;04;384;207;177
066;001;001;009;01;432;221;211
066;001;001;009;02;432;199;233
066;001;001;009;03;432;194;238
066;001;001;009;04;432;202;230
066;001;001;009;05;432;201;231
066;001;001;009;06;432;199;233
066;001;001;009;07;430;248;182
066;001;001;010;01;219;105;114
066;001;001;011;01;416;227;189
066;001;001;011;02;416;206;210
066;001;001;011;03;416;209;207
066;001;001;011;04;414;196;218
066;001;001;011;05;408;208;200
066;001;001;011;06;408;214;194
066;001;001;012;01;408;214;194
066;001;001;012;02;408;213;195
066;001;001;012;03;408;187;221
066;001;001;012;04;406;190;216
066;001;001;012;05;400;170;230
066;001;001;012;06;400;194;206
066;001;001;012;07;400;215;185
066;001;001;013;01;416;214;202
066;001;001;013;02;415;241;174
066;001;001;013;03;408;226;182
066;001;001;013;04;408;219;189
066;001;001;013;05;408;205;203
066;001;001;013;06;408;229;179
066;001;001;013;07;408;217;191
066;001;001;013;08;408;210;198
066;001;001;014;01;368;199;169
066;001;001;014;02;366;193;173
066;001;001;014;03;360;188;172
066;001;001;015;01;168;97;71
066;001;001;016;01;384;174;210
066;001;001;016;02;384;166;218
066;001;001;016;03;384;184;200
066;001;001;017;01;344;175;169
066;001;001;017;02;337;185;152
066;001;001;018;01;289;144;145
066;001;001;018;02;288;159;129
066;001;001;019;01;272;141;131
066;001;001;019;02;265;141;124
066;001;001;020;01;291;149;142
066;001;001;021;01;289;156;133
066;001;001;021;02;288;156;132
066;001;001;022;01;171;90;81
066;001;001;023;01;204;97;107
066;001;001;024;01;145;78;67
066;001;001;025;01;399;205;194
066;001;001;026;01;194;113;81
066;001;001;027;01;208;116;92
066;001;001;028;01;408;212;196
066;001;001;028;02;408;218;190
066;001;001;028;03;401;219;182
066;001;001;028;04;400;216;184
066;001;001;029;01;400;212;188
066;001;001;029;02;400;178;222
066;001;001;029;03;397;200;197
066;001;001;030;01;369;193;176
066;001;001;031;01;40;25;15
066;001;098;001;01;118;73;45
066;001;098;002;01;185;95;90
066;001;098;003;01;371;200;171
066;001;098;004;01;332;169;163
066;001;098;005;01;291;144;147
066;001;098;006;01;388;180;208
066;001;098;006;02;384;177;207
066;001;098;006;03;384;182;202
066;001;098;006;04;384;188;196
066;001;098;007;01;235;113;122
066;001;098;007;02;232;103;129
066;001;098;008;01;352;189;163
066;001;098;008;02;351;202;149
066;001;098;009;01;68;41;27
066;001;098;010;01;141;70;71
066;001;098;011;01;407;196;211
066;001;098;012;01;239;115;124
066;001;098;013;01;252;129;123
066;001;098;014;01;303;144;159
066;001;098;015;01;312;157;155
066;001;098;015;02;308;143;165
066;001;098;016;01;249;124;125
066;001;098;016;02;248;137;111
066;001;098;017;01;302;141;161
066;001;098;018;01;250;120;130
066;001;098;019;01;171;90;81
066;001;098;020;01;218;121;97
066;001;098;021;01;179;86;93
066;001;098;022;01;281;125;156
066;001;098;023;01;236;131;105
066;001;098;024;01;121;70;51
066;002;098;001;01;248;130;118
066;002;098;001;02;242;134;108
066;002;098;002;01;376;205;171
066;002;098;003;01;352;191;161
066;002;098;004;01;330;166;164
066;002;098;005;01;423;228;195
066;002;098;006;01;272;144;128
066;002;098;006;02;271;147;124
066;002;098;007;01;330;167;163
066;002;098;008;01;264;139;125
066;002;098;008;02;258;136;122
066;002;098;009;01;131;66;65
066;002;098;010;01;369;184;185
066;002;098;011;01;209;112;97
066;002;098;012;01;413;211;202
066;002;098;013;01;163;82;81
066;002;098;014;01;386;185;201
066;002;098;015;01;192;94;98
066;002;098;016;01;376;194;182
066;002;098;016;02;376;186;190
066;002;098;016;03;374;196;178
066;002;098;016;04;368;218;150
066;002;098;017;01;237;127;110
066;002;098;018;01;48;33;15
066;002;098;019;01;70;42;28
066;003;098;001;01;424;223;201
066;003;098;001;02;424;215;209
066;003;098;001;03;418;192;226
066;003;098;001;04;416;230;186
066;003;098;001;05;416;197;219
066;003;098;001;06;416;238;178
066;003;098;001;07;416;218;198
066;003;098;003;01;441;223;218
066;003;098;003;02;440;209;231
066;003;098;004;01;280;134;146
066;003;098;004;02;273;136;137
066;003;098;005;01;311;162;149
066;003;098;005;02;304;160;144
066;003;098;005;03;304;154;150
066;003;098;006;01;283;154;129
066;003;098;007;01;324;181;143
066;003;098;008;01;148;79;69
066;003;098;009;01;118;61;57
066;003;098;010;01;163;83;80
066;003;098;011;01;158;101;57
066;003;098;012;01;312;165;147
066;003;098;012;02;307;154;153
066;003;098;013;01;309;163;146
066;003;098;014;01;89;53;36
066;003;098;015;01;46;26;20
066;003;098;016;01;96;49;47
066;003;098;017;01;200;94;106
066;003;098;018;01;134;72;62
066;003;098;019;01;218;130;88
066;003;098;020;01;351;184;167
066;003;098;021;01;94;55;39
066;003;098;022;01;109;60;49
066;003;098;023;01;218;119;99
066;003;098;024;01;149;75;74
066;003;098;025;01;195;107;88
066;003;098;026;01;172;82;90
066;003;098;027;01;96;51;45
066;003;098;028;01;128;76;52
066;003;098;029;01;154;81;73
066;003;098;030;01;278;133;145
066;003;098;031;01;121;67;54
066;003;098;032;01;128;59;69
066;003;098;033;01;87;43;44
066;003;098;034;01;98;48;50
066;003;098;035;01;74;43;31
066;003;098;036;01;169;95;74
066;003;098;037;01;117;63;54
066;003;098;038;01;368;208;160
066;003;098;038;02;362;180;182
066;003;098;038;03;360;176;184
066;003;098;038;04;360;201;159
066;003;098;038;05;360;195;165
066;003;098;039;01;296;177;119
066;003;098;040;01;248;124;124
066;003;098;041;01;74;49;25
066;003;098;042;01;111;65;46
066;003;098;043;01;275;164;111
066;004;098;001;01;352;182;170
066;004;098;001;02;346;184;162
066;004;098;002;01;411;197;214
066;004;098;003;01;170;82;88
066;004;098;004;01;266;138;128
066;004;098;005;01;196;95;101
066;004;098;006;01;155;75;80
066;004;098;007;01;176;91;85
066;004;098;008;01;153;83;70
066;004;098;009;01;106;62;44
066;004;098;010;01;111;62;49
066;004;098;011;01;303;149;154
066;004;098;012;01;349;178;171
066;004;098;013;01;245;122;123
066;004;098;014;01;409;202;207
066;004;098;015;01;276;137;139
066;004;098;016;01;134;77;57
066;004;098;017;01;198;111;87
066;004;098;018;01;43;18;25
066;004;098;019;01;231;119;112
066;004;098;020;01;304;133;171
066;004;098;020;02;297;168;129
066;004;098;021;01;191;93;98
066;004;098;022;01;72;38;34
067;002;001;001;01;440;241;199
067;002;001;001;02;440;226;214
067;002;001;001;03;440;239;201
067;002;001;001;04;440;228;212
067;002;001;001;05;432;213;219
067;002;001;001;06;432;242;190
067;002;001;001;07;432;223;209
067;002;001;001;08;432;219;213
067;002;001;002;01;400;237;163
067;002;001;002;02;395;200;195
067;002;001;002;03;392;224;168
067;002;001;003;01;399;180;219
067;002;001;003;02;392;203;189
067;002;001;003;03;392;196;196
067;002;001;003;04;392;195;197
067;002;001;003;05;392;194;198
067;002;001;004;01;448;222;226
067;002;001;004;02;448;206;242
067;002;001;004;03;440;239;201
067;002;001;005;01;432;245;187
067;002;001;005;02;432;212;220
067;002;001;005;03;432;228;204
067;002;001;005;04;430;235;195
067;002;001;006;01;344;170;174
067;002;001;006;02;341;172;169
067;002;001;006;03;336;182;154
067;002;001;006;04;336;172;164
067;002;001;007;01;441;245;196
067;002;001;007;02;440;230;210
067;002;001;008;01;424;223;201
067;002;001;008;02;424;217;207
067;002;001;008;03;417;219;198
067;002;001;008;04;416;221;195
067;002;001;009;01;279;151;128
067;002;001;010;01;367;193;174
067;002;001;011;01;397;209;188
067;002;001;012;01;232;125;107
067;002;001;012;02;228;122;106
067;002;001;013;01;364;209;155
067;002;001;014;01;434;190;244
067;002;001;014;02;432;190;242
067;002;001;015;01;378;175;203
067;002;001;016;01;203;103;100
067;002;001;017;01;347;184;163
067;002;001;018;01;171;84;87
067;002;001;019;01;422;228;194
067;002;001;020;01;294;163;131
067;002;001;021;01;369;206;163
067;002;098;001;01;172;79;93
067;002;098;002;01;252;142;110
067;002;098;003;01;173;93;80
067;002;098;004;01;225;118;107
067;002;098;005;01;319;178;141
067;002;098;006;01;320;158;162
067;002;098;006;02;320;170;150
067;002;098;006;03;320;138;182
067;002;098;007;01;330;166;164
067;002;098;008;01;440;214;226
067;002;098;008;02;437;197;240
067;002;098;009;01;263;138;125
067;002;098;010;01;242;124;118
067;002;098;011;01;274;135;139
067;002;098;011;02;272;138;134
067;002;098;012;01;211;95;116
067;002;098;013;01;206;113;93
067;002;098;014;01;207;96;111
067;002;098;015;01;407;199;208
067;002;098;016;01;140;89;51
067;002;098;017;01;237;126;111
067;002;098;018;01;266;140;126
067;002;098;019;01;123;62;61
067;002;098;020;01;63;44;19
067;004;098;001;01;297;176;121
067;004;098;002;01;212;117;95
067;004;098;003;01;344;198;146
067;004;098;003;02;344;196;148
067;004;098;003;03;338;198;140
067;004;098;004;01;316;163;153
067;004;098;005;01;337;187;150
067;004;098;006;01;336;192;144
067;004;098;006;02;328;180;148
067;004;098;007;01;256;143;113
067;004;098;007;02;251;133;118
067;004;098;008;01;324;186;138
067;004;098;009;01;246;134;112
067;004;098;010;01;134;77;57
067;004;098;011;01;107;64;43
067;004;098;012;01;189;101;88
067;004;098;013;01;138;69;69
067;004;098;014;01;154;84;70
067;004;098;015;01;214;115;99
067;004;098;016;01;182;102;80
067;006;098;001;01;410;226;184
067;006;098;001;02;408;242;166
067;006;098;002;01;345;161;184
067;006;098;003;01;296;148;148
067;006;098;003;02;295;160;135
067;006;098;004;01;307;157;150
067;006;098;005;01;272;148;124
067;006;098;005;02;271;141;130
067;006;098;006;01;340;163;177
067;006;098;006;02;336;169;167
067;006;098;007;01;415;213;202
067;006;098;008;01;281;150;131
067;006;098;009;01;110;51;59
067;006;098;010;01;243;145;98
067;006;098;011;01;345;157;188
067;006;098;012;01;162;86;76
067;006;098;013;01;213;131;82
067;006;098;014;01;61;34;27
067;006;098;015;01;37;20;17
067;006;098;016;01;45;20;25
067;007;098;001;01;321;182;139
067;007;098;002;01;245;150;95
067;007;098;003;01;409;227;182
067;007;098;004;01;420;215;205
067;007;098;005;01;218;113;105
067;007;098;006;01;205;123;82
067;007;098;007;01;327;173;154
067;007;098;007;02;320;182;138
067;007;098;008;01;168;90;78
067;007;098;009;01;280;170;110
067;007;098;009;02;274;177;97
067;007;098;010;01;384;242;142
067;007;098;010;02;384;248;136
067;007;098;010;03;377;234;143
067;007;098;010;04;376;220;156
067;007;098;010;05;376;224;152
067;007;098;010;06;376;214;162
067;007;098;011;01;347;188;159
067;007;098;012;01;200;105;95
067;007;098;013;01;78;47;31
067;007;098;014;01;147;84;63
067;007;098;015;01;189;108;81
067;007;098;016;01;94;50;44
067;007;098;017;01;141;80;61
068;001;001;001;01;399;193;206
068;001;001;001;02;392;186;206
068;001;001;001;03;392;201;191
068;001;001;001;04;392;199;193
068;001;001;002;01;384;185;199
068;001;001;002;02;377;190;187
068;001;001;002;03;376;204;172
068;001;001;002;04;376;181;195
068;001;001;002;05;376;179;197
068;001;001;003;01;416;194;222
068;001;001;003;02;416;215;201
068;001;001;003;03;416;220;196
068;001;001;003;04;409;227;182
068;001;001;004;01;432;198;234
068;001;001;004;02;432;220;212
068;001;001;004;03;432;239;193
068;001;001;004;04;429;243;186
068;001;001;004;05;424;235;189
068;001;001;004;06;424;231;193
068;001;001;004;07;424;223;201
068;001;001;004;08;424;217;207
068;001;001;004;09;424;235;189
068;001;001;004;10;424;242;182
068;001;001;005;01;384;192;192
068;001;001;005;02;380;202;178
068;001;001;005;03;376;215;161
068;001;001;006;01;416;217;199
068;001;001;006;02;416;233;183
068;001;001;006;03;416;220;196
068;001;001;006;04;414;213;201
068;001;001;006;05;408;223;185
068;001;001;007;01;404;181;223
068;001;001;007;02;400;158;242
068;001;001;007;03;400;146;254
068;001;001;007;04;400;148;252
068;001;001;007;05;400;162;238
068;001;001;007;06;400;167;233
068;001;001;008;01;408;189;219
068;001;001;008;02;402;208;194
068;001;001;008;03;400;189;211
068;001;001;008;04;400;201;199
068;001;001;009;01;414;226;188
068;001;001;009;02;408;202;206
068;001;001;009;03;408;214;194
068;001;001;009;04;408;194;214
068;001;001;010;01;400;205;195
068;001;001;010;02;400;221;179
068;001;001;010;03;392;197;195
068;001;001;010;04;392;198;194
068;001;001;010;05;392;198;194
068;001;001;010;06;392;210;182
068;001;001;011;01;400;206;194
068;001;001;011;02;400;193;207
068;001;001;011;03;400;204;196
068;001;001;011;04;400;197;203
068;001;001;011;05;400;206;194
068;001;001;011;06;395;218;177
068;001;001;011;07;392;197;195
068;001;001;012;01;447;224;223
068;001;001;012;02;440;221;219
068;001;001;012;03;440;212;228
068;001;001;012;04;440;228;212
068;001;001;012;05;440;227;213
068;001;001;012;06;440;257;183
068;001;001;013;01;400;224;176
068;001;001;013;02;400;212;188
068;001;001;013;03;398;210;188
068;001;001;013;04;392;213;179
068;001;001;013;05;392;195;197
068;001;001;013;06;392;234;158
068;001;001;013;07;392;238;154
068;001;001;014;01;408;200;208
068;001;001;014;02;408;216;192
068;001;001;014;03;408;199;209
068;001;001;014;04;402;209;193
068;001;001;014;05;400;208;192
068;001;001;015;01;448;232;216
068;001;001;015;02;448;240;208
068;001;001;015;03;448;235;213
068;001;001;015;04;445;245;200
068;001;001;016;01;352;194;158
068;001;001;016;02;352;200;152
068;001;001;016;03;348;176;172
068;001;001;016;04;344;175;169
068;001;001;017;01;207;123;84
068;001;001;018;01;186;102;84
068;001;001;019;01;190;98;92
068;001;001;020;01;173;85;88
068;001;098;001;01;232;120;112
068;001;098;001;02;229;137;92
068;001;098;002;01;240;126;114
068;001;098;002;02;234;129;105
068;001;098;003;01;440;210;230
068;001;098;003;02;440;212;228
068;001;098;003;03;432;206;226
068;001;098;003;04;432;205;227
068;001;098;004;01;448;233;215
068;001;098;004;02;448;202;246
068;001;098;004;03;442;181;261
068;001;098;005;01;376;183;193
068;001;098;005;02;376;189;187
068;001;098;005;03;376;198;178
068;001;098;005;04;369;173;196
068;001;098;005;05;368;163;205
068;001;098;006;01;416;193;223
068;001;098;006;02;416;158;258
068;001;098;006;03;410;188;222
068;001;098;006;04;408;180;228
068;001;098;006;05;408;182;226
068;001;098;006;06;408;185;223
068;001;098;007;01;384;173;211
068;001;098;007;02;383;193;190
068;001;098;007;03;376;182;194
068;001;098;007;04;376;194;182
068;001;098;007;05;376;180;196
068;001;098;008;01;368;173;195
068;001;098;008;02;368;158;210
068;001;098;008;03;368;174;194
068;001;098;008;04;368;163;205
068;001;098;008;05;362;184;178
068;001;098;009;01;149;113;36
068;001;098;010;01;174;102;72
068;001;098;011;01;301;181;120
068;001;098;012;01;440;221;219
068;001;098;012;02;440;216;224
068;001;098;012;03;440;224;216
068;001;098;012;04;440;207;233
068;001;098;012;05;434;218;216
068;001;098;013;01;450;230;220
068;001;098;013;02;448;218;230
068;001;098;013;03;448;204;244
068;001;098;014;01;248;129;119
068;001;098;014;02;244;133;111
068;001;098;015;01;304;161;143
068;001;098;016;01;408;210;198
068;001;098;016;02;408;218;190
068;001;098;016;03;402;208;194
068;001;098;016;04;400;186;214
068;001;098;017;01;424;222;202
068;001;098;017;02;423;181;242
068;001;098;017;03;416;196;220
068;001;098;017;04;416;188;228
068;001;098;018;01;66;25;41
068;003;001;001;01;400;189;211
068;003;001;001;02;400;190;210
068;003;001;001;03;400;195;205
068;003;001;001;04;400;190;210
068;003;001;001;05;400;187;213
068;003;001;001;06;399;195;204
068;003;001;001;07;392;206;186
068;003;001;002;01;352;175;177
068;003;001;002;02;347;182;165
068;003;001;003;01;450;221;229
068;003;001;003;02;450;200;250
068;003;001;003;03;449;215;234
068;003;001;004;01;285;130;155
068;003;001;004;02;280;137;143
068;003;001;005;01;367;167;200
068;003;001;005;02;360;181;179
068;003;001;005;03;360;169;191
068;003;001;006;01;440;211;229
068;003;001;006;02;440;202;238
068;003;001;006;03;440;181;259
068;003;001;006;04;434;192;242
068;003;001;006;05;432;206;226
068;003;001;007;01;390;182;208
068;003;001;007;02;384;203;181
068;003;001;007;03;384;181;203
068;003;001;007;04;384;179;205
068;003;001;008;01;328;180;148
068;003;001;008;02;328;180;148
068;003;001;008;03;324;155;169
068;003;001;009;01;376;186;190
068;003;001;009;02;376;183;193
068;003;001;009;03;369;202;167
068;003;001;009;04;368;192;176
068;003;001;010;01;384;177;207
068;003;001;010;02;384;160;224
068;003;001;010;03;384;165;219
068;003;001;010;04;378;181;197
068;003;001;010;05;376;169;207
068;003;001;011;01;387;191;196
068;003;001;011;02;384;213;171
068;003;001;012;01;262;134;128
068;003;001;012;02;256;138;118
068;003;001;013;01;86;50;36
068;003;001;014;01;238;121;117
068;005;098;001;01;318;148;170
068;005;098;001;02;312;152;160
068;005;098;002;01;344;167;177
068;005;098;002;02;339;191;148
068;005;098;002;03;336;155;181
068;005;098;003;01;392;187;205
068;005;098;003;02;384;188;196
068;005;098;003;03;384;198;186
068;005;098;003;04;384;178;206
068;005;098;004;01;379;182;197
068;005;098;004;02;376;197;179
068;005;098;004;03;376;195;181
068;005;098;004;04;376;171;205
068;005;098;005;01;376;207;169
068;005;098;005;02;372;208;164
068;005;098;006;01;376;174;202
068;005;098;006;02;369;211;158
068;006;098;001;01;307;161;146
068;006;098;002;01;357;170;187
068;006;098;002;02;352;162;190
068;006;098;002;03;352;161;191
068;006;098;002;04;352;169;183
068;006;098;003;01;416;201;215
068;006;098;003;02;416;200;216
068;006;098;003;03;409;214;195
068;006;098;003;04;408;222;186
068;006;098;004;01;360;185;175
068;006;098;004;02;358;181;177
068;006;098;004;03;352;171;181
068;006;098;005;01;400;194;206
068;006;098;005;02;393;182;211
068;006;098;005;03;392;182;210
068;006;098;005;04;392;158;234
068;006;098;005;05;392;175;217
068;006;098;005;06;392;172;220
068;006;098;005;07;392;157;235
068;006;098;006;01;249;125;124
068;007;098;001;01;446;216;230
068;007;098;001;02;440;222;218
068;007;098;002;01;416;217;199
068;007;098;002;02;416;215;201
068;007;098;002;03;410;205;205
068;007;098;002;04;408;196;212
068;007;098;003;01;446;228;218
068;007;098;003;02;440;207;233
068;007;098;003;03;440;220;220
068;007;098;004;01;383;179;204
068;007;098;004;02;376;181;195
068;007;098;004;03;376;194;182
068;007;098;004;04;376;183;193
068;007;098;005;01;354;183;171
068;007;098;005;02;352;167;185
068;007;098;005;03;352;176;176
068;007;098;005;04;352;174;178
068;008;098;001;01;400;209;191
068;008;098;001;02;400;194;206
068;008;098;001;03;400;200;200
068;008;098;001;04;392;198;194
068;008;098;002;01;448;216;232
068;008;098;002;02;441;217;224
068;008;098;002;03;440;222;218
068;008;098;003;01;368;186;182
068;008;098;003;02;368;180;188
068;008;098;003;03;361;166;195
068;008;098;003;04;360;176;184
068;008;098;003;05;360;167;193
068;008;098;004;01;448;230;218
068;008;098;004;02;448;217;231
068;008;098;004;03;448;244;204
068;008;098;004;04;440;192;248
068;008;098;004;05;440;230;210
068;008;098;005;01;423;200;223
068;008;098;005;02;416;203;213
068;008;098;005;03;416;198;218
068;008;098;005;04;416;201;215
068;008;098;006;01;126;83;43
069;002;001;001;01;440;227;213
069;002;001;001;02;440;204;236
069;002;001;001;03;440;214;226
069;002;001;001;04;434;186;248
069;002;001;001;05;432;198;234
069;002;001;002;01;440;210;230
069;002;001;002;02;440;181;259
069;002;001;002;03;439;237;202
069;002;001;002;04;432;185;247
069;002;001;002;05;432;196;236
069;002;001;003;01;416;197;219
069;002;001;003;02;416;205;211
069;002;001;003;03;416;204;212
069;002;001;003;04;416;205;211
069;002;001;003;05;416;212;204
069;002;001;003;06;416;195;221
069;002;001;003;07;416;214;202
069;002;001;003;08;416;220;196
069;002;001;003;09;416;194;222
069;002;001;003;10;407;202;205
069;002;001;004;01;449;205;244
069;002;001;004;02;448;227;221
069;002;001;004;03;448;196;252
069;002;001;004;04;448;198;250
069;002;001;004;05;448;227;221
069;002;001;004;06;448;211;237
069;002;001;005;01;440;208;232
069;002;001;005;02;440;205;235
069;002;001;005;03;433;206;227
069;002;001;005;04;432;201;231
069;002;001;005;05;432;228;204
069;002;001;006;01;152;84;68
069;002;001;007;01;392;203;189
069;002;001;007;02;392;225;167
069;002;001;007;03;392;184;208
069;002;001;007;04;389;208;181
069;002;001;008;01;296;187;109
069;002;001;008;02;295;166;129
069;002;001;009;01;248;140;108
069;002;001;009;02;243;148;95
069;002;001;010;01;195;100;95
069;004;001;001;01;432;202;230
069;004;001;001;02;432;183;249
069;004;001;001;03;425;201;224
069;004;001;001;04;424;173;251
069;004;001;001;05;424;184;240
069;004;001;002;01;448;199;249
069;004;001;002;02;442;194;248
069;004;001;002;03;440;197;243
069;004;001;002;04;440;205;235
069;004;001;002;05;440;217;223
069;004;001;002;06;440;221;219
069;004;001;003;01;392;180;212
069;004;001;003;02;392;177;215
069;004;001;003;03;392;202;190
069;004;001;003;04;392;194;198
069;004;001;003;05;392;203;189
069;004;001;003;06;389;189;200
069;004;001;003;07;384;183;201
069;004;001;004;01;408;198;210
069;004;001;004;02;408;212;196
069;004;001;004;03;408;208;200
069;004;001;004;04;408;220;188
069;004;001;005;01;400;215;185
069;004;001;005;02;400;208;192
069;004;001;005;03;400;216;184
069;004;001;005;04;400;212;188
069;004;001;005;05;397;221;176
069;004;001;005;06;392;214;178
069;004;001;005;07;392;219;173
069;004;001;006;01;264;167;97
069;004;001;006;02;257;155;102
069;004;001;007;01;438;200;238
069;004;001;007;02;432;206;226
069;004;001;007;03;432;222;210
069;004;001;008;01;384;206;178
069;004;001;008;02;384;205;179
069;004;001;008;03;380;193;187
069;004;001;009;01;416;189;227
069;004;001;009;02;408;194;214
069;004;001;009;03;408;195;213
069;004;001;010;01;256;125;131
069;004;001;010;02;250;139;111
069;004;001;011;01;383;200;183
069;004;001;011;02;376;206;170
069;004;001;011;03;376;206;170
069;004;001;011;04;376;180;196
069;004;001;011;05;376;191;185
069;004;001;012;01;344;168;176
069;004;001;012;02;344;181;163
069;004;001;012;03;337;184;153
069;004;001;012;04;336;169;167
069;004;001;013;01;371;187;184
069;004;001;013;02;368;176;192
069;004;001;013;03;368;162;206
069;004;001;013;04;368;168;200
069;004;001;013;05;368;167;201
069;004;001;014;01;448;223;225
069;004;001;014;02;448;213;235
069;004;001;014;03;443;228;215
069;004;001;014;04;440;220;220
069;004;001;015;01;392;204;188
069;004;001;015;02;384;188;196
069;004;001;015;03;384;181;203
069;004;001;015;04;384;171;213
069;004;001;015;05;384;180;204
069;004;001;016;01;440;208;232
069;004;001;016;02;440;227;213
069;004;001;016;03;439;221;218
069;004;001;016;04;432;203;229
069;004;001;016;05;432;220;212
069;004;001;017;01;376;185;191
069;004;001;017;02;376;182;194
069;004;001;017;03;376;186;190
069;004;001;017;04;376;168;208
069;004;001;017;05;376;182;194
069;004;001;017;06;372;192;180
069;004;001;018;01;324;159;165
069;004;001;018;02;320;148;172
069;004;001;018;03;320;144;176
069;004;001;019;01;384;181;203
069;004;001;019;02;384;182;202
069;004;001;019;03;377;183;194
069;004;001;019;04;376;193;183
069;004;001;019;05;376;186;190
069;004;001;020;01;219;101;118
069;004;001;021;01;256;125;131
069;004;001;021;02;249;118;131
069;004;098;001;01;257;161;96
069;005;098;001;01;424;202;222
069;005;098;001;02;422;204;218
069;005;098;001;03;416;200;216
069;005;098;001;04;416;201;215
069;005;098;001;05;416;222;194
069;005;098;002;01;432;213;219
069;005;098;002;02;432;215;217
069;005;098;002;03;432;228;204
069;005;098;002;04;426;218;208
069;005;098;002;05;424;214;210
069;005;098;003;01;444;262;182
069;005;098;004;01;408;206;202
069;005;098;004;02;408;229;179
069;005;098;004;03;407;224;183
069;005;098;005;01;401;251;150
069;005;098;006;01;163;92;71
069;005;098;007;01;357;193;164
069;005;098;009;01;126;70;56
069;005;098;010;01;88;78;10
069;005;098;011;01;167;102;65
069;005;098;012;01;231;133;98
070;001;001;001;01;448;217;231
070;001;001;001;02;448;214;234
070;001;001;001;03;448;240;208
070;001;001;001;04;448;218;230
070;001;001;001;05;448;214;234
070;001;001;001;06;441;209;232
070;001;001;001;07;440;227;213
070;001;001;001;08;440;235;205
070;001;001;001;09;440;229;211
070;001;001;001;10;440;229;211
070;001;001;002;01;448;242;206
070;001;001;002;02;448;229;219
070;001;001;002;03;448;243;205
070;001;001;002;04;448;238;210
070;001;001;002;05;448;238;210
070;001;001;002;06;444;249;195
070;001;001;003;01;408;206;202
070;001;001;003;02;405;214;191
070;001;001;004;01;432;215;217
070;001;001;004;02;432;218;214
070;001;001;004;03;432;221;211
070;001;001;004;04;430;215;215
070;001;001;005;01;411;201;210
070;001;001;005;02;408;220;188
070;001;001;005;03;408;189;219
070;001;001;005;04;408;197;211
070;001;001;005;05;408;211;197
070;001;001;005;06;408;206;202
070;001;001;005;07;408;210;198
070;001;001;006;01;448;219;229
070;001;001;006;02;448;222;226
070;001;001;006;03;448;225;223
070;001;001;006;04;448;213;235
070;001;001;006;05;448;223;225
070;001;001;006;06;448;232;216
070;001;001;006;07;443;229;214
070;001;001;007;01;406;202;204
070;001;001;007;02;400;194;206
070;001;001;007;03;400;205;195
070;001;001;007;04;400;196;204
070;001;001;007;05;400;193;207
070;001;001;007;06;400;194;206
070;001;001;008;01;272;130;142
070;001;001;008;02;271;152;119
070;001;001;009;01;264;135;129
070;001;001;012;01;298;148;150
070;001;001;013;01;178;95;83
070;001;098;001;01;368;174;194
070;001;098;001;02;362;178;184
070;001;098;001;03;360;180;180
070;001;098;001;04;360;182;178
070;001;098;001;05;360;158;202
070;001;098;002;01;416;204;212
070;001;098;002;02;413;215;198
070;001;098;002;03;408;205;203
070;001;098;003;01;432;196;236
070;001;098;003;02;432;180;252
070;001;098;003;03;428;208;220
070;001;098;004;01;403;202;201
070;001;098;004;02;400;242;158
070;001;098;005;01;392;179;213
070;001;098;005;02;392;168;224
070;001;098;005;03;386;178;208
070;001;098;005;04;384;187;197
070;001;098;005;05;384;183;201
070;001;098;006;01;360;181;179
070;001;098;006;02;360;176;184
070;001;098;006;03;360;173;187
070;001;098;007;01;400;195;205
070;001;098;007;02;396;175;221
070;001;098;007;03;392;198;194
070;001;098;007;04;392;203;189
070;001;098;008;01;188;108;80
070;001;098;010;01;272;130;142
070;001;098;010;02;266;151;115
070;002;098;001;01;448;209;239
070;002;098;001;02;448;209;239
070;002;098;001;03;447;203;244
070;002;098;002;01;312;144;168
070;002;098;002;02;309;150;159
070;002;098;002;03;304;149;155
070;002;098;003;01;336;158;178
070;002;098;003;02;336;161;175
070;002;098;003;03;331;151;180
070;002;098;004;01;450;223;227
070;002;098;004;02;450;203;247
070;002;098;004;03;448;223;225
070;002;098;005;01;334;164;170
070;002;098;005;02;328;170;158
070;002;098;006;01;267;134;133
070;002;098;006;02;264;136;128
070;002;098;007;01;256;115;141
070;002;098;007;02;249;108;141
070;002;098;008;01;203;106;97
070;003;098;001;01;424;236;188
070;003;098;001;02;424;229;195
070;003;098;001;03;424;268;156
070;003;098;001;04;420;270;150
070;003;098;002;01;194;115;79
070;003;098;003;01;47;29;18
070;003;098;004;01;131;77;54
070;003;098;005;01;287;179;108
070;003;098;005;02;280;167;113
070;003;098;006;01;90;61;29
070;003;098;007;01;90;69;21
070;003;098;008;01;223;159;64
070;003;098;011;01;181;100;81
070;004;098;001;01;195;116;79
070;004;098;002;01;328;173;155
070;004;098;002;02;323;155;168
070;004;098;002;03;320;164;156
070;004;098;003;01;231;136;95
070;004;098;004;01;174;99;75
070;004;098;005;01;340;191;149
070;004;098;006;01;296;162;134
070;004;098;007;01;90;53;37
070;005;098;001;01;371;166;205
070;005;098;001;02;368;181;187
070;005;098;001;03;368;200;168
070;005;098;001;04;368;191;177
070;005;098;001;05;368;185;183
070;005;098;002;01;416;202;214
070;005;098;002;02;416;207;209
070;005;098;002;03;416;229;187
070;005;098;002;04;412;200;212
070;005;098;002;05;408;213;195
070;005;098;003;01;87;58;29
070;005;098;004;01;440;243;197
070;005;098;004;02;440;216;224
070;005;098;004;03;440;234;206
070;005;098;004;04;433;220;213
070;005;098;004;05;432;207;225
070;005;098;005;01;408;182;226
070;005;098;005;02;408;220;188
070;005;098;005;03;401;212;189
070;005;098;005;04;400;217;183
070;005;098;005;05;400;213;187
070;005;098;006;01;232;128;104
070;005;098;006;02;230;129;101
070;005;098;007;01;376;179;197
070;005;098;007;02;376;187;189
070;005;098;007;03;376;189;187
070;005;098;007;04;372;177;195
070;005;098;007;05;368;180;188
070;005;098;008;01;284;155;129
070;005;098;009;01;221;126;95
070;005;098;010;01;446;252;194
070;005;098;011;01;141;79;62
070;005;098;012;01;74;52;22
070;005;098;013;01;70;40;30
070;005;098;014;01;125;75;50
070;005;098;015;01;61;32;29
070;005;098;016;01;163;111;52
070;005;098;017;01;167;86;81
070;005;098;018;01;202;112;90
070;005;098;019;01;102;62;40
071;007;001;001;01;450;195;255
071;007;001;001;02;450;202;248
071;007;001;001;03;450;241;209
071;007;001;001;04;450;207;243
071;007;001;001;05;449;234;215
071;007;001;002;01;384;187;197
071;007;001;002;02;384;200;184
071;007;001;002;03;384;211;173
071;007;001;002;04;384;222;162
071;007;001;002;05;384;211;173
071;007;001;002;06;381;215;166
071;007;001;003;01;432;218;214
071;007;001;003;02;430;218;212
071;007;001;003;03;424;211;213
071;007;001;003;04;424;191;233
071;007;001;004;01;360;174;186
071;007;001;004;02;360;172;188
071;007;001;004;03;360;188;172
071;007;001;004;04;357;163;194
071;007;001;005;01;410;186;224
071;007;001;005;02;408;215;193
071;007;001;006;01;392;190;202
071;007;001;006;02;392;203;189
071;007;001;006;03;392;206;186
071;007;001;006;04;390;198;192
071;007;001;007;01;344;176;168
071;007;001;007;02;344;186;158
071;007;001;007;03;338;168;170
071;007;001;008;01;400;214;186
071;007;001;008;02;400;211;189
071;007;001;008;03;397;195;202
071;007;001;009;01;448;216;232
071;007;001;009;02;448;204;244
071;007;001;009;03;448;214;234
071;007;001;009;04;448;221;227
071;007;001;009;05;440;202;238
071;007;001;010;01;420;216;204
071;007;001;010;02;416;225;191
071;007;001;011;01;448;218;230
071;007;001;011;02;448;244;204
071;007;001;011;03;448;224;224
071;007;001;011;04;442;207;235
071;007;001;011;05;440;219;221
071;007;001;012;01;354;201;153
071;007;001;013;01;352;153;199
071;007;001;013;02;352;174;178
071;007;001;013;03;352;162;190
071;007;001;013;04;345;182;163
071;007;001;014;01;287;172;115
071;008;098;001;01;448;190;258
071;008;098;001;02;448;253;195
071;008;098;001;03;446;217;229
071;008;098;001;04;440;223;217
071;008;098;002;01;243;116;127
071;008;098;002;02;240;124;116
071;008;098;003;01;136;76;60
071;008;098;004;01;294;153;141
071;009;098;001;01;432;196;236
071;009;098;001;02;432;193;239
071;009;098;001;03;432;211;221
071;009;098;001;04;430;214;216
071;009;098;001;05;424;201;223
071;009;098;001;06;424;216;208
071;009;098;002;01;400;187;213
071;009;098;002;02;399;186;213
071;009;098;002;03;392;199;193
071;009;098;002;04;392;194;198
071;009;098;003;01;366;206;160
071;009;098;003;02;360;216;144
072;001;001;001;01;403;231;172
072;001;001;001;02;400;221;179
072;001;001;002;01;402;225;177
072;001;001;002;02;400;216;184
072;001;001;002;03;400;214;186
072;001;001;002;04;400;230;170
072;001;001;003;01;392;230;162
072;001;001;003;02;392;223;169
072;001;001;003;03;391;223;168
072;001;001;003;04;384;243;141
072;001;001;004;01;257;159;98
072;001;001;005;01;352;202;150
072;001;001;006;01;288;152;136
072;001;001;006;02;280;151;129
072;001;001;007;01;157;98;59
072;001;001;008;01;334;201;133
072;001;001;009;01;167;95;72
072;001;001;010;01;241;135;106
072;001;001;011;01;372;219;153
072;001;001;012;01;385;249;136
072;001;001;013;01;151;95;56
072;001;001;014;01;147;85;62
072;001;001;015;01;100;58;42
072;001;001;018;01;65;43;22
072;001;098;001;01;175;93;82
072;001;098;002;01;111;62;49
072;001;098;003;01;190;119;71
072;001;098;004;01;173;103;70
072;001;098;005;01;133;79;54
072;001;098;006;01;296;163;133
072;001;098;007;01;252;121;131
072;001;098;008;01;400;233;167
072;001;098;009;01;324;185;139
072;001;098;010;01;218;109;109
072;001;098;011;01;95;45;50
072;001;098;012;01;239;139;100
072;001;098;013;01;297;169;128
072;001;098;014;01;203;101;102
072;001;098;015;01;269;166;103
072;001;098;016;01;145;90;55
072;001;098;017;01;175;106;69
072;001;098;018;01;249;145;104
072;001;098;019;01;122;75;47
072;001;098;020;01;82;47;35
072;002;098;001;01;180;116;64
072;002;098;002;01;83;53;30
072;002;098;003;01;392;222;170
072;002;098;003;02;392;216;176
072;002;098;003;03;392;227;165
072;002;098;003;04;387;218;169
072;002;098;003;05;384;198;186
072;002;098;004;01;248;140;108
072;002;098;004;02;248;141;107
072;002;098;005;01;297;170;127
072;002;098;006;01;317;197;120
072;002;098;007;01;430;241;189
072;002;098;008;01;376;208;168
072;002;098;008;02;370;220;150
072;002;098;009;01;288;147;141
072;002;098;009;02;287;166;121
072;002;098;010;01;261;154;107
072;002;098;010;02;256;148;108
072;002;098;011;01;322;198;124
072;002;098;012;01;128;69;59
072;002;098;013;01;65;38;27
072;002;098;014;01;318;167;151
072;002;098;015;01;243;139;104
072;002;098;016;01;280;170;110
072;002;098;016;02;277;174;103
072;002;098;017;01;126;74;52
072;002;098;018;01;159;103;56
072;002;098;019;01;272;157;115
072;002;098;019;02;266;150;116
072;002;098;020;01;118;82;36
073;002;001;001;01;370;203;167
073;002;001;002;01;400;227;173
073;002;001;002;02;392;198;194
073;002;001;003;01;375;219;156
073;002;001;004;01;406;233;173
073;002;001;005;01;360;191;169
073;002;001;005;02;354;167;187
073;002;001;005;03;352;187;165
073;002;001;006;01;392;206;186
073;002;001;006;02;390;196;194
073;002;001;007;01;412;218;194
073;002;001;007;02;408;226;182
073;002;001;007;03;408;190;218
073;002;001;007;04;408;193;215
073;002;001;008;01;362;203;159
073;002;001;009;01;334;175;159
073;002;001;010;01;252;147;105
073;002;001;011;01;194;100;94
073;002;001;012;01;246;145;101
073;002;001;013;01;129;77;52
073;002;001;014;01;369;226;143
073;002;001;015;01;411;249;162
073;002;001;015;02;408;227;181
073;002;001;016;01;92;50;42
073;002;001;017;01;79;53;26
073;002;001;020;01;129;72;57
073;002;001;021;01;173;98;75
073;002;098;001;01;307;168;139
073;002;098;002;01;120;73;47
073;002;098;003;01;115;63;52
073;002;098;004;01;111;60;51
073;002;098;005;01;107;57;50
073;002;098;006;01;448;230;218
073;002;098;006;02;448;249;199
073;002;098;007;01;345;195;150
073;002;098;008;01;267;133;134
073;002;098;008;02;264;152;112
073;002;098;009;01;133;71;62
073;002;098;010;01;264;144;120
073;002;098;010;02;256;144;112
073;002;098;011;01;148;78;70
073;002;098;012;01;213;103;110
073;002;098;013;01;201;109;92
073;002;098;014;01;384;205;179
073;002;098;014;02;376;207;169
073;002;098;015;01;198;100;98
073;002;098;016;01;361;201;160
073;002;098;017;01;177;111;66
073;002;098;018;01;113;71;42
073;002;098;019;01;123;68;55
073;002;098;020;01;241;135;106
073;002;098;020;02;240;124;116
073;002;098;021;01;245;138;107
073;002;098;022;01;238;142;96
073;002;098;023;01;367;207;160
073;002;098;024;01;304;188;116
073;002;098;025;01;153;93;60
073;002;098;026;01;368;204;164
073;002;098;026;02;364;201;163
073;002;098;027;01;409;234;175
073;002;098;028;01;312;187;125
073;002;098;029;01;164;89;75
073;002;098;030;01;344;187;157
073;002;098;031;01;121;65;56
073;002;098;032;01;202;123;79
073;002;098;034;01;248;137;111
073;002;098;034;02;248;113;135
073;002;098;035;01;256;139;117
073;002;098;035;02;248;129;119
073;002;098;037;01;117;77;40
073;004;001;001;01;344;173;171
073;004;001;001;02;336;158;178
073;004;001;001;03;336;186;150
073;004;001;001;04;336;164;172
073;004;001;002;01;344;179;165
073;004;001;002;02;344;168;176
073;004;001;002;03;338;175;163
073;004;001;002;04;336;175;161
073;004;001;003;01;395;202;193
073;004;001;003;02;392;205;187
073;004;001;003;03;392;206;186
073;004;001;003;04;392;212;180
073;004;001;004;01;422;233;189
073;004;001;004;02;416;204;212
073;004;001;005;01;392;233;159
073;004;001;005;02;385;223;162
073;004;001;006;01;416;272;144
073;004;001;006;02;412;261;151
073;004;001;006;03;408;235;173
073;004;001;006;04;408;275;133
073;004;001;007;01;400;225;175
073;004;001;007;02;399;190;209
073;004;001;007;03;392;208;184
073;004;001;007;04;392;208;184
073;004;001;008;01;416;227;189
073;004;001;008;02;416;242;174
073;004;001;008;03;416;231;185
073;004;001;008;04;416;217;199
073;004;001;008;05;416;246;170
073;004;001;008;06;412;249;163
073;004;001;008;07;408;243;165
073;004;001;009;01;384;223;161
073;004;001;009;02;384;214;170
073;004;001;009;03;384;207;177
073;004;001;009;04;382;227;155
073;004;001;010;01;372;212;160
073;004;001;010;02;368;187;181
073;004;001;010;03;368;206;162
073;004;001;010;04;368;219;149
073;004;001;011;01;367;191;176
073;004;001;011;02;360;193;167
073;004;001;011;03;360;200;160
073;004;001;012;01;400;224;176
073;004;001;012;02;400;209;191
073;004;001;012;03;397;211;186
073;004;001;012;04;392;213;179
073;004;001;013;01;392;212;180
073;004;001;013;02;392;221;171
073;004;001;013;03;386;216;170
073;004;001;013;04;384;200;184
073;004;001;013;05;384;210;174
073;004;001;013;06;384;225;159
073;004;001;014;01;400;155;245
073;004;001;014;02;400;178;222
073;004;001;014;03;395;188;207
073;004;001;014;04;392;180;212
073;004;001;014;05;392;189;203
073;004;001;014;06;392;168;224
073;004;001;015;01;408;191;217
073;004;001;015;02;408;199;209
073;004;001;015;03;408;206;202
073;004;001;015;04;406;183;223
073;004;001;015;05;400;206;194
073;004;001;016;01;439;237;202
073;004;001;016;02;432;255;177
073;004;001;016;03;432;241;191
073;004;001;017;01;224;141;83
073;004;001;018;01;140;86;54
073;004;001;019;01;277;159;118
073;004;001;020;01;443;258;185
073;004;001;021;01;272;138;134
073;004;001;021;02;264;144;120
073;004;001;022;01;164;94;70
073;004;001;024;01;247;139;108
073;004;001;024;02;240;123;117
073;004;001;025;01;288;153;135
073;004;001;025;02;287;162;125
073;004;001;026;01;314;181;133
073;004;001;027;01;384;217;167
073;004;001;027;02;384;198;186
073;004;001;027;03;383;219;164
073;004;001;028;01;368;196;172
073;004;001;028;02;365;207;158
073;004;001;029;01;263;155;108
073;004;001;030;01;336;204;132
073;004;001;030;02;336;187;149
073;004;001;031;01;312;181;131
073;004;001;031;02;311;162;149
073;004;001;031;03;304;156;148
073;004;001;032;01;424;209;215
073;004;001;032;02;424;213;211
073;004;001;032;03;422;225;197
073;004;001;032;04;416;224;192
073;004;001;033;01;392;225;167
073;004;001;033;02;392;218;174
073;004;001;033;03;392;211;181
073;004;001;033;04;392;237;155
073;004;001;033;05;392;219;173
073;004;001;033;06;388;227;161
073;004;001;034;01;448;255;193
073;004;001;034;02;443;233;210
073;004;001;034;03;440;243;197
073;004;001;035;01;344;172;172
073;004;001;035;02;340;185;155
073;004;001;035;03;336;172;164
073;004;001;036;01;320;189;131
073;004;001;036;02;320;176;144
073;004;001;036;03;315;180;135
073;004;001;037;01;368;187;181
073;004;001;037;02;368;188;180
073;004;001;037;03;367;183;184
073;004;001;038;01;344;180;164
073;004;001;038;02;339;180;159
073;004;001;038;03;336;192;144
073;004;001;039;01;319;167;152
073;004;001;040;01;107;66;41
073;004;001;041;01;413;220;193
073;004;001;042;01;165;79;86
073;004;001;045;01;199;96;103
073;004;001;046;01;121;77;44
073;004;001;047;01;90;40;50
073;004;001;048;01;168;93;75
073;004;001;049;01;121;69;52
073;004;001;050;01;53;31;22
073;004;001;051;01;62;34;28
073;004;098;001;01;93;52;41
073;004;098;002;01;243;126;117
073;004;098;003;01;155;92;63
073;004;098;004;01;323;180;143
073;004;098;004;02;320;187;133
073;004;098;005;01;153;82;71
073;004;098;006;01;224;121;103
073;004;098;007;01;376;206;170
073;004;098;008;01;215;110;105
073;004;098;009;01;241;126;115
073;004;098;010;01;448;249;199
073;004;098;010;02;446;225;221
073;004;098;010;03;440;278;162
073;004;098;011;01;309;164;145
073;004;098;011;02;304;159;145
073;004;098;012;01;267;124;143
073;004;098;013;01;435;246;189
073;004;098;013;02;432;231;201
073;004;098;013;03;432;218;214
073;004;098;013;04;432;227;205
073;004;098;014;01;400;212;188
073;004;098;014;02;400;227;173
073;004;098;015;01;400;195;205
073;004;098;015;02;396;207;189
073;004;098;016;01;176;100;76
073;004;098;017;01;248;145;103
073;004;098;018;01;355;203;152
073;004;098;019;01;132;76;56
073;004;098;020;01;243;132;111
073;004;098;020;02;240;137;103
073;004;098;021;01;126;77;49
073;004;098;023;01;126;63;63
073;004;098;024;01;24;13;11
073;004;098;026;01;74;44;30
073;004;098;027;01;65;40;25
073;005;098;001;01;448;236;212
073;005;098;001;02;448;218;230
073;005;098;001;03;448;238;210
073;005;098;001;04;441;222;219
073;005;098;001;05;440;246;194
073;005;098;002;01;138;75;63
073;005;098;003;01;290;146;144
073;005;098;004;01;139;74;65
073;005;098;005;01;297;166;131
073;005;098;005;02;296;177;119
073;005;098;006;01;220;134;86
073;005;098;007;01;264;152;112
073;005;098;008;01;151;94;57
073;005;098;010;01;178;98;80
073;005;098;011;01;257;145;112
073;005;098;012;01;223;120;103
073;005;098;013;01;338;175;163
073;005;098;013;02;336;198;138
073;005;098;013;03;336;173;163
073;005;098;014;01;221;130;91
073;005;098;015;01;125;68;57
073;005;098;016;01;187;106;81
073;005;098;017;01;131;83;48
073;005;098;018;01;186;114;72
073;005;098;019;01;246;141;105
073;005;098;019;02;240;126;114
073;005;098;020;01;181;105;76
073;005;098;021;01;271;143;128
073;005;098;022;01;268;165;103
073;005;098;022;02;264;169;95
073;005;098;023;01;125;64;61
073;005;098;024;01;156;75;81
073;005;098;025;01;174;95;79
073;005;098;026;01;283;163;120
073;005;098;027;01;203;115;88
073;005;098;028;01;328;174;154
073;005;098;029;01;201;124;77
073;005;098;030;01;229;114;115
073;005;098;031;01;211;116;95
073;005;098;032;01;236;140;96
073;005;098;033;01;87;52;35
073;005;098;034;01;174;94;80
073;005;098;035;01;361;195;166
073;005;098;036;01;221;118;103
073;005;098;037;01;167;96;71
073;005;098;038;01;409;217;192
073;005;098;039;01;176;103;73
073;005;098;040;01;118;68;50
073;005;098;041;01;353;182;171
073;005;098;042;01;273;153;120
073;005;098;043;01;184;103;81
073;005;098;044;01;157;95;62
073;005;098;045;01;229;131;98
073;005;098;046;01;104;51;53
073;005;098;047;01;361;210;151
073;005;098;048;01;260;149;111
073;005;098;048;02;256;147;109
073;005;098;049;01;241;135;106
073;005;098;050;01;254;142;112
073;005;098;051;01;241;137;104
073;005;098;052;01;69;38;31
073;005;098;053;01;246;134;112
073;005;098;054;01;387;229;158
073;005;098;055;01;208;120;88
073;005;098;056;01;107;64;43
073;005;098;057;01;433;250;183
073;005;098;057;02;432;226;206
073;005;098;058;01;324;182;142
073;005;098;059;01;233;135;98
073;005;098;060;01;365;219;146
073;005;098;060;02;360;202;158
073;005;098;060;03;360;209;151
073;005;098;060;04;360;198;162
073;005;098;061;01;320;182;138
073;005;098;061;02;318;197;121
073;005;098;062;01;335;208;127
073;005;098;063;01;351;250;101
073;005;098;064;01;191;137;54
073;005;098;065;01;202;124;78
073;005;098;066;01;77;46;31
073;005;098;067;01;51;21;30
073;005;098;068;01;54;41;13
073;005;098;069;01;64;32;32
073;005;098;070;01;123;71;52
073;005;098;071;01;51;31;20
073;005;098;072;01;147;107;40
073;005;098;074;01;52;29;23
073;005;098;075;01;79;45;34
073;005;098;076;01;66;40;26
073;005;098;077;01;72;45;27
073;005;098;078;01;106;66;40
073;008;098;001;01;253;142;111
073;008;098;002;01;344;198;146
073;008;098;002;02;342;191;151
073;008;098;003;01;147;88;59
073;008;098;004;01;384;200;184
073;008;098;004;02;377;216;161
073;008;098;005;01;113;68;45
073;008;098;006;01;336;175;161
073;008;098;006;02;331;187;144
073;008;098;007;01;72;40;32
073;008;098;008;01;320;170;150
073;008;098;008;02;320;168;152
073;008;098;008;03;314;177;137
073;008;098;009;01;90;57;33
073;008;098;010;01;364;195;169
073;008;098;011;01;362;196;166
073;008;098;012;01;413;232;181
073;008;098;013;01;243;125;118
073;008;098;013;02;240;119;121
073;008;098;014;01;107;60;47
073;008;098;015;01;360;197;163
073;008;098;015;02;356;205;151
073;008;098;016;01;143;78;65
073;008;098;017;01;397;237;160
073;008;098;018;01;149;76;73
073;008;098;019;01;141;74;67
073;008;098;020;01;109;55;54
073;008;098;021;01;217;118;99
073;008;098;022;01;246;136;110
073;008;098;023;01;286;161;125
073;008;098;023;02;280;149;131
073;008;098;024;01;240;146;94
073;008;098;025;01;280;141;139
073;008;098;026;01;104;60;44
073;008;098;027;01;183;92;91
073;008;098;028;01;87;52;35
073;008;098;029;01;153;90;63
073;008;098;030;01;86;49;37
073;008;098;031;01;145;76;69
073;009;001;001;01;381;184;197
073;009;001;001;02;376;199;177
073;009;001;002;01;131;73;58
073;009;001;003;01;432;245;187
073;009;001;003;02;429;234;195
073;009;001;004;01;368;200;168
073;009;001;005;01;251;137;114
073;009;001;005;02;248;136;112
073;009;001;006;01;424;255;169
073;009;001;006;02;424;257;167
073;009;001;007;01;148;87;61
073;009;001;008;01;109;64;45
073;009;001;009;01;144;91;53
073;009;001;010;01;64;47;17
073;009;001;011;01;101;54;47
074;002;001;001;01;392;181;211
074;002;001;001;02;392;191;201
074;002;001;001;03;392;185;207
074;002;001;001;04;387;200;187
074;002;001;003;01;440;220;220
074;002;001;003;02;438;203;235
074;002;001;003;03;432;199;233
074;002;001;003;04;432;200;232
074;002;001;003;05;432;205;227
074;002;001;003;06;432;214;218
074;002;001;003;07;432;191;241
074;002;001;003;08;432;216;216
074;002;001;003;09;432;203;229
074;002;001;003;10;432;221;211
074;002;001;003;11;432;211;221
074;002;001;004;01;376;174;202
074;002;001;004;02;376;189;187
074;002;001;004;03;376;189;187
074;002;001;004;04;376;198;178
074;002;001;004;05;372;213;159
074;002;001;005;01;416;219;197
074;002;001;005;02;416;190;226
074;002;001;005;03;409;200;209
074;002;001;006;01;424;167;257
074;002;001;006;02;416;191;225
074;002;001;006;03;416;232;184
074;002;001;006;04;416;182;234
074;002;001;007;01;400;183;217
074;002;001;007;02;400;196;204
074;002;001;007;03;400;199;201
074;002;001;007;04;398;191;207
074;002;001;007;05;392;189;203
074;002;001;008;01;400;179;221
074;002;001;008;02;397;198;199
074;002;001;008;03;392;184;208
074;002;001;008;04;392;189;203
074;002;001;008;05;392;200;192
074;002;001;010;01;134;77;57
074;002;001;011;01;260;148;112
074;002;001;011;02;256;130;126
074;002;098;001;01;410;249;161
074;002;098;002;01;120;69;51
074;002;098;003;01;232;135;97
074;002;098;003;02;230;122;108
074;002;098;004;01;129;79;50
074;002;098;005;01;186;113;73
074;002;098;006;01;128;79;49
074;003;098;001;01;180;118;62
074;003;098;002;01;416;196;220
074;003;098;002;02;415;228;187
074;003;098;003;01;372;176;196
074;003;098;003;02;368;177;191
074;003;098;003;03;368;184;184
074;003;098;003;04;368;169;199
074;003;098;003;05;368;186;182
074;003;098;004;01;448;222;226
074;003;098;004;02;440;197;243
074;003;098;004;03;440;201;239
074;003;098;005;01;424;188;236
074;003;098;005;02;424;216;208
074;003;098;005;03;423;206;217
074;003;098;005;04;416;185;231
074;003;098;005;05;416;196;220
074;003;098;007;01;384;194;190
074;003;098;007;02;384;183;201
074;003;098;007;03;380;205;175
074;003;098;008;01;376;159;217
074;003;098;008;02;376;170;206
074;003;098;008;03;376;171;205
074;003;098;008;04;369;167;202
074;003;098;008;05;368;155;213
074;003;098;009;01;440;194;246
074;003;098;009;02;435;185;250
074;004;098;001;01;248;117;131
074;004;098;001;02;242;128;114
074;004;098;002;01;360;182;178
074;004;098;002;02;356;181;175
074;004;098;002;03;352;159;193
074;004;098;003;01;448;186;262
074;004;098;003;02;440;188;252
074;004;098;003;03;440;176;264
074;004;098;004;01;432;206;226
074;004;098;004;02;432;204;228
074;004;098;004;03;426;211;215
074;004;098;005;01;216;136;80
074;004;098;006;01;360;167;193
074;004;098;006;02;358;180;178
074;004;098;006;03;352;157;195
074;004;098;006;04;352;173;179
074;004;098;007;01;156;92;64
074;004;098;008;01;108;71;37
074;004;098;009;01;304;148;156
074;004;098;009;02;304;136;168
074;004;098;009;03;302;156;146
074;004;098;010;01;232;108;124
075;001;001;001;01;312;168;144
075;001;001;001;02;312;143;169
075;001;001;001;03;305;170;135
075;001;001;002;01;440;211;229
075;001;001;002;02;437;232;205
075;001;001;002;03;432;222;210
075;001;001;003;01;379;143;236
075;001;001;003;02;376;182;194
075;001;001;003;03;376;161;215
075;001;001;004;01;312;146;166
075;001;001;004;02;309;140;169
075;001;001;004;03;304;161;143
075;001;001;005;01;402;199;203
075;001;001;005;02;400;189;211
075;001;001;006;01;344;160;184
075;001;001;006;02;344;165;179
075;001;001;006;03;343;178;165
075;001;001;006;04;336;174;162
075;001;001;007;01;245;118;127
075;001;001;008;01;253;122;131
075;001;001;009;01;416;183;233
075;001;001;010;01;239;101;138
075;001;001;010;02;232;93;139
075;001;001;011;01;169;73;96
075;001;001;012;01;328;147;181
075;001;001;013;01;222;87;135
075;001;001;014;01;280;115;165
075;001;001;014;02;273;125;148
075;001;001;015;01;154;69;85
075;001;001;016;01;319;130;189
075;001;001;016;02;312;144;168
075;001;001;017;01;180;123;57
075;001;001;018;01;223;92;131
075;001;001;020;01;107;45;62
075;001;001;021;01;71;29;42
075;001;098;001;01;301;126;175
075;001;098;002;01;304;124;180
075;001;098;002;02;297;140;157
075;001;098;003;01;157;76;81
075;001;098;004;01;200;87;113
075;001;098;005;01;194;80;114
075;001;098;006;01;340;126;214
075;001;098;006;02;336;136;200
075;001;098;007;01;391;152;239
075;001;098;008;01;232;101;131
075;001;098;009;01;199;86;113
075;001;098;010;01;342;154;188
075;001;098;011;01;107;54;53
075;001;098;012;01;107;45;62
075;001;098;013;01;169;72;97
075;001;098;014;01;119;50;69
075;001;098;015;01;230;84;146
075;001;098;015;02;224;93;131
075;001;098;016;01;222;86;136
075;001;098;017;01;317;134;183
075;001;098;018;01;375;164;211
075;001;098;019;01;345;150;195
075;001;098;020;01;320;126;194
075;001;098;021;01;308;153;155
075;001;098;022;01;88;50;38
075;001;098;023;01;390;160;230
075;001;098;024;01;287;116;171
075;001;098;025;01;170;71;99
075;001;098;026;01;274;96;178
075;001;098;026;02;272;101;171
075;001;098;027;01;371;150;221
075;001;098;028;01;321;147;174
075;001;098;029;01;153;65;88
075;001;098;030;01;360;160;200
075;001;098;031;01;232;100;132
075;001;098;031;02;224;106;118
075;001;098;032;01;386;147;239
075;001;098;032;02;384;168;216
075;001;098;033;01;144;65;79
075;001;098;034;01;319;141;178
075;001;098;035;01;218;94;124
075;001;098;036;01;175;82;93
075;001;098;037;01;142;62;80
075;001;098;038;01;294;117;177
075;001;098;039;01;328;139;189
075;001;098;039;02;328;165;163
075;001;098;040;01;299;128;171
075;001;098;041;01;203;99;104
075;001;098;042;01;72;33;39
075;001;098;043;01;88;42;46
075;003;098;001;01;392;192;200
075;003;098;001;02;386;201;185
075;003;098;002;01;396;178;218
075;003;098;003;01;177;88;89
075;003;098;004;01;266;114;152
075;003;098;004;02;264;130;134
075;003;098;005;01;244;108;136
075;003;098;006;01;218;82;136
075;003;098;007;01;336;143;193
075;003;098;008;01;356;155;201
075;003;098;009;01;307;136;171
075;003;098;010;01;374;158;216
075;003;098;012;01;304;129;175
075;003;098;012;02;303;123;180
075;003;098;013;01;128;52;76
075;003;098;014;01;356;144;212
075;003;098;015;01;328;136;192
075;003;098;015;02;328;159;169
075;003;098;015;03;323;152;171
075;003;098;016;01;159;83;76
075;003;098;017;01;292;131;161
075;003;098;018;01;312;140;172
075;003;098;019;01;272;110;162
075;003;098;019;02;264;118;146
075;003;098;020;01;221;113;108
075;003;098;022;01;371;162;209
075;004;098;001;01;424;197;227
075;004;098;001;02;424;173;251
075;004;098;001;03;422;206;216
075;004;098;002;01;342;161;181
075;004;098;003;01;209;109;100
075;004;098;004;01;171;85;86
075;004;098;005;01;386;159;227
075;004;098;005;02;384;158;226
075;004;098;006;01;378;168;210
075;004;098;007;01;375;152;223
075;004;098;008;01;246;115;131
075;004;098;009;01;184;85;99
075;004;098;010;01;369;145;224
075;004;098;011;01;200;85;115
075;004;098;012;01;344;132;212
075;004;098;012;02;344;156;188
075;004;098;012;03;336;145;191
075;004;098;012;04;336;147;189
075;004;098;013;01;194;88;106
075;004;098;014;01;256;107;149
075;004;098;015;01;232;112;120
075;004;098;015;02;227;101;126
075;004;098;016;01;87;42;45
075;005;098;001;01;318;154;164
075;005;098;002;01;281;114;167
075;005;098;003;01;429;184;245
075;005;098;004;01;304;139;165
075;005;098;004;02;301;131;170
075;005;098;005;01;352;123;229
075;005;098;005;02;344;155;189
075;005;098;006;01;400;179;221
075;005;098;006;02;392;198;194
075;005;098;006;03;392;175;217
075;005;098;006;04;392;167;225
075;005;098;007;01;182;85;97
075;005;098;008;01;205;87;118
075;005;098;009;01;320;153;167
075;005;098;009;02;320;154;166
075;005;098;010;01;405;178;227
075;005;098;010;02;400;209;191
075;005;098;011;01;205;98;107
075;005;098;012;01;175;87;88
075;005;098;013;01;368;153;215
075;005;098;013;02;368;151;217
075;005;098;013;03;360;170;190
075;005;098;015;01;84;42;42
076;003;001;001;01;410;191;219
076;003;001;001;02;408;199;209
076;003;001;001;03;408;198;210
076;003;001;001;04;408;197;211
076;003;001;002;01;284;148;136
076;003;001;003;01;416;198;218
076;003;001;003;02;416;191;225
076;003;001;003;03;416;195;221
076;003;001;003;04;416;202;214
076;003;001;003;05;412;221;191
076;003;001;004;01;392;214;178
076;003;001;004;02;392;208;184
076;003;001;004;03;385;211;174
076;003;001;005;01;424;250;174
076;003;001;005;02;423;248;175
076;003;001;005;03;416;248;168
076;003;001;006;01;384;183;201
076;003;001;006;02;384;177;207
076;003;001;006;03;384;199;185
076;003;001;006;04;384;175;209
076;003;001;006;05;380;193;187
076;003;001;006;06;376;181;195
076;003;001;007;01;384;178;206
076;003;001;007;02;384;169;215
076;003;001;007;03;384;162;222
076;003;001;007;04;378;199;179
076;003;001;008;01;440;208;232
076;003;001;008;02;440;227;213
076;003;001;008;03;438;228;210
076;003;001;008;04;432;209;223
076;003;001;008;05;432;204;228
076;003;001;008;06;432;225;207
076;003;001;008;07;432;221;211
076;003;001;008;08;432;204;228
076;003;001;009;01;292;157;135
076;003;001;010;01;266;120;146
076;003;001;010;02;264;160;104
076;003;001;011;01;424;205;219
076;003;001;011;02;419;187;232
076;003;001;011;03;416;218;198
076;003;001;012;01;344;166;178
076;003;001;012;02;339;170;169
076;003;001;012;03;336;167;169
076;003;001;012;04;336;157;179
076;003;001;013;01;203;101;102
076;003;001;014;01;368;177;191
076;003;001;014;02;365;179;186
076;003;001;015;01;164;98;66
076;003;001;016;01;353;187;166
076;003;001;016;02;352;179;173
076;003;001;016;03;352;172;180
076;003;001;017;01;360;177;183
076;003;001;017;02;360;176;184
076;003;001;017;03;354;181;173
076;003;001;017;04;352;151;201
076;003;001;018;01;384;192;192
076;003;001;018;02;379;187;192
076;003;001;018;03;376;193;183
076;003;001;019;01;351;168;183
076;003;001;019;02;344;169;175
076;003;001;019;03;344;177;167
076;003;001;020;01;336;169;167
076;003;001;020;02;330;193;137
076;003;001;021;01;384;175;209
076;003;001;021;02;377;184;193
076;003;001;022;01;69;45;24
076;003;001;023;01;121;57;64
076;003;001;024;01;130;60;70
076;003;098;001;01;398;226;172
076;003;098;002;01;408;187;221
076;003;098;002;02;406;182;224
076;003;098;002;03;400;203;197
076;003;098;003;01;392;163;229
076;003;098;003;02;392;205;187
076;003;098;003;03;392;178;214
076;003;098;003;04;392;184;208
076;003;098;003;05;388;182;206
076;003;098;004;01;125;76;49
076;003;098;006;01;128;72;56
076;004;098;001;01;440;202;238
076;004;098;002;01;424;198;226
076;004;098;002;02;424;183;241
076;004;098;002;03;420;171;249
076;004;098;003;01;437;193;244
076;004;098;003;02;432;207;225
076;004;098;003;03;432;190;242
076;004;098;003;04;432;217;215
076;004;098;003;05;432;182;250
076;004;098;004;01;392;179;213
076;004;098;004;02;392;196;196
076;004;098;004;03;384;157;227
076;004;098;004;04;384;204;180
076;004;098;005;01;400;185;215
076;004;098;005;02;400;168;232
076;004;098;005;03;395;173;222
076;004;098;006;01;441;197;244
076;004;098;006;02;440;210;230
076;004;098;007;01;448;196;252
076;004;098;007;02;448;192;256
076;004;098;007;03;448;219;229
076;004;098;007;04;445;199;246
076;004;098;008;01;411;172;239
076;004;098;008;02;408;208;200
076;004;098;009;01;351;168;183
076;004;098;010;01;430;226;204
076;004;098;010;02;424;215;209
076;004;098;011;01;364;164;200
076;004;098;011;02;360;165;195
076;004;098;011;03;360;176;184
076;004;098;011;04;360;183;177
076;004;098;012;01;434;192;242
076;004;098;012;02;432;204;228
076;004;098;013;01;287;146;141
076;004;098;013;02;280;135;145
076;004;098;014;01;320;131;189
076;004;098;014;02;320;165;155
076;004;098;015;01;79;40;39
076;005;098;001;01;416;191;225
076;005;098;001;02;411;201;210
076;005;098;002;01;436;198;238
076;005;098;003;01;429;194;235
076;005;098;003;02;424;190;234
076;005;098;003;03;424;182;242
076;005;098;003;04;424;164;260
076;005;098;003;05;424;172;252
076;005;098;003;06;424;188;236
076;005;098;004;01;402;183;219
076;005;098;004;02;400;175;225
076;005;098;004;03;400;182;218
076;005;098;005;01;149;60;89
076;005;098;006;01;88;45;43
076;006;098;001;01;363;188;175
076;006;098;002;01;376;154;222
076;006;098;002;02;376;157;219
076;006;098;002;03;371;188;183
076;006;098;002;04;368;176;192
076;006;098;003;01;315;157;158
076;006;098;003;02;312;166;146
076;006;098;003;03;312;177;135
076;006;098;004;01;361;193;168
076;006;098;005;01;261;118;143
076;006;098;005;02;256;125;131
076;006;098;006;01;408;186;222
076;006;098;006;02;408;201;207
076;006;098;006;03;408;181;227
076;006;098;006;04;408;204;204
076;006;098;006;05;405;178;227
076;006;098;007;01;352;172;180
076;006;098;007;02;348;177;171
076;006;098;008;01;279;134;145
076;006;098;008;02;272;138;134
076;006;098;009;01;416;205;211
076;006;098;009;02;410;187;223
076;006;098;009;03;408;179;229
076;006;098;010;01;384;178;206
076;006;098;010;02;383;204;179
076;006;098;011;01;111;58;53
076;006;098;012;01;331;154;177
076;006;098;013;01;320;142;178
076;006;098;013;02;315;148;167
077;001;001;001;01;448;196;252
077;001;001;001;02;448;195;253
077;001;001;001;03;440;198;242
077;001;001;001;04;440;205;235
077;001;001;002;01;384;185;199
077;001;001;002;02;384;174;210
077;001;001;002;03;378;160;218
077;001;001;002;04;376;198;178
077;001;001;002;05;376;206;170
077;001;001;003;01;355;205;150
077;001;001;004;01;360;184;176
077;001;001;004;02;360;181;179
077;001;001;004;03;355;202;153
077;001;001;005;01;360;180;180
077;001;001;005;02;360;182;178
077;001;001;005;03;360;177;183
077;001;001;005;04;355;181;174
077;001;001;006;01;392;189;203
077;001;001;006;02;392;219;173
077;001;001;006;03;387;204;183
077;001;001;007;01;376;192;184
077;001;001;007;02;376;191;185
077;001;001;007;03;376;177;199
077;001;001;007;04;376;167;209
077;001;001;007;05;373;185;188
077;001;001;008;01;408;184;224
077;001;001;008;02;407;178;229
077;001;001;008;03;400;194;206
077;001;001;008;04;400;198;202
077;001;001;008;05;400;201;199
077;001;001;008;06;400;219;181
077;001;001;009;01;448;209;239
077;001;001;009;02;448;223;225
077;001;001;009;03;443;202;241
077;001;001;009;04;440;200;240
077;001;001;009;05;440;215;225
077;001;001;009;06;440;221;219
077;001;001;010;01;368;194;174
077;001;001;010;02;360;177;183
077;001;001;010;03;360;194;166
077;001;001;011;01;340;168;172
077;001;001;011;02;336;151;185
077;001;001;011;03;336;150;186
077;001;001;012;01;400;193;207
077;001;001;012;02;400;175;225
077;001;001;012;03;395;192;203
077;001;001;012;04;392;192;200
077;001;001;012;05;392;187;205
077;001;001;012;06;392;199;193
077;001;001;012;07;392;203;189
077;001;001;013;01;392;218;174
077;001;001;013;02;392;195;197
077;001;001;013;03;392;216;176
077;001;001;013;04;384;183;201
077;001;001;015;01;448;196;252
077;001;001;015;02;448;212;236
077;001;001;015;03;448;187;261
077;001;001;015;04;448;167;281
077;001;001;015;05;448;222;226
077;001;001;015;06;444;202;242
077;001;001;015;07;440;193;247
077;001;001;015;08;440;196;244
077;001;001;015;09;440;220;220
077;001;001;015;10;440;220;220
077;001;001;016;01;450;194;256
077;001;001;016;02;450;202;248
077;001;001;016;03;450;207;243
077;001;001;016;04;449;228;221
077;001;001;016;05;448;234;214
077;001;001;017;01;274;147;127
077;001;001;018;01;117;62;55
077;001;001;019;01;400;201;199
077;001;001;020;01;272;148;124
077;001;001;020;02;270;132;138
077;001;001;021;01;305;160;145
077;001;001;022;01;368;163;205
077;001;001;022;02;368;180;188
077;001;001;022;03;365;180;185
077;001;001;023;01;322;167;155
077;001;001;023;02;320;148;172
077;001;001;024;01;242;106;136
077;001;001;024;02;240;128;112
077;001;001;025;01;440;195;245
077;001;001;027;01;203;107;96
077;001;001;028;01;231;114;117
077;001;001;029;01;344;158;186
077;001;001;029;02;339;168;171
077;001;001;030;01;314;165;149
077;001;001;031;01;325;144;181
077;001;001;032;01;178;96;82
077;001;001;035;01;204;96;108
077;001;001;036;01;312;157;155
077;001;001;036;02;311;161;150
077;001;001;036;03;304;153;151
077;001;001;037;01;158;75;83
077;001;001;038;01;285;158;127
077;001;001;038;02;280;153;127
077;001;098;001;01;194;103;91
077;001;098;002;01;177;88;89
077;002;098;001;01;195;97;98
077;002;098;002;01;434;195;239
077;002;098;003;01;370;184;186
077;002;098;004;01;248;113;135
077;002;098;004;02;245;128;117
077;002;098;005;01;322;156;166
077;002;098;006;01;387;173;214
077;002;098;007;01;250;115;135
077;002;098;007;02;248;120;128
077;002;098;008;01;400;180;220
077;002;098;008;02;400;171;229
077;002;098;008;03;399;176;223
077;002;098;009;01;294;141;153
077;002;098;010;01;227;107;120
077;002;098;011;01;93;44;49
077;003;098;001;01;321;147;174
077;003;098;002;01;304;134;170
077;003;098;003;01;304;130;174
077;003;098;003;02;304;156;148
077;003;098;003;03;300;151;149
077;003;098;004;01;304;150;154
077;003;098;004;02;302;169;133
077;003;098;005;01;217;115;102
077;003;098;006;01;135;68;67
077;003;098;007;01;320;165;155
077;003;098;007;02;319;170;149
077;003;098;008;01;285;152;133
077;003;098;009;01;232;101;131
077;003;098;009;02;227;113;114
077;003;098;010;01;284;124;160
077;003;098;010;02;280;135;145
077;003;098;011;01;106;51;55
077;003;098;012;01;282;124;158
077;003;098;012;02;280;131;149
077;003;098;013;01;235;105;130
077;003;098;014;01;68;29;39
077;003;098;015;01;120;56;64
077;004;098;001;01;433;202;231
077;004;098;002;01;216;107;109
077;004;098;003;01;195;75;120
077;004;098;004;01;140;54;86
077;004;098;005;01;301;119;182
077;004;098;006;01;165;88;77
077;004;098;007;01;400;200;200
077;004;098;007;02;397;167;230
077;004;098;008;01;343;167;176
077;004;098;009;01;148;68;80
077;004;098;010;01;283;139;144
077;004;098;011;01;65;32;33
077;004;098;012;01;75;44;31
078;001;001;001;01;360;190;170
078;001;001;001;02;360;203;157
078;001;001;001;03;360;183;177
078;001;001;001;04;352;184;168
078;001;001;002;01;392;181;211
078;001;001;002;02;386;177;209
078;001;001;002;03;384;173;211
078;001;001;002;04;384;196;188
078;001;001;003;01;330;165;165
078;001;001;003;02;328;161;167
078;001;001;003;03;328;165;163
078;001;001;004;01;283;152;131
078;001;001;004;02;280;131;149
078;001;001;005;01;96;49;47
078;001;001;006;01;298;172;126
078;001;001;006;02;296;140;156
078;001;001;007;01;244;134;110
078;001;001;008;01;207;104;103
078;001;001;009;01;388;199;189
078;001;001;010;01;84;49;35
078;001;001;011;01;124;70;54
078;001;001;012;01;120;71;49
078;001;098;001;01;256;107;149
078;001;098;001;02;255;134;121
078;001;098;002;01;246;135;111
078;001;098;002;02;240;102;138
078;001;098;003;01;290;147;143
078;001;098;004;01;208;112;96
078;001;098;007;01;142;65;77
078;004;001;001;01;344;167;177
078;004;001;001;02;343;166;177
078;004;001;001;03;336;170;166
078;004;001;001;04;336;177;159
078;004;001;002;01;384;211;173
078;004;001;002;02;384;194;190
078;004;001;002;03;384;208;176
078;004;001;002;04;384;219;165
078;004;001;002;05;376;221;155
078;004;001;002;06;376;218;158
078;004;001;003;01;304;159;145
078;004;001;003;02;302;175;127
078;004;001;003;03;296;161;135
078;004;001;004;01;400;206;194
078;004;001;004;02;400;205;195
078;004;001;004;03;399;240;159
078;004;001;004;04;392;224;168
078;004;001;005;01;400;211;189
078;004;001;005;02;400;195;205
078;004;001;005;03;394;180;214
078;004;001;005;04;392;188;204
078;004;001;005;05;392;193;199
078;004;001;005;06;392;185;207
078;004;001;005;07;392;180;212
078;004;001;006;01;384;180;204
078;004;001;006;02;384;183;201
078;004;001;006;03;384;178;206
078;004;001;006;04;377;156;221
078;004;001;007;01;368;183;185
078;004;001;007;02;367;169;198
078;004;001;007;03;360;182;178
078;004;001;007;04;360;184;176
078;004;001;008;01;346;158;188
078;004;001;008;02;344;146;198
078;004;001;008;03;344;159;185
078;004;001;008;04;344;154;190
078;004;001;009;01;366;188;178
078;004;001;009;02;360;185;175
078;004;001;009;03;360;192;168
078;004;001;010;01;238;95;143
078;004;001;010;02;232;103;129
078;004;001;011;01;256;116;140
078;004;001;011;02;253;134;119
078;004;001;012;01;312;154;158
078;004;001;012;02;312;150;162
078;004;001;012;03;309;163;146
078;004;001;013;01;384;172;212
078;004;001;013;02;384;179;205
078;004;001;013;03;378;187;191
078;004;001;014;01;328;200;128
078;004;001;015;01;384;195;189
078;004;001;015;02;376;207;169
078;004;001;015;03;376;180;196
078;004;001;015;04;376;186;190
078;004;001;016;01;349;166;183
078;004;001;016;02;344;135;209
078;004;001;016;03;344;161;183
078;004;001;016;04;344;154;190
078;004;001;017;01;261;132;129
078;004;001;019;01;111;60;51
078;004;001;020;01;101;54;47
078;004;098;001;01;304;151;153
078;004;098;002;01;304;154;150
078;004;098;002;02;302;145;157
078;004;098;003;01;336;169;167
078;004;098;003;02;336;171;165
078;004;098;003;03;332;165;167
078;004;098;004;01;232;115;117
078;004;098;004;02;226;118;108
078;004;098;005;01;408;213;195
078;004;098;005;02;406;200;206
078;004;098;006;01;202;144;58
078;005;001;001;01;359;169;190
078;005;001;001;02;352;164;188
078;005;001;002;01;385;189;196
078;005;001;002;02;384;196;188
078;005;001;003;01;309;166;143
078;005;001;003;02;304;157;147
078;005;001;004;01;440;208;232
078;005;001;004;02;435;204;231
078;005;001;005;01;349;177;172
078;005;001;006;01;392;202;190
078;005;001;006;02;388;217;171
078;005;001;007;01;42;26;16
078;005;001;008;01;223;96;127
078;005;001;009;01;263;135;128
078;005;001;009;02;256;120;136
078;005;001;010;01;157;82;75
078;005;001;011;01;230;106;124
078;005;001;012;01;444;216;228
078;005;001;013;01;436;221;215
078;005;001;014;01;280;142;138
078;005;001;014;02;277;139;138
078;005;098;001;01;312;167;145
078;005;098;001;02;307;166;141
078;005;098;002;01;234;126;108
078;005;098;003;01;408;210;198
078;005;098;003;02;408;213;195
078;005;098;004;01;156;86;70
078;005;098;005;01;232;110;122
078;005;098;005;02;228;99;129
078;005;098;006;01;222;105;117
078;005;098;007;01;368;160;208
078;005;098;008;01;441;210;231
078;005;098;008;02;440;210;230
078;005;098;008;03;440;221;219
078;005;098;009;01;66;41;25
078;005;098;010;01;95;52;43
078;006;098;001;01;358;165;193
078;006;098;001;02;352;168;184
078;006;098;002;01;264;114;150
078;006;098;002;02;261;119;142
078;006;098;003;01;304;133;171
078;006;098;003;02;296;128;168
078;006;098;004;01;118;66;52
078;006;098;005;01;446;229;217
078;006;098;006;01;107;40;67
078;006;098;007;01;319;162;157
078;006;098;008;01;112;53;59
079;001;001;001;01;364;193;171
079;001;001;001;02;360;184;176
079;001;001;001;03;360;176;184
079;001;001;001;04;360;164;196
079;001;001;001;05;360;181;179
079;001;001;002;01;411;222;189
079;001;001;002;02;408;208;200
079;001;001;002;03;408;198;210
079;001;001;003;01;434;217;217
079;001;001;003;02;432;227;205
079;001;001;003;03;432;198;234
079;001;001;004;01;320;169;151
079;001;001;004;02;320;173;147
079;001;001;004;03;315;163;152
079;001;001;005;01;419;203;216
079;001;001;006;01;303;174;129
079;001;001;006;02;296;172;124
079;001;001;007;01;372;190;182
079;001;001;008;01;225;120;105
079;001;001;009;01;169;91;78
079;001;001;010;01;273;125;148
079;001;001;010;02;272;132;140
079;001;001;011;01;162;85;77
079;001;098;002;01;264;172;92
079;001;098;002;02;257;149;108
079;001;098;003;01;287;164;123
079;001;098;004;01;400;167;233
079;001;098;004;02;393;212;181
079;001;098;004;03;392;199;193
079;001;098;005;01;211;120;91
079;001;098;006;01;234;108;126
079;001;098;006;02;232;108;124
079;001;098;007;01;306;169;137
079;001;098;008;01;335;138;197
079;001;098;009;01;240;124;116
079;001;098;009;02;238;114;124
079;001;098;010;01;407;196;211
079;001;098;011;01;211;128;83
079;001;098;012;01;238;129;109
079;001;098;013;01;173;102;71
079;001;098;014;01;209;115;94
079;001;098;015;01;356;202;154
079;001;098;016;01;121;63;58
079;001;098;017;01;253;129;124
079;001;098;018;01;446;199;247
079;001;098;019;01;112;61;51
079;001;098;020;01;136;75;61
079;001;098;021;01;67;36;31
079;002;001;001;01;344;170;174
079;002;001;001;02;344;181;163
079;002;001;001;03;343;164;179
079;002;001;002;01;416;214;202
079;002;001;002;02;416;199;217
079;002;001;002;03;411;172;239
079;002;001;002;04;408;196;212
079;002;001;003;01;338;160;178
079;002;001;004;01;308;153;155
079;002;001;004;02;304;160;144
079;002;001;005;01;210;104;106
079;002;001;006;01;198;85;113
079;002;001;007;01;99;49;50
079;002;001;008;01;175;88;87
079;002;098;001;01;263;129;134
079;002;098;002;01;125;68;57
079;002;098;003;01;381;181;200
079;002;098;004;01;63;32;31
079;002;098;005;01;65;36;29
079;002;098;006;01;69;43;26
079;002;098;007;01;136;67;69
079;002;098;008;01;140;71;69
079;002;098;009;01;315;174;141
079;002;098;010;01;336;169;167
079;002;098;010;02;328;183;145
079;002;098;011;01;288;161;127
079;002;098;011;02;286;131;155
079;002;098;012;01;376;188;188
079;002;098;014;01;177;89;88
079;002;098;016;01;166;70;96
079;002;098;017;01;254;115;139
079;003;098;001;01;382;192;190
079;003;098;001;02;376;208;168
079;003;098;002;01;366;213;153
079;003;098;003;01;412;194;218
079;003;098;003;02;408;231;177
079;003;098;003;03;408;201;207
079;003;098;004;01;341;188;153
079;003;098;004;02;336;197;139
079;003;098;004;03;336;176;160
079;003;098;005;01;355;214;141
079;003;098;006;01;291;163;128
079;003;098;006;02;288;172;116
079;003;098;007;01;206;125;81
079;003;098;008;01;138;80;58
079;003;098;009;01;331;186;145
079;003;098;009;02;328;179;149
079;003;098;009;03;328;184;144
079;003;098;010;01;130;76;54
079;003;098;011;01;91;56;35
079;003;098;012;01;126;72;54
079;003;098;013;01;87;52;35
079;003;098;015;01;73;51;22
079;003;098;016;01;103;65;38
079;003;098;017;01;112;72;40
080;003;001;001;01;350;171;179
080;003;001;001;02;344;154;190
080;003;001;001;03;344;157;187
080;003;001;002;01;290;147;143
080;003;001;003;01;320;142;178
080;003;001;003;02;315;128;187
080;003;001;004;01;202;78;124
080;003;001;005;01;243;103;140
080;003;001;005;02;240;130;110
080;003;001;006;01;314;129;185
080;003;001;006;02;312;129;183
080;003;001;007;01;344;175;169
080;003;001;007;02;337;169;168
080;003;001;008;01;320;140;180
080;003;001;008;02;316;147;169
080;003;001;009;01;349;170;179
080;003;001;009;02;344;165;179
080;003;001;010;01;263;134;129
080;003;001;010;02;256;97;159
080;003;001;011;01;282;122;160
080;003;001;012;01;375;170;205
080;003;001;013;01;277;116;161
080;003;001;014;01;276;130;146
080;003;001;014;02;272;131;141
080;003;098;001;01;336;172;164
080;003;098;002;01;369;170;199
080;003;098;003;01;86;34;52
080;003;098;004;01;247;107;140
080;003;098;005;01;147;55;92
080;003;098;006;01;335;166;169
080;003;098;007;01;296;116;180
080;003;098;007;02;289;129;160
080;003;098;008;01;232;102;130
080;003;098;009;01;428;196;232
080;003;098;009;02;424;184;240
080;003;098;010;01;290;121;169
080;003;098;011;01;119;60;59
080;003;098;012;01;61;25;36
080;003;098;013;01;92;44;48
080;003;098;014;01;83;38;45
080;003;098;015;01;151;63;88
080;003;098;016;01;166;64;102
080;003;098;017;01;108;61;47
080;003;098;018;01;101;42;59
080;003;098;019;01;69;36;33
080;004;001;001;01;450;229;221
080;004;001;001;02;450;211;239
080;004;001;001;03;450;197;253
080;004;001;002;01;442;231;211
080;004;001;002;02;440;189;251
080;004;001;003;01;312;143;169
080;004;001;003;02;305;144;161
080;004;001;004;01;153;63;90
080;004;001;005;01;343;179;164
080;004;001;005;02;336;140;196
080;004;001;006;01;248;117;131
080;004;001;006;02;244;106;138
080;004;001;007;01;352;182;170
080;004;001;008;01;325;156;169
080;004;001;009;01;107;45;62
080;004;001;010;01;124;56;68
080;004;098;001;01;407;168;239
080;004;098;002;01;184;67;117
080;004;098;003;01;250;113;137
080;004;098;004;01;263;116;147
080;004;098;005;01;230;99;131
080;004;098;006;01;130;52;78
080;004;098;007;01;163;73;90
080;004;098;008;01;119;43;76
080;004;098;009;01;103;49;54
080;004;098;010;01;130;55;75
080;004;098;011;01;251;117;134
080;004;098;012;01;80;40;40
080;004;098;013;01;200;135;65
080;004;098;014;01;230;105;125
080;004;098;015;01;22;11;11
080;005;001;001;01;352;187;165
080;005;001;001;02;352;185;167
080;005;001;001;03;352;179;173
080;005;001;001;04;348;189;159
080;005;001;002;01;424;263;161
080;005;001;002;02;424;252;172
080;005;001;002;03;424;219;205
080;005;001;003;01;376;209;167
080;005;001;003;02;368;204;164
080;005;001;003;03;368;196;172
080;005;001;003;04;368;211;157
080;005;001;004;01;417;223;194
080;005;001;004;02;416;224;192
080;005;001;004;03;416;208;208
080;005;001;004;04;416;226;190
080;005;001;005;01;432;218;214
080;005;001;005;02;432;230;202
080;005;001;005;03;429;230;199
080;005;001;005;04;424;228;196
080;005;001;005;05;424;182;242
080;005;001;005;06;424;192;232
080;005;001;005;07;424;225;199
080;005;001;006;01;440;229;211
080;005;001;006;02;437;225;212
080;005;001;006;03;432;222;210
080;005;001;006;04;432;216;216
080;005;001;006;05;432;209;223
080;005;001;006;06;432;212;220
080;005;001;006;07;432;227;205
080;005;001;006;08;432;200;232
080;005;001;006;09;432;172;260
080;005;001;006;10;432;217;215
080;005;001;006;11;432;219;213
080;005;001;006;12;432;235;197
080;005;001;006;13;432;226;206
080;005;001;006;14;432;220;212
080;005;001;006;15;432;233;199
080;005;001;007;01;432;223;209
080;005;001;007;02;432;188;244
080;005;001;007;03;432;214;218
080;005;001;007;04;432;228;204
080;005;001;007;05;428;230;198
080;005;001;007;06;424;213;211
080;005;001;007;07;424;204;220
080;005;001;007;08;424;218;206
080;005;001;008;01;408;198;210
080;005;001;008;02;408;214;194
080;005;001;008;03;408;196;212
080;005;001;008;04;407;224;183
080;005;001;008;05;400;198;202
080;005;001;009;01;416;265;151
080;005;001;009;02;416;195;221
080;005;001;009;03;410;254;156
080;005;001;009;04;408;231;177
080;005;001;009;05;408;230;178
080;005;001;009;06;408;240;168
080;005;001;009;07;408;230;178
080;005;001;009;08;408;230;178
080;005;001;009;09;408;229;179
080;005;001;010;01;424;211;213
080;005;001;010;02;424;201;223
080;005;001;010;03;424;215;209
080;005;001;010;04;417;219;198
080;005;001;010;05;416;214;202
080;005;001;010;06;416;218;198
080;005;001;010;07;416;219;197
080;005;001;010;08;416;213;203
080;005;001;010;09;416;241;175
080;005;001;011;01;432;210;222
080;005;001;011;02;432;239;193
080;005;001;011;03;432;235;197
080;005;001;011;04;432;247;185
080;005;001;011;05;428;214;214
080;005;001;011;06;424;223;201
080;005;001;012;01;424;216;208
080;005;001;012;02;424;220;204
080;005;001;012;03;424;223;201
080;005;001;012;04;424;224;200
080;005;001;012;05;424;232;192
080;005;001;012;06;424;223;201
080;005;001;012;07;424;223;201
080;005;001;012;08;424;229;195
080;005;001;012;09;424;212;212
080;005;001;012;10;421;199;222
080;005;001;012;11;416;197;219
080;005;001;012;12;416;217;199
080;005;001;012;13;416;210;206
080;005;001;013;01;440;232;208
080;005;001;013;02;440;237;203
080;005;001;013;03;440;204;236
080;005;001;013;04;440;192;248
080;005;001;013;05;440;223;217
080;005;001;013;06;440;192;248
080;005;001;013;07;438;216;222
080;005;001;014;01;440;233;207
080;005;001;014;02;440;236;204
080;005;001;014;03;440;213;227
080;005;001;014;04;440;228;212
080;005;001;014;05;440;230;210
080;005;001;014;06;440;216;224
080;005;001;014;07;440;218;222
080;005;001;014;08;440;206;234
080;005;001;014;09;440;200;240
080;005;001;014;10;440;238;202
080;005;001;014;11;440;234;206
080;005;001;014;12;440;227;213
080;005;001;014;13;434;202;232
080;005;001;014;14;432;223;209
080;005;001;015;01;432;208;224
080;005;001;015;02;432;217;215
080;005;001;015;03;432;215;217
080;005;001;015;04;432;217;215
080;005;001;015;05;432;196;236
080;005;001;015;06;432;170;262
080;005;001;015;07;432;210;222
080;005;001;015;08;428;194;234
080;005;001;015;09;424;217;207
080;005;001;015;10;424;227;197
080;005;001;015;11;424;199;225
080;005;001;016;01;427;215;212
080;005;001;016;02;424;220;204
080;005;001;016;03;424;248;176
080;005;001;017;01;432;246;186
080;005;001;017;02;428;213;215
080;005;001;017;03;424;207;217
080;005;001;017;04;424;206;218
080;005;001;017;05;424;220;204
080;005;001;018;01;410;212;198
080;005;001;018;02;408;209;199
080;005;001;018;03;408;209;199
080;005;001;018;04;408;206;202
080;005;001;018;05;408;202;206
080;005;001;018;06;408;193;215
080;005;001;018;07;408;191;217
080;005;001;018;08;408;228;180
080;005;001;018;09;408;183;225
080;005;001;019;01;381;195;186
080;005;001;019;02;376;191;185
080;005;001;019;03;376;213;163
080;005;001;019;04;376;189;187
080;005;001;019;05;376;180;196
080;005;001;020;01;424;229;195
080;005;001;020;02;424;192;232
080;005;001;020;03;424;206;218
080;005;001;020;04;417;214;203
080;005;001;020;05;416;210;206
080;005;001;020;06;416;217;199
080;005;001;020;07;416;198;218
080;005;001;020;08;416;214;202
080;005;001;020;09;416;240;176
080;005;001;020;10;416;216;200
080;005;001;020;11;416;185;231
080;005;001;020;12;416;204;212
080;005;001;020;13;416;221;195
080;005;001;021;01;384;199;185
080;005;001;021;02;384;197;187
080;005;001;021;03;384;213;171
080;005;001;021;04;379;188;191
080;005;001;021;05;376;198;178
080;005;001;022;01;432;211;221
080;005;001;022;02;432;218;214
080;005;001;022;03;432;248;184
080;005;001;022;04;428;199;229
080;005;001;022;05;424;227;197
080;005;001;023;01;432;208;224
080;005;001;023;02;427;181;246
080;005;001;023;03;424;187;237
080;005;001;023;04;424;232;192
080;005;001;023;05;424;192;232
080;005;001;023;06;424;238;186
080;005;001;023;07;424;186;238
080;005;001;023;08;424;220;204
080;005;001;023;09;424;227;197
080;005;001;023;10;424;161;263
080;005;001;024;01;384;203;181
080;005;001;024;02;384;217;167
080;005;001;024;03;384;221;163
080;005;001;024;04;381;214;167
080;005;001;024;05;376;179;197
080;005;001;024;06;376;200;176
080;005;001;025;01;450;246;204
080;005;001;025;02;449;233;216
080;005;001;025;03;448;227;221
080;005;001;025;04;448;245;203
080;005;001;026;01;440;200;240
080;005;001;026;02;432;231;201
080;005;001;026;03;432;201;231
080;005;001;026;04;432;233;199
080;005;001;026;05;432;207;225
080;005;001;026;06;432;210;222
080;005;001;027;01;416;193;223
080;005;001;027;02;416;180;236
080;005;001;027;03;416;194;222
080;005;001;027;04;414;201;213
080;005;001;027;05;408;185;223
080;005;001;027;06;408;170;238
080;005;001;027;07;408;178;230
080;005;001;027;08;408;188;220
080;005;001;028;01;416;249;167
080;005;001;028;02;412;195;217
080;005;001;028;03;408;224;184
080;005;001;028;04;408;207;201
080;005;001;028;05;408;206;202
080;005;001;028;06;408;228;180
080;005;001;028;07;408;193;215
080;005;001;028;08;408;213;195
080;005;001;029;01;432;230;202
080;005;001;029;02;432;234;198
080;005;001;029;03;432;232;200
080;005;001;029;04;432;195;237
080;005;001;029;05;432;178;254
080;005;001;029;06;432;237;195
080;005;001;029;07;432;222;210
080;005;001;029;08;432;218;214
080;005;001;029;09;432;221;211
080;005;001;029;10;432;203;229
080;005;001;029;11;432;197;235
080;005;001;029;12;432;249;183
080;005;001;029;13;432;228;204
080;005;001;029;14;432;251;181
080;005;001;029;15;432;224;208
080;005;001;029;16;428;165;263
080;005;001;029;17;424;227;197
080;005;001;029;18;424;254;170
080;005;001;029;19;424;198;226
080;005;001;030;01;432;219;213
080;005;001;030;02;425;217;208
080;005;001;030;03;424;225;199
080;005;001;030;04;424;217;207
080;005;001;031;01;416;226;190
080;005;001;031;02;416;229;187
080;005;001;031;03;416;225;191
080;005;001;031;04;412;213;199
080;005;001;031;05;408;231;177
080;005;001;031;06;408;217;191
080;005;001;032;01;416;225;191
080;005;001;032;02;416;199;217
080;005;001;032;03;416;231;185
080;005;001;032;04;416;231;185
080;005;001;032;05;416;244;172
080;005;001;032;06;416;199;217
080;005;001;032;07;416;236;180
080;005;001;032;08;416;231;185
080;005;001;032;09;410;220;190
080;005;001;032;10;408;227;181
080;005;001;033;01;368;219;149
080;005;001;033;02;368;222;146
080;005;001;033;03;368;201;167
080;005;001;034;01;312;173;139
080;005;001;034;02;312;176;136
080;005;001;034;03;307;153;154
080;005;001;035;01;320;195;125
080;005;001;035;02;312;152;160
080;005;001;036;01;448;243;205
080;005;001;036;02;447;218;229
080;005;001;036;03;440;220;220
080;005;001;037;01;384;248;136
080;005;001;037;02;384;170;214
080;005;001;037;03;384;171;213
080;005;001;037;04;384;181;203
080;005;001;037;05;380;199;181
080;005;001;037;06;376;208;168
080;005;001;038;01;304;145;159
080;005;001;038;02;304;146;158
080;005;001;038;03;303;168;135
080;005;001;039;01;344;194;150
080;005;001;039;02;344;150;194
080;005;001;039;03;338;155;183
080;005;001;040;01;264;154;110
080;005;001;040;02;260;126;134
080;005;001;041;01;305;174;131
080;005;001;041;02;304;132;172
080;005;001;041;03;304;149;155
080;005;001;042;01;387;223;164
080;005;001;042;02;384;232;152
080;005;001;042;03;384;207;177
080;005;001;043;01;408;223;185
080;005;001;043;02;404;239;165
080;005;001;043;03;400;217;183
080;005;001;043;04;400;225;175
080;005;001;043;05;400;156;244
080;005;001;043;06;400;227;173
080;005;001;043;07;400;206;194
080;005;001;044;01;416;243;173
080;005;001;044;02;410;231;179
080;005;001;045;01;260;162;98
080;005;001;046;01;376;209;167
080;005;001;047;01;383;243;140
080;005;001;048;01;378;208;170
080;005;001;049;01;389;187;202
080;005;001;050;01;400;195;205
080;005;001;050;02;398;192;206
080;005;001;050;03;392;196;196
080;005;001;050;04;392;215;177
080;005;001;050;05;392;208;184
080;005;001;050;06;392;222;170
080;005;001;051;01;416;250;166
080;005;001;051;02;416;224;192
080;005;001;051;03;416;236;180
080;005;001;051;04;416;234;182
080;005;001;051;05;416;229;187
080;005;001;051;06;416;227;189
080;005;001;051;07;416;218;198
080;005;001;051;08;416;210;206
080;005;001;051;09;416;241;175
080;005;001;051;10;416;239;177
080;005;001;051;11;409;215;194
080;005;001;051;12;408;249;159
080;005;001;052;01;424;219;205
080;005;001;052;02;424;248;176
080;005;001;052;03;421;239;182
080;005;001;052;04;416;224;192
080;005;001;053;01;392;193;199
080;005;001;053;02;390;198;192
080;005;001;053;03;384;192;192
080;005;001;053;04;384;185;199
080;005;001;054;01;392;191;201
080;005;001;054;02;392;174;218
080;005;001;054;03;391;171;220
080;005;001;055;01;374;227;147
080;005;001;055;02;368;197;171
080;005;001;056;01;272;135;137
080;005;001;056;02;271;134;137
080;005;001;057;01;368;159;209
080;005;001;057;02;366;174;192
080;005;001;057;03;360;183;177
080;005;001;057;04;360;170;190
080;005;001;058;01;408;222;186
080;005;001;058;02;408;212;196
080;005;001;058;03;407;232;175
080;005;001;058;04;400;230;170
080;005;001;059;01;322;159;163
080;005;001;060;01;416;206;210
080;005;001;060;02;416;210;206
080;005;001;060;03;416;203;213
080;005;001;060;04;416;226;190
080;005;001;060;05;416;219;197
080;005;001;060;06;410;197;213
080;005;001;061;01;416;218;198
080;005;001;061;02;416;211;205
080;005;001;061;03;416;190;226
080;005;001;061;04;416;199;217
080;005;001;061;05;416;202;214
080;005;001;061;06;412;196;216
080;005;001;062;01;392;220;172
080;005;001;062;02;392;209;183
080;005;001;062;03;389;212;177
080;005;001;063;01;388;195;193
080;005;001;063;02;384;193;191
080;005;001;063;03;384;224;160
080;005;001;063;04;384;162;222
080;005;001;063;05;384;207;177
080;005;001;064;01;310;148;162
080;005;001;064;02;304;134;170
080;005;001;065;01;271;118;153
080;005;001;065;02;264;105;159
080;005;001;066;01;320;159;161
080;005;001;066;02;317;164;153
080;005;001;066;03;312;167;145
080;005;001;067;01;166;73;93
080;005;001;068;01;269;145;124
080;005;001;069;01;358;162;196
080;005;001;070;01;342;182;160
080;005;001;071;01;323;139;184
080;005;001;071;02;320;131;189
080;005;001;072;01;303;167;136
080;005;001;072;02;296;144;152
080;005;001;073;01;383;226;157
080;005;001;074;01;211;105;106
080;005;001;075;01;380;182;198
080;005;001;076;01;315;170;145
080;005;098;001;01;345;177;168
080;005;098;001;02;344;146;198
080;005;098;001;03;344;147;197
080;005;098;002;01;300;141;159
080;005;098;002;02;296;139;157
080;005;098;003;01;374;150;224
080;005;098;003;02;368;176;192
080;005;098;004;01;328;173;155
080;005;098;004;02;325;146;179
080;005;098;005;01;344;168;176
080;005;098;006;01;368;173;195
080;005;098;006;02;367;166;201
080;005;098;006;03;360;196;164
080;005;098;007;01;295;146;149
080;005;098;008;01;285;135;150
080;005;098;008;02;280;140;140
080;005;098;009;01;312;134;178
080;005;098;009;02;304;120;184
080;005;098;010;01;420;168;252
080;005;098;011;01;352;149;203
080;005;098;011;02;349;127;222
080;005;098;012;01;406;194;212
080;005;098;013;01;272;122;150
080;005;098;013;02;267;115;152
080;005;098;014;01;162;62;100
080;005;098;015;01;263;116;147
080;005;098;016;01;272;130;142
080;005;098;017;01;243;120;123
080;005;098;018;01;198;91;107
080;005;098;019;01;372;174;198
080;005;098;020;01;330;153;177
080;005;098;021;01;177;94;83
080;005;098;022;01;189;99;90
080;005;098;023;01;442;200;242
080;005;098;024;01;306;167;139
080;005;098;025;01;432;169;263
080;005;098;025;02;430;155;275
080;005;098;027;01;287;140;147
080;005;098;028;01;161;70;91
080;005;098;029;01;259;107;152
080;005;098;030;01;424;213;211
080;005;098;030;02;424;206;218
080;005;098;030;03;421;212;209
080;005;098;030;04;416;213;203
080;005;098;031;01;238;125;113
080;005;098;032;01;329;149;180
080;005;098;032;02;328;131;197
080;005;098;033;01;264;108;156
080;005;098;033;02;261;105;156
080;005;098;034;01;333;134;199
080;007;001;001;01;328;172;156
080;007;001;001;02;325;158;167
080;007;001;002;01;357;184;173
080;007;001;002;02;352;145;207
080;007;001;003;01;340;176;164
080;007;001;003;02;336;165;171
080;007;001;004;01;336;174;162
080;007;001;004;02;334;150;184
080;007;001;005;01;352;177;175
080;007;001;005;02;352;198;154
080;007;001;005;03;348;176;172
080;007;001;005;04;344;172;172
080;007;001;006;01;449;233;216
080;007;001;006;02;448;206;242
080;007;001;007;01;272;143;129
080;007;001;007;02;264;116;148
080;007;001;008;01;237;117;120
080;007;001;009;01;240;118;122
080;007;001;009;02;235;121;114
080;007;001;010;01;250;106;144
080;007;001;011;01;320;138;182
080;007;001;011;02;320;137;183
080;007;001;012;01;380;173;207
080;007;001;012;02;376;167;209
080;007;001;013;01;336;166;170
080;007;001;013;02;331;122;209
080;007;001;013;03;328;132;196
080;007;001;014;01;150;68;82
080;007;001;015;01;415;200;215
080;007;001;016;01;136;62;74
080;007;001;017;01;282;129;153
080;007;001;018;01;324;138;186
080;007;001;019;01;291;115;176
080;007;001;020;01;242;111;131
080;007;001;021;01;205;91;114
080;007;001;022;01;362;168;194
080;007;001;023;01;118;56;62
080;007;098;001;01;125;62;63
080;007;098;002;01;243;100;143
080;007;098;002;02;240;106;134
080;007;098;003;01;250;115;135
080;007;098;004;01;208;115;93
080;007;098;005;01;368;185;183
080;007;098;005;02;363;162;201
080;007;098;006;01;154;69;85
080;007;098;007;01;263;113;150
080;007;098;008;01;188;91;97
080;007;098;009;01;219;109;110
080;007;098;010;01;42;18;24
080;008;001;001;01;435;214;221
080;008;001;001;02;432;210;222
080;008;001;002;01;304;149;155
080;008;001;002;02;304;159;145
080;008;001;002;03;303;153;150
080;008;001;003;01;376;188;188
080;008;001;003;02;368;190;178
080;008;001;004;01;407;206;201
080;008;001;005;01;331;160;171
080;008;001;006;01;212;106;106
080;008;001;007;01;175;89;86
080;008;001;008;01;170;89;81
080;008;098;001;01;352;168;184
080;008;098;001;02;352;173;179
080;008;098;001;03;352;166;186
080;008;098;001;04;347;173;174
080;008;098;002;01;294;127;167
080;008;098;003;01;100;53;47
080;008;098;004;01;307;158;149
080;008;098;004;02;304;152;152
080;008;098;005;01;272;153;119
080;008;098;005;02;271;128;143
080;008;098;006;01;336;167;169
080;008;098;006;02;336;168;168
080;008;098;006;03;330;171;159
080;008;098;007;01;264;134;130
080;008;098;007;02;263;124;139
080;008;098;008;01;364;177;187
080;008;098;009;01;342;162;180
080;008;098;010;01;316;149;167
080;008;098;010;02;312;162;150
080;008;098;010;03;312;169;143
080;008;098;011;01;361;200;161
080;008;098;012;01;243;122;121
080;008;098;013;01;128;71;57
080;008;098;014;01;157;77;80
080;008;098;015;01;239;128;111
080;008;098;016;01;192;94;98
080;008;098;017;01;324;166;158
080;008;098;018;01;177;77;100
080;008;098;019;01;113;56;57
080;008;098;020;01;122;63;59
080;010;001;001;01;392;180;212
080;010;001;001;02;389;199;190
080;010;001;001;03;384;177;207
080;010;001;001;04;384;191;193
080;010;001;002;01;416;208;208
080;010;001;002;02;415;209;206
080;010;001;002;03;408;188;220
080;010;001;003;01;435;242;193
080;010;001;003;02;432;239;193
080;010;001;004;01;248;126;122
080;010;001;005;01;210;113;97
080;010;098;001;01;243;119;124
080;010;098;002;01;364;202;162
080;010;098;002;02;360;146;214
080;010;098;003;01;446;221;225
080;010;098;004;01;360;165;195
080;010;098;004;02;360;182;178
080;010;098;005;01;323;172;151
080;010;098;005;02;320;141;179
080;010;098;006;01;380;197;183
080;010;098;007;01;352;164;188
080;010;098;007;02;352;196;156
080;010;098;007;03;346;149;197
080;010;098;008;01;344;182;162
080;010;098;008;02;344;178;166
080;010;098;008;03;344;178;166
080;010;098;008;04;344;178;166
080;010;098;009;01;76;47;29
080;010;098;010;01;234;135;99
080;010;098;011;01;151;74;77
080;010;098;012;01;210;103;107
080;011;001;001;01;401;182;219
080;011;001;001;02;400;176;224
080;011;001;001;03;400;183;217
080;011;001;001;04;400;173;227
080;011;001;001;05;400;145;255
080;011;001;002;01;351;176;175
080;011;001;002;02;344;172;172
080;011;001;002;03;344;177;167
080;011;001;002;04;344;146;198
080;011;001;003;01;416;190;226
080;011;001;003;02;410;162;248
080;011;001;003;03;408;149;259
080;011;001;004;01;358;171;187
080;011;001;005;01;264;125;139
080;011;001;005;02;260;120;140
080;011;001;006;01;248;118;130
080;011;001;006;02;245;101;144
080;011;001;007;01;368;221;147
080;011;001;007;02;365;135;230
080;011;001;007;03;360;197;163
080;011;001;008;01;248;130;118
080;011;001;008;02;245;109;136
080;011;001;009;01;273;135;138
080;011;001;010;01;403;198;205
080;011;001;011;01;448;214;234
080;011;001;015;01;424;203;221
080;011;001;015;02;417;187;230
080;011;098;001;01;358;183;175
080;011;098;001;02;352;137;215
080;011;098;003;01;272;131;141
080;011;098;003;02;271;116;155
080;011;098;004;01;193;91;102
080;011;098;005;01;98;45;53
080;011;098;006;01;347;138;209
080;011;098;007;01;171;84;87
080;013;098;001;01;352;176;176
080;013;098;001;02;348;170;178
080;013;098;001;03;344;130;214
080;013;098;002;01;362;168;194
080;013;098;003;01;272;107;165
080;013;098;004;01;328;172;156
080;013;098;004;02;325;105;220
080;013;098;005;01;439;190;249
080;013;098;006;01;172;67;105
080;014;098;001;01;419;194;225
080;014;098;002;01;380;205;175
080;014;098;003;01;312;144;168
080;014;098;003;02;309;147;162
080;014;098;003;03;304;144;160
080;014;098;004;01;386;196;190
080;014;098;004;02;384;214;170
080;014;098;005;01;400;218;182
080;014;098;005;02;396;226;170
080;014;098;006;01;352;181;171
080;014;098;006;02;349;173;176
080;014;098;006;03;344;166;178
080;014;098;006;04;344;150;194
080;014;098;007;01;422;230;192
080;014;098;008;01;337;175;162
080;014;098;009;01;246;148;98
080;014;098;010;01;228;112;116
080;014;098;011;01;155;83;72
080;014;098;012;01;248;134;114
080;014;098;012;02;248;139;109
080;014;098;013;01;386;201;185
080;014;098;014;01;169;82;87
080;014;098;015;01;127;71;56
080;017;098;001;01;425;227;198
080;017;098;001;02;424;213;211
080;017;098;001;03;424;205;219
080;017;098;001;04;424;218;206
080;017;098;003;01;336;179;157
080;017;098;003;02;335;182;153
080;017;098;004;01;365;195;170
080;017;098;005;01;416;202;214
080;017;098;005;02;412;184;228
080;017;098;006;01;287;174;113
080;017;098;006;02;280;136;144
080;017;098;007;01;272;132;140
080;017;098;007;02;266;134;132
080;017;098;008;01;274;169;105
080;017;098;008;02;272;148;124
080;017;098;009;01;363;199;164
080;017;098;010;01;204;123;81
080;017;098;011;01;360;212;148
080;017;098;012;01;295;160;135
080;017;098;013;01;153;85;68
080;017;098;014;01;213;125;88
080;017;098;015;01;206;109;97
080;017;098;016;01;117;63;54
080;017;098;017;01;195;99;96
080;018;098;001;01;352;185;167
080;018;098;001;02;352;156;196
080;018;098;001;03;352;165;187
080;018;098;001;04;348;170;178
080;018;098;002;01;240;110;130
080;018;098;002;02;238;105;133
080;018;098;003;01;396;187;209
080;018;098;004;01;240;117;123
080;018;098;004;02;235;115;120
080;018;098;005;01;175;76;99
080;019;098;001;01;438;201;237
080;019;098;002;01;398;190;208
080;019;098;003;01;440;220;220
080;019;098;003;02;440;201;239
080;019;098;003;03;435;210;225
080;019;098;004;01;400;195;205
080;019;098;004;02;399;194;205
080;019;098;006;01;353;170;183
080;019;098;007;01;328;154;174
080;019;098;007;02;322;149;173
080;019;098;008;01;390;207;183
080;019;098;008;02;384;196;188
080;019;098;009;01;164;87;77
080;019;098;010;01;265;123;142
080;019;098;012;01;267;124;143
080;020;098;001;01;418;192;226
080;020;098;001;02;416;172;244
080;020;098;002;01;424;201;223
080;020;098;002;02;424;188;236
080;020;098;002;03;424;171;253
080;020;098;002;04;424;195;229
080;020;098;002;05;424;186;238
080;020;098;002;06;416;159;257
080;020;098;004;01;232;113;119
080;020;098;004;02;225;82;143
080;020;098;005;01;240;108;132
080;020;098;005;02;235;97;138
080;020;098;006;01;248;107;141
080;020;098;007;01;328;152;176
080;020;098;008;01;393;190;203
080;020;098;010;01;281;123;158
080;020;098;013;01;366;178;188
080;020;098;014;01;288;129;159
080;020;098;015;01;142;63;79
080;020;098;016;01;327;157;170
080;020;098;017;01;115;55;60
080;020;098;018;01;219;95;124
080;021;098;001;01;63;28;35
080;021;098;002;01;242;115;127
080;021;098;002;02;240;121;119
080;021;098;003;01;368;191;177
080;021;098;003;02;362;180;182
080;021;098;004;01;268;135;133
080;021;098;005;01;309;160;149
080;021;098;005;02;304;176;128
080;021;098;006;01;336;155;181
080;021;098;006;02;333;155;178
080;021;098;007;01;384;200;184
080;021;098;007;02;383;199;184
080;022;098;001;01;416;205;211
080;022;098;001;02;408;188;220
080;022;098;002;01;287;128;159
080;022;098;003;01;336;153;183
080;022;098;003;02;328;155;173
080;022;098;004;01;368;156;212
080;022;098;004;02;360;173;187
080;022;098;004;03;360;135;225
080;022;098;005;01;322;144;178
080;023;098;001;01;392;203;189
080;023;098;001;02;390;196;194
080;023;098;001;03;384;199;185
080;023;098;002;01;278;127;151
080;023;098;003;01;128;65;63
080;023;098;004;01;341;158;183
080;023;098;005;01;225;119;106
080;023;098;006;01;84;43;41
080;023;098;007;01;121;72;49
080;023;098;008;01;108;68;40
081;009;001;001;01;392;206;186
081;009;001;001;02;392;232;160
081;009;001;001;03;388;181;207
081;009;001;002;01;376;198;178
081;009;001;002;02;376;198;178
081;009;001;002;03;376;179;197
081;009;001;002;04;376;208;168
081;009;001;002;05;376;193;183
081;009;001;002;06;371;200;171
081;009;001;003;01;422;192;230
081;009;001;003;02;416;183;233
081;009;001;003;03;416;205;211
081;009;001;004;01;376;188;188
081;009;001;004;02;369;180;189
081;009;001;004;03;368;191;177
081;009;001;004;04;368;185;183
081;009;001;005;01;312;189;123
081;009;001;005;02;309;165;144
081;009;001;006;01;194;92;102
081;009;001;007;01;299;137;162
081;009;001;008;01;383;184;199
081;009;001;009;01;414;210;204
081;009;001;009;02;408;171;237
081;009;001;010;01;281;134;147
081;009;001;010;02;280;117;163
081;009;001;011;01;300;141;159
081;009;001;011;02;296;111;185
081;009;001;012;01;377;201;176
081;009;001;012;02;376;182;194
081;009;001;013;01;393;177;216
081;009;001;014;01;344;190;154
081;009;001;014;02;343;148;195
081;009;001;015;01;424;202;222
081;009;001;015;02;419;205;214
081;009;001;015;03;416;219;197
081;009;001;015;04;416;182;234
081;009;001;015;05;416;202;214
081;009;001;015;06;416;222;194
081;009;001;015;07;416;153;263
081;009;001;016;01;268;118;150
081;009;001;016;02;264;124;140
081;009;001;017;01;256;122;134
081;009;001;017;02;248;107;141
081;009;001;018;01;399;182;217
081;009;001;019;01;336;171;165
081;009;001;019;02;331;136;195
081;009;001;020;01;250;122;128
081;009;001;021;01;424;202;222
081;009;001;022;01;170;77;93
081;009;001;023;01;414;204;210
081;009;001;024;01;210;100;110
081;009;098;001;01;286;149;137
081;009;098;001;02;280;113;167
081;009;098;002;01;440;223;217
081;009;098;002;02;439;168;271
081;009;098;003;01;215;97;118
081;009;098;004;01;124;56;68
081;009;098;010;01;409;157;252
081;009;098;011;01;189;74;115
081;010;098;001;01;191;76;115
081;010;098;002;01;365;181;184
081;010;098;002;02;360;150;210
081;010;098;002;03;360;140;220
081;010;098;003;01;304;135;169
081;010;098;003;02;304;147;157
081;010;098;003;03;300;125;175
081;010;098;004;01;72;33;39
081;010;098;005;01;344;161;183
081;010;098;007;01;246;112;134
081;010;098;008;01;132;54;78
081;010;098;009;01;169;65;104
081;010;098;010;01;296;133;163
081;010;098;010;02;291;123;168
081;010;098;011;01;138;56;82
081;010;098;012;01;159;72;87
081;010;098;013;01;325;146;179
081;011;098;001;01;121;48;73
081;011;098;002;01;407;168;239
081;011;098;003;01;217;88;129
081;011;098;004;01;441;238;203
081;011;098;004;02;440;207;233
081;011;098;004;03;440;174;266
081;011;098;005;01;385;152;233
081;017;098;001;01;304;147;157
081;017;098;001;02;303;133;170
081;017;098;001;03;296;132;164
081;017;098;002;01;320;159;161
081;017;098;002;02;314;126;188
081;017;098;003;01;203;71;132
081;017;098;004;01;327;175;152
081;017;098;004;02;320;142;178
081;017;098;004;03;320;144;176
081;017;098;005;01;375;162;213
082;001;001;001;01;392;223;169
082;001;001;001;02;392;218;174
082;001;001;001;03;385;198;187
082;001;001;001;04;384;211;173
082;001;001;002;01;381;209;172
082;001;001;002;02;376;212;164
082;001;001;002;03;376;220;156
082;001;001;003;01;450;246;204
082;001;001;003;02;450;240;210
082;001;001;003;03;450;227;223
082;001;001;003;04;448;224;224
082;001;001;003;05;448;222;226
082;001;001;004;01;384;213;171
082;001;001;005;01;297;153;144
082;001;001;006;01;161;88;73
082;001;001;007;01;282;157;125
082;001;001;008;01;149;71;78
082;001;001;009;01;283;142;141
082;001;001;010;01;320;183;137
082;001;001;011;01;289;155;134
082;001;001;012;01;424;268;156
082;001;001;012;02;424;255;169
082;001;001;012;03;416;269;147
082;001;001;013;01;352;192;160
082;001;001;013;02;352;196;156
082;001;001;013;03;352;201;151
082;001;001;013;04;348;196;152
082;001;001;014;01;146;69;77
082;001;001;015;01;79;38;41
082;001;001;016;01;169;86;83
082;001;098;001;01;334;201;133
082;001;098;002;01;138;73;65
082;001;098;003;01;345;193;152
082;001;098;003;02;344;207;137
082;001;098;004;01;187;105;82
082;001;098;005;01;416;240;176
082;001;098;005;02;416;214;202
082;001;098;005;03;416;244;172
082;001;098;005;04;412;253;159
082;001;098;006;01;312;172;140
082;001;098;006;02;312;189;123
082;001;098;006;03;310;172;138
082;001;098;007;01;215;115;100
082;001;098;008;01;232;142;90
082;001;098;008;02;230;138;92
082;001;098;009;01;383;251;132
082;001;098;010;01;319;194;125
082;001;098;011;01;217;122;95
082;001;098;012;01;296;206;90
082;001;098;013;01;266;136;130
082;001;098;014;01;238;138;100
082;001;098;015;01;230;139;91
082;001;098;016;01;297;186;111
082;001;098;017;01;256;155;101
082;001;098;017;02;256;158;98
082;001;098;018;01;446;264;182
082;001;098;019;01;241;142;99
082;001;098;019;02;240;147;93
082;001;098;020;01;331;211;120
082;001;098;021;01;264;160;104
082;001;098;021;02;257;169;88
082;001;098;022;01;151;95;56
082;001;098;023;01;131;88;43
082;001;098;024;01;126;68;58
082;001;098;025;01;307;170;137
082;001;098;026;01;291;172;119
082;001;098;027;01;60;31;29
082;001;098;028;01;188;120;68
082;001;098;029;01;272;160;112
082;001;098;029;02;270;153;117
082;001;098;030;01;376;212;164
082;001;098;031;01;126;78;48
082;001;098;032;01;349;187;162
082;001;098;033;01;363;201;162
082;001;098;034;01;386;192;194
082;001;098;034;02;384;212;172
082;001;098;034;03;384;202;182
082;001;098;035;01;245;148;97
082;001;098;036;01;81;47;34
082;001;098;037;01;416;235;181
082;001;098;038;01;272;163;109
082;001;098;038;02;268;167;101
082;001;098;039;01;274;160;114
082;001;098;040;01;182;105;77
082;001;098;041;01;80;52;28
082;001;098;042;01;141;100;41
082;001;098;047;01;252;160;92
082;001;098;048;01;89;60;29
082;002;001;001;01;408;245;163
082;002;001;001;02;408;237;171
082;002;001;001;03;408;249;159
082;002;001;001;04;408;232;176
082;002;001;001;05;407;243;164
082;002;001;002;01;398;279;119
082;002;001;002;02;392;250;142
082;002;001;002;03;392;246;146
082;002;001;003;01;344;200;144
082;002;001;003;02;344;191;153
082;002;001;003;03;344;175;169
082;002;001;003;04;342;178;164
082;002;001;004;01;407;232;175
082;002;001;004;02;400;215;185
082;002;001;004;03;400;221;179
082;002;001;004;04;400;219;181
082;002;001;005;01;395;221;174
082;002;001;005;02;392;204;188
082;002;001;005;03;392;194;198
082;002;001;005;04;392;197;195
082;002;001;006;01;448;246;202
082;002;001;006;02;448;229;219
082;002;001;006;03;448;235;213
082;002;001;006;04;448;246;202
082;002;001;006;05;446;234;212
082;002;001;006;06;440;238;202
082;002;001;006;07;440;246;194
082;002;001;007;01;384;294;90
082;002;001;007;02;377;294;83
082;002;001;007;03;376;284;92
082;002;001;008;01;392;210;182
082;002;001;008;02;392;225;167
082;002;001;008;03;392;182;210
082;002;001;008;04;392;215;177
082;002;001;008;05;387;212;175
082;002;001;009;01;448;226;222
082;002;001;009;02;448;215;233
082;002;001;009;03;448;234;214
082;002;001;009;04;448;228;220
082;002;001;009;05;448;223;225
082;002;001;010;01;371;193;178
082;002;001;010;02;368;167;201
082;002;001;010;03;368;191;177
082;002;001;010;04;368;187;181
082;002;001;010;05;368;171;197
082;002;001;011;01;229;134;95
082;002;001;012;01;432;209;223
082;002;001;012;02;432;264;168
082;002;001;012;03;432;237;195
082;002;001;012;04;432;228;204
082;002;001;012;05;432;211;221
082;002;001;012;06;432;238;194
082;002;001;012;07;432;233;199
082;002;001;012;08;424;218;206
082;002;001;012;09;424;223;201
082;002;001;012;10;424;221;203
082;002;001;012;11;424;239;185
082;002;001;012;12;424;248;176
082;002;001;012;13;424;228;196
082;002;001;013;01;440;217;223
082;002;001;013;02;437;214;223
082;002;001;013;03;432;240;192
082;002;001;013;04;432;222;210
082;002;001;013;05;432;252;180
082;002;001;014;01;408;203;205
082;002;001;014;02;406;205;201
082;002;001;014;03;400;203;197
082;002;001;014;04;400;200;200
082;002;001;014;05;400;219;181
082;002;001;015;01;375;231;144
082;002;001;015;02;368;219;149
082;002;001;015;03;368;227;141
082;002;001;016;01;432;209;223
082;002;001;016;02;432;239;193
082;002;001;016;03;432;199;233
082;002;001;016;04;428;215;213
082;002;001;016;05;424;215;209
082;002;001;016;06;424;199;225
082;002;001;016;07;424;214;210
082;002;001;016;08;424;237;187
082;002;001;016;09;424;198;226
082;002;001;016;10;424;216;208
082;002;001;017;01;408;235;173
082;002;001;017;02;408;230;178
082;002;001;017;03;407;219;188
082;002;001;017;04;400;216;184
082;002;001;017;05;400;191;209
082;002;001;017;06;400;203;197
082;002;001;017;07;400;225;175
082;002;001;017;08;400;216;184
082;002;001;018;01;384;190;194
082;002;001;018;02;384;193;191
082;002;001;018;03;377;186;191
082;002;001;018;04;376;193;183
082;002;001;018;05;376;200;176
082;002;001;019;01;200;111;89
082;002;001;020;01;145;96;49
082;002;001;021;01;278;143;135
082;002;001;021;02;272;155;117
082;002;001;022;01;311;163;148
082;002;001;023;01;264;159;105
082;002;001;024;01;230;128;102
082;002;001;024;02;224;125;99
082;002;001;025;01;235;118;117
082;002;001;026;01;227;131;96
082;002;001;027;01;293;187;106
082;002;001;027;02;288;182;106
082;002;001;028;01;256;150;106
082;002;001;028;02;248;158;90
082;002;001;029;01;365;197;168
082;002;001;030;01;416;234;182
082;002;001;030;02;414;231;183
082;002;001;030;03;408;223;185
082;002;001;030;04;408;225;183
082;002;001;030;05;408;224;184
082;002;001;030;06;408;232;176
082;002;001;030;07;408;238;170
082;002;001;030;08;408;214;194
082;002;001;031;01;360;207;153
082;002;001;031;02;360;183;177
082;002;001;031;03;360;177;183
082;002;001;031;04;360;199;161
082;002;001;032;01;403;233;170
082;002;001;032;02;400;230;170
082;002;001;032;03;400;234;166
082;002;001;032;04;400;230;170
082;002;001;033;01;416;244;172
082;002;001;033;02;416;244;172
082;002;001;033;03;416;217;199
082;002;001;033;04;416;239;177
082;002;001;033;05;411;241;170
082;002;001;034;01;344;177;167
082;002;001;034;02;344;170;174
082;002;001;034;03;336;166;170
082;002;001;034;04;336;168;168
082;002;001;035;01;408;199;209
082;002;001;035;02;408;215;193
082;002;001;035;03;408;243;165
082;002;001;035;04;408;203;205
082;002;001;035;05;408;219;189
082;002;001;035;06;402;212;190
082;002;001;035;07;400;175;225
082;002;001;035;08;400;211;189
082;002;001;035;09;400;223;177
082;002;001;036;01;424;219;205
082;002;001;036;02;424;210;214
082;002;001;036;03;421;223;198
082;002;001;036;04;416;231;185
082;002;001;036;05;416;199;217
082;002;001;037;01;392;200;192
082;002;001;037;02;392;190;202
082;002;001;037;03;386;179;207
082;002;001;037;04;384;184;200
082;002;001;038;01;404;213;191
082;002;001;038;02;400;212;188
082;002;001;038;03;400;217;183
082;002;001;038;04;400;216;184
082;002;001;039;01;424;258;166
082;002;001;039;02;424;237;187
082;002;001;039;03;424;235;189
082;002;001;039;04;424;233;191
082;002;001;039;05;421;238;183
082;002;001;040;01;360;260;100
082;002;001;040;02;360;252;108
082;002;001;040;03;360;254;106
082;002;001;040;04;359;237;122
082;002;001;041;01;360;205;155
082;002;001;041;02;360;182;178
082;002;001;041;03;360;185;175
082;002;001;041;04;352;190;162
082;002;001;042;01;432;224;208
082;002;001;042;02;432;218;214
082;002;001;042;03;425;227;198
082;002;001;042;04;424;228;196
082;002;001;043;01;400;199;201
082;002;001;043;02;400;212;188
082;002;001;043;03;400;229;171
082;002;001;043;04;397;218;179
082;002;001;043;05;392;212;180
082;002;001;043;06;392;217;175
082;002;001;044;01;392;201;191
082;002;001;044;02;392;207;185
082;002;001;044;03;392;192;200
082;002;001;044;04;392;183;209
082;002;001;045;01;352;190;162
082;002;001;045;02;352;188;164
082;002;001;045;03;344;184;160
082;002;001;045;04;344;178;166
082;002;001;046;01;416;221;195
082;002;001;046;02;416;212;204
082;002;001;046;03;413;205;208
082;002;001;046;04;408;198;210
082;002;001;046;05;408;211;197
082;002;001;046;06;408;196;212
082;002;001;047;01;400;247;153
082;002;001;047;02;400;229;171
082;002;001;047;03;400;238;162
082;002;001;047;04;400;238;162
082;002;001;048;01;384;252;132
082;002;001;048;02;384;244;140
082;002;001;048;03;377;234;143
082;002;001;048;04;376;230;146
082;002;001;048;05;376;229;147
082;002;001;048;06;376;239;137
082;002;001;049;01;370;235;135
082;002;001;049;02;368;227;141
082;002;001;049;03;368;228;140
082;002;001;050;01;80;51;29
082;002;001;051;01;416;229;187
082;002;001;051;02;409;237;172
082;002;001;051;03;408;227;181
082;002;001;052;01;264;148;116
082;002;001;052;02;256;166;90
082;002;001;053;01;228;125;103
082;002;001;054;01;432;262;170
082;002;001;054;02;432;282;150
082;002;001;055;01;376;223;153
082;002;001;055;02;371;205;166
082;002;001;055;03;368;222;146
082;002;001;055;04;368;216;152
082;002;001;056;01;400;217;183
082;002;001;056;02;400;233;167
082;002;001;056;03;400;238;162
082;002;001;056;04;398;239;159
082;002;001;057;01;352;170;182
082;002;001;057;02;349;172;177
082;002;001;057;03;344;167;177
082;002;001;057;04;344;148;196
082;002;001;058;01;432;249;183
082;002;001;058;02;432;262;170
082;002;001;058;03;432;250;182
082;002;001;058;04;432;248;184
082;002;001;058;05;432;240;192
082;002;001;058;06;431;231;200
082;002;001;059;01;82;42;40
082;002;001;060;01;140;71;69
082;002;001;061;01;188;105;83
082;002;001;062;01;144;81;63
082;002;001;063;01;68;37;31
082;002;001;064;01;80;54;26
082;002;001;066;01;180;157;23
082;002;001;067;01;324;168;156
082;002;001;068;01;374;180;194
082;002;001;068;02;368;195;173
082;002;001;069;01;249;166;83
082;002;001;070;01;112;82;30
082;002;001;071;01;181;94;87
082;002;001;072;01;131;78;53
082;002;001;073;01;72;33;39
082;002;001;075;01;144;86;58
082;002;098;001;01;87;43;44
082;002;098;002;01;235;146;89
082;002;098;003;01;307;191;116
082;002;098;004;01;249;159;90
082;002;098;005;01;362;196;166
082;002;098;006;01;376;221;155
082;002;098;007;01;165;97;68
082;002;098;008;01;247;135;112
082;002;098;009;01;350;191;159
082;002;098;009;02;344;199;145
082;002;098;010;01;382;207;175
082;002;098;011;01;139;76;63
082;002;098;012;01;175;102;73
082;002;098;013;01;408;223;185
082;002;098;013;02;408;232;176
082;002;098;013;03;408;244;164
082;002;098;013;04;408;262;146
082;002;098;013;05;408;224;184
082;002;098;013;06;407;236;171
082;002;098;013;07;400;239;161
082;002;098;013;08;400;254;146
082;002;098;013;09;400;235;165
082;002;098;014;01;370;209;161
082;002;098;015;01;288;155;133
082;002;098;015;02;280;167;113
082;002;098;016;01;150;86;64
082;002;098;017;01;436;294;142
082;002;098;018;01;136;82;54
082;002;098;019;01;242;151;91
082;002;098;020;01;288;188;100
082;002;098;020;02;288;205;83
082;002;098;021;01;258;160;98
082;002;098;022;01;126;73;53
082;002;098;024;01;101;70;31
082;002;098;025;01;79;44;35
082;002;098;026;01;106;69;37
082;002;098;027;01;123;73;50
082;003;098;001;01;262;145;117
082;003;098;001;02;256;156;100
082;003;098;002;01;157;97;60
082;003;098;003;01;104;71;33
082;003;098;004;01;208;129;79
082;003;098;005;01;234;156;78
082;003;098;006;01;155;112;43
082;003;098;007;01;172;118;54
082;003;098;008;01;438;243;195
082;003;098;009;01;313;172;141
082;003;098;010;01;424;251;173
082;003;098;010;02;422;237;185
082;003;098;011;01;408;225;183
082;003;098;011;02;405;231;174
082;003;098;011;03;400;241;159
082;003;098;012;01;156;101;55
082;003;098;013;01;199;123;76
082;003;098;014;01;267;150;117
082;003;098;015;01;284;165;119
082;003;098;016;01;172;109;63
082;003;098;017;01;320;204;116
082;003;098;017;02;316;187;129
082;003;098;018;01;214;126;88
082;003;098;019;01;141;70;71
082;003;098;020;01;165;102;63
082;003;098;021;01;138;81;57
082;003;098;022;01;140;86;54
082;003;098;023;01;296;198;98
082;003;098;024;01;408;203;205
082;003;098;024;02;400;235;165
082;003;098;025;01;182;95;87
082;003;098;026;01;189;106;83
082;003;098;027;01;213;123;90
082;003;098;028;01;260;137;123
082;003;098;028;02;256;146;110
082;003;098;029;01;118;75;43
082;003;098;030;01;204;120;84
082;003;098;031;01;266;146;120
082;003;098;032;01;356;202;154
082;003;098;033;01;143;90;53
082;003;098;034;01;213;150;63
082;003;098;035;01;123;80;43
082;004;098;001;01;294;193;101
082;004;098;001;02;288;184;104
082;004;098;002;01;192;124;68
082;004;098;003;01;221;139;82
082;004;098;004;01;312;204;108
082;004;098;004;02;304;193;111
082;004;098;005;01;371;248;123
082;004;098;006;01;180;113;67
082;004;098;007;01;66;42;24
082;004;098;008;01;97;63;34
082;004;098;009;01;111;70;41
082;004;098;010;01;126;85;41
082;004;098;011;01;110;74;36
082;004;098;012;01;118;68;50
082;005;098;001;01;408;208;200
082;005;098;001;02;404;202;202
082;005;098;001;03;400;218;182
082;005;098;002;01;359;189;170
082;005;098;003;01;233;128;105
082;005;098;003;02;232;119;113
082;005;098;004;01;321;182;139
082;005;098;005;01;282;161;121
082;005;098;006;01;440;241;199
082;005;098;006;02;440;217;223
082;005;098;006;03;440;228;212
082;005;098;006;04;440;247;193
082;005;098;006;05;435;254;181
082;005;098;007;01;276;169;107
082;005;098;009;01;327;201;126
082;005;098;010;01;139;77;62
082;005;098;011;01;440;231;209
082;005;098;011;02;440;247;193
082;005;098;011;03;440;238;202
082;005;098;011;04;440;224;216
082;005;098;011;05;440;260;180
082;005;098;011;06;437;198;239
082;005;098;011;07;432;224;208
082;005;098;011;08;432;247;185
082;005;098;011;09;432;219;213
082;005;098;011;10;432;234;198
082;005;098;012;01;238;132;106
082;005;098;013;01;352;178;174
082;005;098;013;02;352;196;156
082;005;098;013;03;347;189;158
082;005;098;014;01;214;127;87
082;005;098;015;01;405;181;224
082;005;098;015;02;400;208;192
082;005;098;015;03;400;224;176
082;005;098;015;04;400;205;195
082;005;098;016;01;384;200;184
082;005;098;016;02;384;234;150
082;005;098;016;03;380;196;184
082;005;098;017;01;288;172;116
082;005;098;017;02;288;175;113
082;005;098;018;01;326;168;158
082;005;098;019;01;243;142;101
082;005;098;019;02;240;142;98
082;005;098;020;01;207;121;86
082;005;098;021;01;224;129;95
082;005;098;022;01;292;164;128
082;005;098;022;02;288;165;123
082;005;098;023;01;285;163;122
082;005;098;023;02;280;169;111
082;005;098;024;01;358;186;172
082;005;098;025;01;321;168;153
082;005;098;026;01;196;112;84
082;005;098;027;01;334;168;166
082;005;098;027;02;328;180;148
082;005;098;028;01;244;135;109
082;005;098;028;02;240;145;95
082;005;098;029;01;266;157;109
082;005;098;030;01;143;87;56
082;005;098;031;01;418;231;187
082;005;098;031;02;416;231;185
082;005;098;032;01;280;165;115
082;005;098;032;02;276;157;119
082;005;098;033;01;235;135;100
082;005;098;035;01;350;184;166
082;005;098;036;01;284;153;131
082;005;098;037;01;263;156;107
082;005;098;037;02;256;143;113
082;005;098;038;01;153;97;56
082;005;098;039;01;173;104;69
082;005;098;040;01;217;103;114
082;005;098;041;01;359;178;181
082;005;098;041;02;352;186;166
082;005;098;042;01;150;107;43
082;005;098;043;01;123;75;48
082;005;098;044;01;141;81;60
082;005;098;045;01;304;158;146
082;005;098;046;01;158;102;56
082;005;098;047;01;187;111;76
082;005;098;048;01;146;89;57
082;005;098;049;01;100;55;45
082;005;098;050;01;108;59;49
082;005;098;051;01;71;41;30
082;005;098;055;01;136;74;62
082;005;098;057;01;83;61;22
082;005;098;058;01;60;43;17
082;005;098;059;01;96;59;37
082;005;098;060;01;65;46;19
083;001;001;001;01;400;223;177
083;001;001;001;02;400;239;161
083;001;001;001;03;399;208;191
083;001;001;002;01;424;263;161
083;001;001;002;02;424;257;167
083;001;001;002;03;424;265;159
083;001;001;002;04;417;243;174
083;001;001;002;05;416;278;138
083;001;001;003;01;307;165;142
083;001;001;004;01;115;63;52
083;001;001;005;01;304;189;115
083;001;001;005;02;301;174;127
083;001;001;006;01;124;67;57
083;001;001;007;01;282;166;116
083;001;001;007;02;280;161;119
083;001;001;008;01;376;233;143
083;001;001;008;02;376;226;150
083;001;001;008;03;376;251;125
083;001;001;009;01;420;255;165
083;001;001;010;01;133;65;68
083;001;001;011;01;99;61;38
083;001;001;012;01;416;272;144
083;001;001;013;01;168;88;80
083;001;001;014;01;137;80;57
083;001;001;015;01;206;128;78
083;001;001;016;01;190;115;75
083;001;098;001;01;43;26;17
083;001;098;002;01;83;47;36
083;001;098;003;01;137;82;55
083;001;098;004;01;352;218;134
083;001;098;004;02;344;209;135
083;001;098;005;01;152;106;46
083;002;001;001;01;375;196;179
083;002;001;001;02;368;191;177
083;002;001;001;03;368;200;168
083;002;001;002;01;143;63;80
083;002;001;003;01;136;69;67
083;002;001;004;01;70;44;26
083;002;001;005;01;351;182;169
083;002;001;005;02;344;179;165
083;002;001;005;03;344;189;155
083;002;001;006;01;329;176;153
083;002;001;006;02;328;187;141
083;002;001;007;01;386;203;183
083;002;001;007;02;384;194;190
083;002;001;007;03;384;189;195
083;002;001;007;04;384;199;185
083;002;001;007;05;384;196;188
083;002;001;007;06;384;196;188
083;002;001;008;01;344;177;167
083;002;001;008;02;344;191;153
083;002;001;008;03;344;199;145
083;002;001;008;04;339;178;161
083;002;001;009;01;312;159;153
083;002;001;009;02;312;161;151
083;002;001;009;03;305;140;165
083;002;001;010;01;398;203;195
083;002;001;010;02;392;196;196
083;002;001;010;03;392;212;180
083;002;001;010;04;392;191;201
083;002;001;010;05;392;224;168
083;002;001;011;01;400;203;197
083;002;001;011;02;396;228;168
083;002;001;012;01;423;223;200
083;002;001;013;01;249;125;124
083;002;001;015;01;220;115;105
083;002;001;016;01;422;222;200
083;002;001;017;01;155;77;78
083;002;001;018;01;396;209;187
083;002;001;018;02;392;211;181
083;002;001;019;01;191;104;87
083;002;001;020;01;360;175;185
083;002;001;020;02;360;186;174
083;002;001;020;03;355;171;184
083;002;001;020;04;352;168;184
083;002;098;001;01;147;83;64
083;002;098;002;01;418;236;182
083;002;098;003;01;120;67;53
083;002;098;004;01;242;131;111
083;002;098;005;01;114;80;34
083;002;098;006;01;55;42;13
083;002;098;007;01;236;134;102
083;002;098;008;01;42;20;22
083;002;098;009;01;146;99;47
083;002;098;010;01;57;27;30
083;002;098;015;01;67;37;30
083;003;098;001;01;132;76;56
083;003;098;002;01;336;216;120
083;003;098;002;02;328;208;120
083;003;098;002;03;328;195;133
083;003;098;003;01;245;170;75
083;003;098;004;01;248;136;112
083;003;098;005;01;248;153;95
083;003;098;005;02;244;166;78
083;003;098;006;01;190;126;64
083;003;098;007;01;257;160;97
083;003;098;008;01;302;182;120
083;003;098;009;01;113;73;40
083;003;098;010;01;61;31;30
083;004;098;001;01;126;65;61
083;004;098;002;01;395;187;208
083;004;098;003;01;114;74;40
083;004;098;004;01;403;265;138
083;004;098;005;01;320;197;123
083;004;098;005;02;317;207;110
083;004;098;006;01;184;96;88
083;004;098;007;01;302;158;144
083;004;098;008;01;414;219;195
083;004;098;009;01;49;25;24
083;004;098;010;01;279;145;134
083;004;098;011;01;128;64;64
083;004;098;012;01;130;61;69
083;004;098;013;01;135;72;63
083;004;098;015;01;64;30;34
083;005;098;001;01;248;137;111
083;005;098;001;02;244;132;112
083;005;098;002;01;376;216;160
083;005;098;003;01;384;233;151
083;005;098;003;02;384;233;151
083;005;098;003;03;379;210;169
083;005;098;003;04;376;231;145
083;005;098;004;01;309;193;116
083;005;098;004;02;304;183;121
083;005;098;005;01;184;116;68
083;005;098;006;01;191;124;67
083;005;098;007;01;236;171;65
083;005;098;007;02;232;141;91
083;005;098;008;01;281;172;109
083;005;098;008;02;280;182;98
083;005;098;009;01;441;229;212
083;005;098;010;01;105;58;47
083;005;098;011;01;318;181;137
083;005;098;011;02;312;173;139
083;005;098;011;03;312;184;128
083;005;098;012;01;361;211;150
083;005;098;013;01;88;51;37
083;005;098;014;01;228;115;113
083;005;098;015;01;199;127;72
083;005;098;016;01;368;236;132
083;005;098;016;02;360;219;141
083;005;098;017;01;131;68;63
083;005;098;018;01;247;160;87
083;005;098;018;02;240;140;100
083;005;098;019;01;290;189;101
083;005;098;020;01;124;73;51
083;005;098;021;01;260;153;107
083;005;098;022;01;120;70;50
083;005;098;023;01;131;84;47
083;006;098;001;01;100;68;32
083;006;098;002;01;89;56;33
083;006;098;003;01;167;115;52
083;006;098;004;01;196;118;78
083;006;098;005;01;142;82;60
083;006;098;006;01;48;27;21
083;006;098;007;01;68;43;25
083;006;098;008;01;156;93;63
083;006;098;009;01;400;193;207
083;006;098;009;02;393;232;161
083;006;098;009;03;392;210;182
083;006;098;010;01;197;117;80
083;006;098;011;01;80;36;44
083;006;098;012;01;341;210;131
083;006;098;013;01;138;71;67
083;006;098;014;01;167;94;73
083;006;098;018;01;52;30;22
083;006;098;019;01;71;43;28
084;001;001;001;01;424;199;225
084;001;001;001;02;424;226;198
084;001;001;001;03;424;215;209
084;001;001;001;04;423;243;180
084;001;001;002;01;424;214;210
084;001;001;002;02;424;231;193
084;001;001;002;03;424;227;197
084;001;001;002;04;424;217;207
084;001;001;002;05;424;224;200
084;001;001;002;06;424;237;187
084;001;001;002;07;424;246;178
084;001;001;002;08;418;249;169
084;001;001;003;01;392;206;186
084;001;001;003;02;391;229;162
084;001;001;003;03;384;216;168
084;001;001;003;04;384;226;158
084;001;001;003;05;384;221;163
084;001;001;003;06;384;227;157
084;001;001;004;01;432;225;207
084;001;001;004;02;432;246;186
084;001;001;004;03;432;243;189
084;001;001;004;04;432;232;200
084;001;001;004;05;432;240;192
084;001;001;004;06;432;250;182
084;001;001;004;07;424;249;175
084;001;001;005;01;432;185;247
084;001;001;005;02;432;197;235
084;001;001;005;03;432;193;239
084;001;001;005;04;432;195;237
084;001;001;005;05;424;172;252
084;001;001;005;06;424;194;230
084;001;001;005;07;424;199;225
084;001;001;006;01;407;198;209
084;001;001;006;02;400;188;212
084;001;001;006;03;400;193;207
084;001;001;006;04;400;200;200
084;001;001;006;05;400;223;177
084;001;001;006;06;400;207;193
084;001;001;007;01;440;212;228
084;001;001;007;02;440;247;193
084;001;001;007;03;440;226;214
084;001;001;007;04;440;235;205
084;001;001;007;05;439;235;204
084;001;001;007;06;432;221;211
084;001;001;007;07;432;246;186
084;001;001;008;01;416;225;191
084;001;001;008;02;416;233;183
084;001;001;008;03;409;249;160
084;001;001;009;01;408;195;213
084;001;001;009;02;408;223;185
084;001;001;009;03;408;223;185
084;001;001;009;04;402;205;197
084;001;001;009;05;400;214;186
084;001;001;010;01;424;210;214
084;001;001;010;02;424;213;211
084;001;001;010;03;424;206;218
084;001;001;010;04;424;242;182
084;001;001;010;05;416;228;188
084;001;001;010;06;416;233;183
084;001;001;011;01;416;226;190
084;001;001;011;02;416;242;174
084;001;001;011;03;412;251;161
084;001;001;012;01;440;213;227
084;001;001;012;02;440;220;220
084;001;001;012;03;437;224;213
084;001;001;012;04;432;243;189
084;001;001;012;05;432;245;187
084;001;001;013;01;440;212;228
084;001;001;013;02;440;225;215
084;001;001;013;03;440;236;204
084;001;001;013;04;432;219;213
084;001;001;013;05;432;233;199
084;001;001;013;06;432;239;193
084;001;001;013;07;432;228;204
084;001;001;013;08;432;245;187
084;001;001;014;01;450;237;213
084;001;001;014;02;450;214;236
084;001;001;014;03;448;210;238
084;001;001;015;01;408;197;211
084;001;001;015;02;408;197;211
084;001;001;015;03;408;199;209
084;001;001;015;04;408;211;197
084;001;001;015;05;408;198;210
084;001;001;015;06;408;200;208
084;001;001;015;07;404;209;195
084;001;001;015;08;400;194;206
084;001;001;015;09;400;215;185
084;001;001;015;10;400;214;186
084;001;001;016;01;448;240;208
084;001;001;016;02;441;260;181
084;001;001;016;03;440;241;199
084;001;001;016;04;440;255;185
084;001;001;016;05;440;246;194
084;001;001;016;06;440;270;170
084;001;001;016;07;440;278;162
084;001;001;017;01;376;185;191
084;001;001;017;02;374;173;201
084;001;001;017;03;368;170;198
084;001;001;017;04;368;187;181
084;001;001;018;01;284;167;117
084;001;001;019;01;171;104;67
084;001;001;020;01;216;133;83
084;001;098;001;01;312;135;177
084;001;098;001;02;312;131;181
084;001;098;001;03;309;140;169
084;001;098;002;01;392;188;204
084;001;098;003;01;335;164;171
084;001;098;004;01;113;62;51
084;001;098;005;01;177;94;83
084;001;098;006;01;153;90;63
084;001;098;007;01;229;134;95
084;001;098;008;01;163;103;60
084;001;098;009;01;377;197;180
084;001;098;009;02;376;202;174
084;001;098;009;03;376;201;175
084;001;098;010;01;85;37;48
084;001;098;012;01;72;45;27
084;001;098;013;01;180;116;64
084;002;001;001;01;392;207;185
084;002;001;001;02;388;212;176
084;002;001;001;03;384;190;194
084;002;001;002;01;424;226;198
084;002;001;002;02;424;239;185
084;002;001;002;03;419;224;195
084;002;001;002;04;416;220;196
084;002;001;004;01;448;205;243
084;002;001;004;02;448;246;202
084;002;001;004;03;448;243;205
084;002;001;004;04;448;213;235
084;002;001;004;05;442;238;204
084;002;001;005;01;320;172;148
084;002;001;005;02;317;169;148
084;002;001;006;01;344;199;145
084;002;001;006;02;337;204;133
084;002;001;007;01;328;231;97
084;002;001;008;01;176;110;66
084;002;001;009;01;356;239;117
084;002;098;001;01;157;82;75
084;002;098;002;01;146;74;72
084;002;098;003;01;102;61;41
084;002;098;004;01;98;56;42
084;002;098;005;01;304;148;156
084;002;098;005;02;304;168;136
084;003;098;001;01;384;211;173
084;003;098;001;02;378;230;148
084;003;098;001;03;376;206;170
084;003;098;001;04;376;199;177
084;003;098;001;05;376;222;154
084;003;098;002;01;408;234;174
084;003;098;003;01;304;155;149
084;003;098;003;02;304;177;127
084;003;098;003;03;299;160;139
084;003;098;004;01;117;81;36
084;003;098;005;01;170;87;83
084;003;098;006;01;152;86;66
084;003;098;007;01;440;235;205
084;003;098;007;02;437;234;203
084;003;098;007;03;432;222;210
084;003;098;007;04;432;224;208
084;003;098;007;05;432;263;169
084;003;098;009;01;386;208;178
084;003;098;009;02;384;233;151
084;003;098;009;03;384;240;144
084;003;098;010;01;85;51;34
084;003;098;011;01;304;189;115
084;003;098;012;01;192;127;65
084;003;098;013;01;168;97;71
084;003;098;015;01;51;29;22
084;004;001;001;01;416;200;216
084;004;001;001;02;416;205;211
084;004;001;001;03;413;196;217
084;004;001;001;04;408;233;175
084;004;001;002;01;440;197;243
084;004;001;002;02;440;236;204
084;004;001;002;03;440;227;213
084;004;001;002;04;440;226;214
084;004;001;002;05;440;229;211
084;004;001;002;06;438;222;216
084;004;001;002;07;432;227;205
084;004;001;002;08;432;227;205
084;004;001;003;01;432;196;236
084;004;001;003;02;424;213;211
084;004;001;003;03;424;207;217
084;004;001;003;04;424;210;214
084;004;001;003;05;424;216;208
084;004;001;003;06;424;222;202
084;004;001;004;01;424;208;216
084;004;001;004;02;424;214;210
084;004;001;004;03;419;228;191
084;004;001;004;04;416;229;187
084;004;001;005;01;302;192;110
084;004;001;005;02;296;173;123
084;004;001;006;01;144;92;52
084;004;001;007;01;157;97;60
084;004;001;008;01;160;107;53
084;004;001;009;01;169;108;61
084;004;098;001;01;360;178;182
084;004;098;001;02;360;181;179
084;004;098;002;01;328;185;143
084;004;098;002;02;325;177;148
084;004;098;003;01;328;168;160
084;004;098;003;02;325;197;128
084;005;098;001;01;448;234;214
084;005;098;001;02;445;216;229
084;005;098;002;01;329;177;152
084;005;098;002;02;328;189;139
084;005;098;002;03;328;182;146
084;005;098;003;01;313;158;155
084;005;098;003;02;312;167;145
084;005;098;004;01;311;176;135
084;005;098;004;02;304;174;130
084;005;098;005;01;400;219;181
084;005;098;005;02;400;236;164
084;005;098;005;03;400;218;182
084;005;098;005;04;395;218;177
084;005;098;005;05;392;212;180
084;005;098;005;06;392;205;187
084;005;098;005;07;392;218;174
084;005;098;005;08;392;238;154
084;005;098;006;01;400;205;195
084;005;098;006;02;398;187;211
084;005;098;006;03;392;205;187
084;005;098;006;04;392;216;176
084;005;098;007;01;376;204;172
084;005;098;007;02;370;198;172
084;005;098;008;01;360;193;167
084;005;098;008;02;360;217;143
084;005;098;009;01;367;207;160
084;005;098;009;02;360;211;149
084;005;098;010;01;292;179;113
084;005;098;011;01;303;172;131
084;005;098;011;02;296;159;137
084;005;098;012;01;416;249;167
084;005;098;012;02;416;235;181
084;005;098;012;03;416;271;145
084;005;098;012;04;409;224;185
084;005;098;012;05;408;225;183
084;005;098;012;06;408;225;183
084;005;098;012;07;408;236;172
084;005;098;013;01;111;59;52
084;005;098;014;01;248;154;94
084;005;098;014;02;241;155;86
084;005;098;015;01;355;209;146
084;005;098;016;01;91;54;37
084;005;098;017;01;287;172;115
084;005;098;018;01;296;164;132
084;005;098;018;02;290;173;117
084;005;098;019;01;91;44;47
084;005;098;020;01;302;195;107
084;006;098;001;01;384;194;190
084;006;098;001;02;376;214;162
084;006;098;002;01;125;79;46
084;006;098;003;01;320;177;143
084;006;098;003;02;320;186;134
084;006;098;003;03;315;191;124
084;006;098;004;01;400;244;156
084;006;098;004;02;398;254;144
084;006;098;004;03;392;229;163
084;006;098;004;04;392;254;138
084;006;098;004;05;392;255;137
084;006;098;005;01;408;185;223
084;006;098;005;02;408;198;210
084;006;098;006;01;111;64;47
084;006;098;007;01;339;156;183
084;006;098;007;02;336;162;174
084;006;098;007;03;336;148;188
084;006;098;008;01;417;192;225
084;006;098;008;02;416;195;221
084;006;098;008;03;416;237;179
084;006;098;009;01;171;94;77
084;006;098;010;01;146;95;51
084;006;098;011;01;61;33;28
084;006;098;012;01;204;98;106
084;007;098;001;01;373;204;169
084;007;098;002;01;267;147;120
084;007;098;003;01;243;125;118
084;007;098;004;01;286;145;141
084;007;098;004;02;280;139;141
084;007;098;005;01;277;146;131
084;007;098;005;02;272;132;140
084;007;098;006;01;376;184;192
084;007;098;006;02;370;203;167
084;007;098;007;01;259;126;133
084;007;098;008;01;353;191;162
084;007;098;008;02;352;167;185
084;007;098;009;01;291;136;155
084;007;098;009;02;288;146;142
084;007;098;010;01;440;224;216
084;007;098;010;02;440;221;219
084;007;098;010;03;434;220;214
084;007;098;010;04;432;228;204
084;007;098;011;01;79;60;19
084;007;098;012;01;109;70;39
084;008;098;001;01;345;211;134
084;008;098;001;02;344;194;150
084;008;098;001;03;344;197;147
084;008;098;002;01;385;194;191
084;008;098;002;02;384;216;168
084;008;098;002;03;384;199;185
084;008;098;003;01;304;151;153
084;008;098;003;02;304;145;159
084;008;098;003;03;301;146;155
084;008;098;004;01;400;195;205
084;008;098;004;02;395;186;209
084;008;098;004;03;392;208;184
085;001;001;001;01;440;199;241
085;001;001;001;02;435;195;240
085;001;001;001;03;432;194;238
085;001;001;001;04;432;199;233
085;001;001;001;05;432;208;224
085;001;001;002;01;424;221;203
085;001;001;002;02;424;219;205
085;001;001;002;03;422;194;228
085;001;001;002;04;416;217;199
085;001;001;003;01;360;164;196
085;001;001;003;02;360;195;165
085;001;001;003;03;358;182;176
085;001;001;003;04;352;181;171
085;001;001;004;01;384;183;201
085;001;001;004;02;384;197;187
085;001;001;004;03;384;198;186
085;001;001;004;04;384;179;205
085;001;001;005;01;424;212;212
085;001;001;005;02;424;231;193
085;001;001;005;03;424;228;196
085;001;001;005;04;424;213;211
085;001;001;005;05;424;216;208
085;001;001;005;06;424;217;207
085;001;001;005;07;424;217;207
085;001;001;005;08;423;217;206
085;001;001;006;01;434;232;202
085;001;001;006;02;432;210;222
085;001;001;007;01;432;216;216
085;001;001;008;01;384;177;207
085;001;001;008;02;384;196;188
085;001;001;008;03;384;206;178
085;001;001;008;04;376;190;186
085;001;001;008;05;376;188;188
085;001;001;008;06;376;208;168
085;001;001;009;01;448;222;226
085;001;001;009;02;448;238;210
085;001;001;009;03;441;198;243
085;001;001;010;01;382;197;185
085;001;001;011;01;142;75;67
085;001;001;012;01;216;138;78
085;001;001;013;01;221;126;95
085;001;098;001;01;400;193;207
085;001;098;001;02;395;189;206
085;001;098;002;01;290;143;147
085;001;098;003;01;438;213;225
085;001;098;004;01;416;191;225
085;001;098;005;01;296;143;153
085;001;098;005;02;290;142;148
085;001;098;006;01;234;91;143
085;001;098;006;02;232;156;76
085;002;001;001;01;424;204;220
085;002;001;001;02;424;200;224
085;002;001;001;03;424;235;189
085;002;001;001;04;424;244;180
085;002;001;001;05;424;224;200
085;002;001;001;06;421;205;216
085;002;001;002;01;424;205;219
085;002;001;002;02;423;243;180
085;002;001;003;01;396;226;170
085;002;001;003;02;392;222;170
085;002;001;003;03;392;233;159
085;002;001;003;04;392;208;184
085;002;001;004;01;344;214;130
085;002;001;004;02;338;203;135
085;002;001;004;03;336;207;129
085;002;001;004;04;336;200;136
085;002;001;005;01;272;173;99
085;002;001;005;02;272;191;81
085;002;001;006;01;296;179;117
085;002;001;006;02;294;196;98
085;002;001;007;01;123;72;51
085;002;001;008;01;306;146;160
085;002;001;009;01;157;81;76
085;002;001;010;01;64;38;26
085;002;001;011;01;115;72;43
085;003;098;001;01;116;64;52
085;003;098;002;01;307;161;146
085;003;098;003;01;248;98;150
085;003;098;003;02;242;121;121
085;003;098;004;01;368;229;139
085;003;098;004;02;365;214;151
085;003;098;005;01;233;116;117
085;003;098;006;01;320;164;156
085;003;098;006;02;315;133;182
085;003;098;006;03;312;146;166
085;003;098;007;01;424;211;213
085;003;098;007;02;423;204;219
085;003;098;008;01;346;175;171
085;003;098;008;02;344;168;176
085;003;098;009;01;245;128;117
085;003;098;010;01;249;130;119
085;003;098;011;01;97;53;44
085;003;098;012;01;108;57;51
085;003;098;013;01;153;97;56
086;001;001;001;01;400;185;215
086;001;001;001;02;400;178;222
086;001;001;001;03;400;208;192
086;001;001;001;04;396;192;204
086;001;001;001;05;392;192;200
086;001;001;001;06;392;192;200
086;001;001;001;07;392;183;209
086;001;001;001;08;392;180;212
086;001;001;002;01;408;192;216
086;001;001;002;02;408;185;223
086;001;001;002;03;408;200;208
086;001;001;002;04;408;212;196
086;001;001;002;05;408;197;211
086;001;001;002;06;408;200;208
086;001;001;002;07;403;188;215
086;001;001;002;08;400;206;194
086;001;001;003;01;440;208;232
086;001;001;003;02;440;212;228
086;001;001;003;03;440;233;207
086;001;001;003;04;440;224;216
086;001;001;003;05;440;219;221
086;001;001;003;06;437;225;212
086;001;001;004;01;388;184;204
086;001;001;004;02;384;189;195
086;001;001;004;03;384;172;212
086;001;001;004;04;384;181;203
086;001;001;004;05;384;190;194
086;001;001;005;01;448;230;218
086;001;001;005;02;443;224;219
086;001;001;005;03;440;203;237
086;001;001;005;04;440;213;227
086;001;001;006;01;371;180;191
086;001;001;006;02;368;204;164
086;001;001;006;03;368;189;179
086;001;001;006;04;368;195;173
086;001;001;007;01;408;193;215
086;001;001;007;02;404;193;211
086;001;001;007;03;400;194;206
086;001;001;007;04;400;188;212
086;001;001;007;05;400;189;211
086;001;001;007;06;400;194;206
086;001;001;007;07;400;179;221
086;001;001;007;08;400;206;194
086;001;001;007;09;400;199;201
086;001;001;008;01;440;214;226
086;001;001;008;02;440;227;213
086;001;001;008;03;440;194;246
086;001;001;008;04;440;210;230
086;001;001;008;05;440;215;225
086;001;001;008;06;440;208;232
086;001;001;008;07;440;193;247
086;001;001;008;08;440;184;256
086;001;001;008;09;435;209;226
086;001;001;008;10;432;200;232
086;001;001;009;01;362;150;212
086;001;001;009;02;360;151;209
086;001;001;009;03;360;144;216
086;001;001;009;04;360;158;202
086;001;001;010;01;406;221;185
086;001;001;010;02;400;207;193
086;001;001;010;03;400;221;179
086;001;001;010;04;400;225;175
086;001;001;010;05;400;214;186
086;001;001;010;06;400;203;197
086;001;001;010;07;400;202;198
086;001;001;010;08;400;214;186
086;001;001;010;09;400;241;159
086;001;001;011;01;400;197;203
086;001;001;011;02;400;204;196
086;001;001;011;03;400;213;187
086;001;001;011;04;392;182;210
086;001;001;011;05;392;214;178
086;001;001;011;06;392;170;222
086;001;001;011;07;392;192;200
086;001;001;011;08;392;210;182
086;001;001;012;01;416;205;211
086;001;001;012;02;414;183;231
086;001;001;012;03;408;202;206
086;001;001;012;04;408;176;232
086;001;001;012;05;408;177;231
086;001;001;012;06;408;187;221
086;001;001;013;01;416;213;203
086;001;001;013;02;416;195;221
086;001;001;013;03;416;187;229
086;001;001;013;04;416;198;218
086;001;001;013;05;409;188;221
086;001;001;013;06;408;195;213
086;001;001;014;01;424;202;222
086;001;001;014;02;424;226;198
086;001;001;014;03;422;215;207
086;001;001;014;04;416;197;219
086;001;001;014;05;416;229;187
086;001;001;015;01;408;186;222
086;001;001;015;02;408;191;217
086;001;001;015;03;408;196;212
086;001;001;015;04;408;176;232
086;001;001;015;05;402;180;222
086;001;001;016;01;392;187;205
086;001;001;016;02;392;193;199
086;001;001;016;03;392;189;203
086;001;001;016;04;392;183;209
086;001;001;016;05;384;188;196
086;001;001;017;01;400;227;173
086;001;001;017;02;397;224;173
086;001;001;018;01;398;221;177
086;001;001;018;02;392;228;164
086;001;001;019;01;425;236;189
086;001;001;020;01;376;183;193
086;001;001;020;02;376;190;186
086;001;001;020;03;375;194;181
086;001;001;020;04;368;207;161
086;001;001;021;01;434;223;211
086;001;001;021;02;432;236;196
086;001;001;021;03;432;247;185
086;001;001;021;04;432;258;174
086;001;001;022;01;387;204;183
086;001;001;023;01;149;91;58
086;001;001;024;01;57;32;25
086;001;001;025;01;264;123;141
086;001;001;025;02;261;120;141
086;001;098;001;01;268;163;105
086;001;098;002;01;187;113;74
086;001;098;003;01;416;240;176
086;001;098;003;02;408;227;181
086;001;098;003;03;408;216;192
086;001;098;004;01;423;267;156
086;001;098;005;01;336;166;170
086;001;098;005;02;334;161;173
086;001;098;005;03;328;177;151
086;001;098;006;01;310;154;156
086;001;098;006;02;304;115;189
086;001;098;007;01;383;214;169
086;001;098;008;01;84;49;35
086;001;098;009;01;55;44;11
086;002;001;001;01;408;179;229
086;002;001;001;02;408;185;223
086;002;001;001;03;408;209;199
086;002;001;001;04;408;191;217
086;002;001;001;05;401;165;236
086;002;001;001;06;400;203;197
086;002;001;001;07;400;185;215
086;002;001;001;08;400;208;192
086;002;001;002;01;440;227;213
086;002;001;002;02;433;231;202
086;002;001;002;03;432;227;205
086;002;001;002;04;432;225;207
086;002;001;003;01;450;232;218
086;002;001;003;02;450;234;216
086;002;001;003;03;450;236;214
086;002;001;003;04;450;214;236
086;002;001;003;05;449;206;243
086;002;001;003;06;448;211;237
086;002;001;003;07;448;261;187
086;002;001;003;08;448;223;225
086;002;001;004;01;408;218;190
086;002;001;004;02;408;214;194
086;002;001;004;03;408;212;196
086;002;001;004;04;403;214;189
086;002;001;004;05;400;200;200
086;002;001;004;06;400;204;196
086;002;001;004;07;400;221;179
086;002;001;005;01;440;225;215
086;002;001;005;02;440;210;230
086;002;001;005;03;433;220;213
086;002;001;005;04;432;207;225
086;002;001;005;05;432;190;242
086;002;001;005;06;432;214;218
086;002;001;005;07;432;230;202
086;002;001;006;01;432;200;232
086;002;001;006;02;432;210;222
086;002;001;006;03;432;212;220
086;002;001;006;04;432;184;248
086;002;001;006;05;432;211;221
086;002;001;006;06;432;203;229
086;002;001;006;07;432;209;223
086;002;001;006;08;432;210;222
086;002;001;006;09;432;215;217
086;002;001;007;01;450;218;232
086;002;001;007;02;448;206;242
086;002;001;007;03;448;216;232
086;002;001;007;04;448;214;234
086;002;001;007;05;448;202;246
086;002;001;007;06;448;212;236
086;002;001;007;07;448;233;215
086;002;001;007;08;448;235;213
086;002;001;008;01;416;188;228
086;002;001;008;02;416;191;225
086;002;001;008;03;416;179;237
086;002;001;008;04;416;187;229
086;002;001;008;05;416;207;209
086;002;001;008;06;415;208;207
086;002;001;008;07;408;199;209
086;002;001;008;08;408;190;218
086;002;001;009;01;392;211;181
086;002;001;009;02;392;208;184
086;002;001;009;03;392;205;187
086;002;001;009;04;392;216;176
086;002;001;009;05;392;203;189
086;002;001;009;06;391;220;171
086;002;001;009;07;384;200;184
086;002;001;010;01;408;181;227
086;002;001;010;02;408;183;225
086;002;001;010;03;408;182;226
086;002;001;010;04;408;212;196
086;002;001;010;05;408;181;227
086;002;001;010;06;408;197;211
086;002;001;010;07;408;195;213
086;002;001;010;08;407;190;217
086;002;001;011;01;440;226;214
086;002;001;011;02;440;205;235
086;002;001;011;03;436;227;209
086;002;001;011;04;432;224;208
086;002;001;011;05;432;217;215
086;002;001;011;06;432;212;220
086;002;001;011;07;432;202;230
086;002;001;011;08;432;233;199
086;002;001;011;09;432;220;212
086;002;001;012;01;400;191;209
086;002;001;012;02;400;196;204
086;002;001;012;03;400;208;192
086;002;001;012;04;400;196;204
086;002;001;012;05;394;183;211
086;002;001;012;06;392;191;201
086;002;001;012;07;392;197;195
086;002;001;013;01;424;193;231
086;002;001;013;02;424;207;217
086;002;001;013;03;420;222;198
086;002;001;013;04;416;194;222
086;002;001;013;05;416;192;224
086;002;001;013;06;416;175;241
086;002;001;013;07;416;199;217
086;002;001;013;08;416;200;216
086;002;001;013;09;416;216;200
086;002;001;013;10;416;214;202
086;002;001;013;11;416;207;209
086;002;001;014;01;440;220;220
086;002;001;014;02;440;228;212
086;002;001;014;03;440;223;217
086;002;001;014;04;440;217;223
086;002;001;014;05;435;212;223
086;002;001;015;01;440;210;230
086;002;001;015;02;439;230;209
086;002;001;015;03;432;225;207
086;002;001;016;01;320;145;175
086;002;001;016;02;320;137;183
086;002;001;016;03;314;142;172
086;002;001;017;01;280;151;129
086;002;001;017;02;279;138;141
086;002;001;018;01;402;231;171
086;002;001;018;02;400;236;164
086;002;001;018;03;400;238;162
086;002;001;018;04;400;240;160
086;002;001;018;05;400;251;149
086;002;001;018;06;400;240;160
086;002;001;019;01;424;243;181
086;002;001;019;02;423;230;193
086;002;001;020;01;443;218;225
086;002;001;020;02;440;228;212
086;002;001;021;01;323;166;157
086;002;001;022;01;312;146;166
086;002;001;022;02;304;149;155
086;002;001;022;03;304;133;171
086;002;001;023;01;351;182;169
086;002;001;024;01;440;196;244
086;002;001;024;02;439;226;213
086;002;001;024;03;432;214;218
086;002;001;024;04;432;195;237
086;002;001;024;05;432;221;211
086;002;001;025;01;432;181;251
086;002;001;025;02;432;202;230
086;002;001;025;03;432;207;225
086;002;001;025;04;432;197;235
086;002;001;025;05;432;218;214
086;002;001;025;06;432;195;237
086;002;001;025;07;432;209;223
086;002;001;025;08;427;203;224
086;002;001;026;01;384;209;175
086;002;001;026;02;384;216;168
086;002;001;026;03;384;205;179
086;002;001;026;04;384;202;182
086;002;001;026;05;378;201;177
086;002;001;026;06;376;205;171
086;002;001;027;01;364;185;179
086;002;001;028;01;245;118;127
086;002;001;028;02;240;108;132
086;002;001;029;01;151;79;72
086;002;001;030;01;231;107;124
086;002;001;030;02;224;100;124
086;002;001;031;01;232;129;103
086;003;098;001;01;143;71;72
086;003;098;002;01;231;115;116
086;003;098;002;02;224;134;90
086;003;098;003;01;336;203;133
086;003;098;003;02;335;208;127
086;003;098;004;01;352;193;159
086;003;098;004;02;350;179;171
086;003;098;004;03;344;192;152
086;003;098;005;01;229;124;105
086;003;098;005;02;224;121;103
086;003;098;006;01;387;228;159
086;003;098;006;02;384;211;173
086;003;098;007;01;355;196;159
086;003;098;008;01;133;92;41
086;003;098;009;01;159;113;46
086;003;098;010;01;226;152;74
086;003;098;011;01;352;220;132
086;003;098;012;01;89;55;34
087;004;001;001;01;352;171;181
087;004;001;001;02;352;180;172
087;004;001;001;03;352;154;198
087;004;001;001;04;347;166;181
087;004;001;002;01;344;173;171
087;004;001;002;02;344;142;202
087;004;001;002;03;337;173;164
087;004;001;003;01;211;130;81
087;004;001;004;01;292;142;150
087;004;001;005;01;312;168;144
087;004;001;006;01;240;168;72
087;004;001;007;01;156;96;60
087;004;098;001;01;373;169;204
087;004;098;001;02;368;157;211
087;004;098;002;01;238;125;113
087;004;098;002;02;232;129;103
087;004;098;003;01;445;225;220
087;004;098;004;01;308;132;176
087;004;098;005;01;136;69;67
087;004;098;006;01;321;178;143
087;004;098;006;02;320;162;158
087;004;098;007;01;198;103;95
087;004;098;008;01;267;124;143
087;004;098;009;01;438;219;219
087;004;098;010;01;282;125;157
087;004;098;011;01;146;89;57
087;004;098;012;01;60;35;25
087;004;098;013;01;114;61;53
087;004;098;014;01;98;50;48
087;004;098;015;01;89;44;45
087;005;098;001;01;314;170;144
087;005;098;001;02;312;158;154
087;005;098;001;03;312;169;143
087;005;098;002;01;354;209;145
087;005;098;003;01;392;168;224
087;005;098;003;02;384;212;172
087;005;098;003;03;384;212;172
087;005;098;003;04;384;207;177
087;005;098;003;05;384;213;171
087;005;098;003;06;384;207;177
087;005;098;004;01;298;134;164
087;005;098;004;02;296;155;141
087;005;098;005;01;99;50;49
087;005;098;006;01;58;29;29
087;005;098;007;01;240;145;95
087;005;098;008;01;111;68;43
087;005;098;010;01;74;55;19
087;005;098;013;01;220;94;126
087;006;098;001;01;400;249;151
087;006;098;001;02;399;236;163
087;006;098;002;01;320;167;153
087;006;098;002;02;320;161;159
087;006;098;002;03;312;186;126
087;006;098;003;01;385;212;173
087;006;098;003;02;384;226;158
087;006;098;004;01;344;166;178
087;006;098;004;02;341;171;170
087;006;098;005;01;213;107;106
087;006;098;006;01;379;192;187
087;006;098;007;01;280;159;121
087;006;098;008;01;68;39;29
087;006;098;009;01;194;110;84
088;002;001;001;01;416;200;216
088;002;001;001;02;416;214;202
088;002;001;001;03;416;214;202
088;002;001;001;04;415;214;201
088;002;001;001;05;408;212;196
088;002;001;002;01;424;216;208
088;002;001;002;02;424;220;204
088;002;001;002;03;418;222;196
088;002;001;002;04;416;226;190
088;002;001;002;05;416;226;190
088;002;001;003;01;376;193;183
088;002;001;003;02;376;191;185
088;002;001;003;03;376;182;194
088;002;001;003;04;376;207;169
088;002;001;003;05;370;198;172
088;002;001;004;01;448;246;202
088;002;001;004;02;447;233;214
088;002;001;004;03;440;221;219
088;002;001;004;04;440;213;227
088;002;001;004;05;440;233;207
088;002;001;005;01;448;247;201
088;002;001;005;02;448;241;207
088;002;001;005;03;448;243;205
088;002;001;005;04;445;248;197
088;002;001;005;05;440;228;212
088;002;001;006;01;360;205;155
088;002;001;006;02;360;223;137
088;002;001;006;03;360;208;152
088;002;001;006;04;356;223;133
088;002;001;007;01;416;193;223
088;002;001;007;02;416;221;195
088;002;001;007;03;416;190;226
088;002;001;007;04;416;187;229
088;002;001;007;05;408;201;207
088;002;001;008;01;448;229;219
088;002;001;008;02;448;236;212
088;002;001;008;03;448;234;214
088;002;001;008;04;443;235;208
088;002;001;008;05;440;229;211
088;002;001;008;06;440;200;240
088;002;001;009;01;416;206;210
088;002;001;009;02;416;214;202
088;002;001;009;03;416;212;204
088;002;001;009;04;410;185;225
088;002;001;010;01;416;211;205
088;002;001;010;02;413;215;198
088;002;001;010;03;408;229;179
088;002;001;011;01;390;216;174
088;002;001;011;02;384;215;169
088;002;001;011;03;384;201;183
088;002;001;011;04;384;190;194
088;002;001;012;01;416;232;184
088;002;001;012;02;414;226;188
088;002;001;013;01;392;188;204
088;002;001;013;02;392;195;197
088;002;001;013;03;392;208;184
088;002;001;013;04;392;174;218
088;002;001;013;05;392;192;200
088;002;001;013;06;390;205;185
088;002;001;014;01;368;190;178
088;002;001;014;02;366;189;177
088;002;001;014;03;360;174;186
088;002;001;014;04;360;180;180
088;002;001;015;01;419;213;206
088;002;001;015;02;416;210;206
088;002;001;015;03;416;200;216
088;002;001;016;01;440;223;217
088;002;001;016;02;440;224;216
088;002;001;016;03;440;231;209
088;002;001;016;04;435;247;188
088;002;001;016;05;432;226;206
088;002;001;017;01;352;194;158
088;002;001;017;02;352;171;181
088;002;001;018;01;416;221;195
088;002;001;018;02;412;219;193
088;002;001;019;01;416;209;207
088;002;001;019;02;414;185;229
088;002;001;020;01;264;132;132
088;002;001;020;02;257;130;127
088;002;001;021;01;380;166;214
088;002;001;021;02;376;167;209
088;002;001;022;01;271;114;157
088;002;001;022;02;264;142;122
088;002;001;023;01;435;220;215
088;002;098;001;01;443;217;226
088;002;098;002;01;341;182;159
088;002;098;002;02;336;144;192
088;002;098;003;01;304;152;152
088;002;098;003;02;304;134;170
088;002;098;003;03;298;116;182
088;002;098;004;01;368;191;177
088;002;098;004;02;364;168;196
088;002;098;005;01;398;191;207
088;002;098;006;01;248;132;116
088;002;098;006;02;245;121;124
088;002;098;007;01;292;149;143
088;002;098;007;02;288;137;151
088;002;098;008;01;400;204;196
088;002;098;008;02;400;164;236
088;002;098;009;01;315;151;164
088;002;098;010;01;265;146;119
088;002;098;010;02;264;132;132
088;002;098;011;01;332;173;159
088;002;098;012;01;424;261;163
088;002;098;012;02;424;239;185
088;002;098;012;03;424;221;203
088;002;098;012;04;424;230;194
088;002;098;012;05;421;225;196
088;002;098;012;06;416;213;203
088;002;098;012;07;416;216;200
088;002;098;013;01;333;169;164
088;002;098;013;02;328;182;146
088;002;098;013;03;328;163;165
088;002;098;014;01;280;164;116
088;002;098;014;02;276;126;150
088;002;098;015;01;418;212;206
088;002;098;016;01;418;216;202
088;002;098;016;02;416;169;247
088;002;098;017;01;450;202;248
088;002;098;018;01;448;246;202
088;002;098;018;02;442;181;261
088;002;098;019;01;251;128;123
088;002;098;019;02;248;121;127
088;002;098;020;01;232;102;130
088;002;098;020;02;228;123;105
088;002;098;021;01;173;88;85
088;002;098;022;01;368;192;176
088;002;098;023;01;179;93;86
088;002;098;024;01;316;167;149
088;002;098;025;01;284;149;135
088;002;098;025;02;280;144;136
088;002;098;026;01;89;38;51
088;002;098;027;01;135;77;58
088;002;098;028;01;181;95;86
088;002;098;029;01;292;152;140
088;002;098;030;01;231;108;123
088;002;098;031;01;35;23;12
088;002;098;032;01;263;158;105
088;002;098;032;02;256;118;138
088;002;098;033;01;167;96;71
088;002;098;034;01;291;132;159
088;002;098;035;01;262;125;137
088;002;098;036;01;256;137;119
088;002;098;036;02;252;115;137
088;002;098;037;01;296;144;152
088;002;098;038;01;192;104;88
088;002;098;039;01;332;146;186
088;002;098;040;01;222;119;103
088;002;098;041;01;416;211;205
088;002;098;042;01;324;140;184
088;002;098;043;01;252;124;128
088;002;098;044;01;273;135;138
088;002;098;045;01;177;90;87
088;002;098;046;01;199;86;113
088;002;098;047;01;99;56;43
088;004;001;001;01;448;213;235
088;004;001;001;02;446;217;229
088;004;001;002;01;272;131;141
088;004;001;002;02;270;129;141
088;004;001;003;01;276;160;116
088;004;001;003;02;272;124;148
088;004;001;004;01;212;98;114
088;004;001;005;01;206;105;101
088;004;098;001;01;439;217;222
088;004;098;002;01;298;134;164
088;004;098;004;01;199;104;95
088;004;098;005;01;132;70;62
088;004;098;006;01;291;154;137
088;004;098;007;01;394;184;210
088;004;098;008;01;384;216;168
088;004;098;009;01;231;114;117
088;004;098;010;01;406;197;209
088;004;098;011;01;86;46;40
088;007;098;001;01;392;203;189
088;007;098;001;02;386;186;200
088;007;098;002;01;385;203;182
088;007;098;002;02;384;180;204
088;007;098;003;01;404;199;205
088;007;098;004;01;435;214;221
088;007;098;005;01;313;159;154
088;007;098;006;01;242;119;123
088;007;098;007;01;280;155;125
088;007;098;007;02;275;150;125
088;007;098;008;01;164;80;84
088;007;098;009;01;158;77;81
088;007;098;010;01;143;73;70
088;007;098;011;01;154;85;69
088;007;098;012;01;99;52;47
088;007;098;013;01;119;68;51
088;007;098;014;01;129;67;62
089;001;001;001;01;400;188;212
089;001;001;001;02;400;196;204
089;001;001;001;03;400;82;318
089;001;001;001;04;400;219;181
089;001;001;001;05;400;229;171
089;001;001;001;06;396;264;132
089;001;001;002;01;408;206;202
089;001;001;002;02;408;188;220
089;001;001;002;03;408;228;180
089;001;001;002;04;408;65;343
089;001;001;002;05;405;220;185
089;001;001;002;06;400;217;183
089;001;001;002;07;400;335;65
089;001;001;002;08;400;239;161
089;001;001;003;01;392;201;191
089;001;001;003;02;392;112;280
089;001;001;003;03;392;218;174
089;001;001;003;04;389;268;121
089;001;001;004;01;430;154;276
089;001;001;004;02;424;275;149
089;001;001;005;01;320;128;192
089;001;001;005;02;316;203;113
089;001;001;006;01;329;155;174
089;001;001;007;01;312;163;149
089;001;001;008;01;368;131;237
089;001;001;008;02;365;259;106
089;001;001;009;01;212;108;104
089;001;001;010;01;229;117;112
089;001;001;011;01;264;84;180
089;001;001;011;02;263;142;121
089;001;001;012;01;230;107;123
089;001;001;013;01;121;64;57
089;001;001;014;01;165;103;62
089;001;098;001;01;424;215;209
089;001;098;001;02;423;255;168
089;001;098;001;03;416;200;216
089;001;098;002;01;328;179;149
089;001;098;002;02;325;187;138
089;001;098;003;01;440;203;237
089;001;098;003;02;436;266;170
089;001;098;004;01;336;189;147
089;001;098;004;02;332;190;142
089;001;098;004;03;328;217;111
089;001;098;005;01;410;227;183
089;001;098;006;01;308;202;106
089;001;098;007;01;244;129;115
089;001;098;008;01;228;107;121
089;001;098;009;01;308;137;171
089;001;098;010;01;206;122;84
089;001;098;011;01;290;140;150
089;001;098;011;02;288;162;126
089;001;098;012;01;214;107;107
089;001;098;013;01;117;67;50
089;001;098;014;01;135;83;52
089;001;098;015;01;240;118;122
089;005;001;001;01;412;173;239
089;005;001;001;02;408;133;275
089;005;001;001;03;408;126;282
089;005;001;001;04;408;244;164
089;005;001;001;05;408;307;101
089;005;001;002;01;384;154;230
089;005;001;002;02;384;136;248
089;005;001;002;03;384;122;262
089;005;001;002;04;384;244;140
089;005;001;002;05;376;277;99
089;005;001;003;01;448;208;240
089;005;001;003;02;448;172;276
089;005;001;003;03;442;120;322
089;005;001;003;04;440;259;181
089;005;001;003;05;440;316;124
089;005;001;004;01;264;135;129
089;005;001;004;02;262;135;127
089;005;001;005;01;248;165;83
089;005;001;005;02;241;84;157
089;005;001;006;01;264;147;117
089;005;001;006;02;256;188;68
089;005;001;007;01;304;150;154
089;005;001;007;02;301;220;81
089;005;001;008;01;167;82;85
089;005;001;009;01;114;53;61
089;005;001;010;01;384;238;146
089;005;001;010;02;384;139;245
089;005;001;010;03;380;276;104
089;005;001;011;01;430;204;226
089;005;001;012;01;325;158;167
089;005;098;001;01;400;177;223
089;005;098;001;02;396;159;237
089;005;098;001;03;392;247;145
089;005;098;001;04;392;177;215
089;005;098;001;05;392;198;194
089;005;098;002;01;219;111;108
089;005;098;003;01;296;147;149
089;005;098;004;01;225;114;111
089;005;098;005;01;231;77;154
089;005;098;005;02;224;155;69
089;005;098;006;01;213;116;97
089;005;098;007;01;249;119;130
089;005;098;008;01;286;152;134
089;005;098;009;01;351;172;179
089;005;098;010;01;133;67;66
089;005;098;011;01;257;134;123
089;005;098;012;01;114;64;50
089;006;001;001;01;440;244;196
089;006;001;001;02;440;218;222
089;006;001;001;03;440;239;201
089;006;001;001;04;440;245;195
089;006;001;001;05;440;213;227
089;006;001;001;06;440;200;240
089;006;001;001;07;439;262;177
089;006;001;001;08;432;231;201
089;006;001;001;09;432;210;222
089;006;001;002;01;416;218;198
089;006;001;002;02;414;235;179
089;006;001;002;03;408;234;174
089;006;001;002;04;408;216;192
089;006;001;002;05;408;162;246
089;006;001;002;06;408;274;134
089;006;001;002;07;408;210;198
089;006;001;003;01;440;226;214
089;006;001;003;02;440;242;198
089;006;001;003;03;440;150;290
089;006;001;003;04;434;239;195
089;006;001;004;01;416;228;188
089;006;001;004;02;416;241;175
089;006;001;004;03;416;221;195
089;006;001;004;04;416;242;174
089;006;001;004;05;416;228;188
089;006;001;004;06;412;259;153
089;006;001;004;07;408;247;161
089;006;001;005;01;424;255;169
089;006;001;005;02;424;276;148
089;006;001;005;03;417;246;171
089;006;001;005;04;416;252;164
089;006;001;006;01;325;180;145
089;006;001;006;02;320;190;130
089;006;001;006;03;320;172;148
089;006;001;007;01;318;156;162
089;006;001;008;01;400;233;167
089;006;001;008;02;397;165;232
089;006;001;009;01;353;171;182
089;006;001;010;01;316;165;151
089;006;001;011;01;332;172;160
089;006;001;012;01;328;157;171
089;006;001;012;02;328;135;193
089;006;001;013;01;315;152;163
089;006;098;001;01;448;199;249
089;006;098;001;02;444;133;311
089;006;098;001;03;440;238;202
089;006;098;001;04;440;301;139
089;006;098;002;01;325;172;153
089;006;098;003;01;399;188;211
089;006;098;003;02;392;253;139
089;006;098;004;01;148;71;77
089;006;098;005;01;246;100;146
089;006;098;005;02;240;135;105
089;006;098;006;01;344;196;148
089;006;098;007;01;243;136;107
089;006;098;008;01;230;117;113
089;006;098;008;02;224;110;114
089;007;098;001;01;415;212;203
089;007;098;002;01;447;263;184
089;007;098;002;02;440;204;236
089;007;098;003;01;416;252;164
089;007;098;003;02;415;197;218
089;007;098;004;01;318;181;137
089;007;098;005;01;254;188;66
089;007;098;006;01;136;94;42
089;007;098;007;01;139;105;34
089;007;098;008;01;207;128;79
089;007;098;009;01;125;97;28
089;007;098;010;01;230;139;91
089;007;098;011;01;317;167;150
089;007;098;012;01;154;110;44
089;007;098;013;01;361;160;201
089;007;098;013;02;360;182;178
089;007;098;013;03;360;167;193
089;007;098;014;01;102;74;28
089;007;098;015;01;117;93;24
089;007;098;016;01;85;49;36
089;007;098;017;01;126;88;38
089;008;098;001;01;408;207;201
089;008;098;001;02;408;135;273
089;008;098;001;03;408;240;168
089;008;098;001;04;402;288;114
089;008;098;001;05;400;170;230
089;008;098;001;06;400;166;234
089;008;098;002;01;416;228;188
089;008;098;002;02;414;213;201
089;008;098;002;03;408;211;197
089;008;098;002;04;408;225;183
089;008;098;002;05;408;224;184
089;008;098;003;01;392;183;209
089;008;098;003;02;386;226;160
089;008;098;004;01;404;154;250
089;008;098;004;02;400;241;159
089;008;098;005;01;94;45;49
089;008;098;006;01;280;108;172
089;008;098;006;02;278;146;132
089;008;098;007;01;316;140;176
089;008;098;008;01;312;145;167
089;008;098;008;02;311;165;146
089;008;098;008;03;304;168;136
089;008;098;009;01;412;210;202
089;008;098;010;01;211;96;115
089;008;098;011;01;418;211;207
089;008;098;012;01;189;87;102
089;008;098;013;01;197;95;102
089;008;098;014;01;137;75;62
089;008;098;015;01;100;53;47
090;001;001;001;01;322;192;130
090;001;001;001;02;320;196;124
090;001;001;002;01;405;212;193
090;001;001;002;02;400;194;206
090;001;001;002;03;400;206;194
090;001;001;002;04;400;220;180
090;001;001;002;05;400;211;189
090;001;001;002;06;400;198;202
090;001;001;003;01;392;219;173
090;001;001;003;02;389;204;185
090;001;001;005;01;240;127;113
090;001;001;005;02;234;118;116
090;001;001;006;01;440;227;213
090;001;001;006;02;439;231;208
090;001;001;006;03;432;241;191
090;001;001;007;01;248;130;118
090;001;001;007;02;246;129;117
090;001;001;008;01;336;177;159
090;001;001;008;02;331;153;178
001;001;001;001;01;440;207;233
001;001;001;001;02;437;237;200
001;001;001;001;03;432;196;236
001;001;001;001;04;432;227;205
001;001;001;001;05;432;219;213
001;001;001;002;01;368;183;185
001;001;001;002;02;368;190;178
001;001;001;002;03;368;182;186
001;001;001;002;04;366;165;201
001;001;001;002;05;360;179;181
001;001;001;003;01;320;145;175
001;001;001;003;02;319;135;184
001;001;001;003;03;312;139;173
001;001;001;004;01;344;168;176
001;001;001;004;02;342;151;191
001;001;001;004;03;336;163;173
001;001;001;004;04;336;174;162
001;001;001;005;01;349;186;163
001;001;001;005;02;344;174;170
001;001;001;005;03;344;162;182
001;001;001;005;04;344;188;156
001;001;001;006;01;440;239;201
001;001;001;006;02;440;212;228
001;001;001;006;03;440;222;218
001;001;001;006;04;434;233;201
001;001;001;007;01;425;193;232
001;001;001;007;02;424;197;227
001;001;001;007;03;424;191;233
001;001;001;007;04;424;215;209
001;001;001;007;05;424;218;206
001;001;001;008;01;394;184;210
001;001;001;008;02;392;205;187
001;001;001;008;03;392;188;204
001;001;001;008;04;392;193;199
001;001;001;008;05;392;200;192
001;001;001;009;01;432;215;217
001;001;001;009;02;430;212;218
001;001;001;009;03;424;204;220
001;001;001;009;04;424;213;211
001;001;001;009;05;424;199;225
001;001;001;010;01;360;167;193
001;001;001;010;02;360;156;204
001;001;001;010;03;360;160;200
001;001;001;010;04;355;166;189
001;001;001;011;01;368;166;202
001;001;001;011;02;368;159;209
001;001;001;011;03;368;189;179
001;001;001;011;04;366;176;190
001;001;001;012;01;424;212;212
001;001;001;012;02;421;214;207
001;001;001;012;03;416;204;212
001;001;001;012;04;416;227;189
001;001;001;012;05;416;202;214
001;001;001;012;06;416;198;218
001;001;001;012;07;416;199;217
001;001;001;012;08;416;207;209
001;001;001;013;01;408;188;220
001;001;001;013;02;405;206;199
001;001;001;013;03;400;192;208
001;001;001;013;04;400;183;217
001;001;001;013;05;400;190;210
001;001;001;013;06;400;197;203
001;001;001;014;01;449;216;233
001;001;001;014;02;448;222;226
001;001;001;014;03;448;235;213
001;001;001;014;04;448;221;227
001;001;001;015;01;416;208;208
001;001;001;015;02;416;208;208
001;001;001;015;03;412;186;226
001;001;001;015;04;408;205;203
001;001;001;016;01;124;70;54
001;001;001;017;01;172;97;75
001;001;001;018;01;237;125;112
001;001;001;018;02;232;122;110
001;001;001;019;01;232;118;114
001;001;001;019;02;231;139;92
001;001;001;020;01;247;137;110
001;001;001;021;01;248;132;116
001;001;001;021;02;242;131;111
001;001;001;022;01;400;202;198
001;001;001;022;02;396;191;205
001;001;001;022;03;392;173;219
001;001;001;022;04;392;200;192
001;001;001;022;05;392;187;205
001;001;001;022;06;392;197;195
001;001;001;023;01;337;150;187
001;001;001;023;02;336;162;174
001;001;001;023;03;336;166;170
001;001;001;024;01;360;201;159
001;001;001;024;02;359;175;184
001;001;001;024;03;352;183;169
001;001;001;025;01;448;216;232
001;001;001;025;02;446;215;231
001;001;001;025;03;440;203;237
001;001;001;025;04;440;218;222
001;001;001;025;05;440;215;225
001;001;001;025;06;440;191;249
001;001;001;026;01;392;204;188
001;001;001;026;02;389;214;175
001;001;001;027;01;415;201;214
001;001;001;028;01;320;176;144
001;001;001;028;02;312;179;133
001;001;001;028;03;312;162;150
001;001;001;029;01;392;190;202
001;001;001;029;02;392;182;210
001;001;001;029;03;386;186;200
001;001;001;030;01;352;188;164
001;001;001;030;02;346;179;167
001;001;001;030;03;344;187;157
001;001;001;030;04;344;183;161
001;001;001;031;01;416;195;221
001;001;001;031;02;416;194;222
001;001;001;031;03;416;202;214
001;001;001;031;04;416;217;199
001;001;001;031;05;409;208;201
001;001;001;032;01;320;133;187
001;001;001;032;02;320;115;205
001;001;001;032;03;318;159;159
001;001;001;033;01;368;175;193
001;001;001;033;02;362;162;200
001;001;001;033;03;360;166;194
001;001;001;034;01;336;167;169
001;001;001;034;02;331;168;163
001;001;001;035;01;265;140;125
001;001;001;035;02;264;114;150
001;001;001;036;01;269;141;128
001;001;001;036;02;264;126;138
001;001;001;037;01;311;149;162
001;001;001;038;01;82;43;39
001;001;001;039;01;69;43;26
001;001;001;040;01;352;139;213
001;001;001;042;01;263;130;133
001;001;001;042;02;256;129;127
001;001;098;002;01;399;200;199
001;001;098;002;02;392;190;202
001;001;098;003;01;400;182;218
001;001;098;003;02;400;181;219
001;001;098;003;03;399;182;217
001;001;098;003;04;392;182;210
001;001;098;004;01;400;195;205
001;001;098;004;02;400;187;213
001;001;098;004;03;400;170;230
001;001;098;004;04;393;210;183
001;001;098;005;01;344;170;174
001;001;098;005;02;340;173;167
001;001;098;005;03;336;177;159
001;001;098;006;01;306;152;154
001;001;098;006;02;304;165;139
001;001;098;006;03;304;140;164
001;001;098;007;01;440;221;219
001;001;098;008;01;368;168;200
001;001;098;008;02;368;200;168
001;001;098;008;03;362;211;151
001;001;098;009;01;240;121;119
001;001;098;009;02;240;136;104
001;001;098;010;01;376;182;194
001;001;098;010;02;369;208;161
001;001;098;010;03;368;222;146
001;001;098;010;04;368;185;183
001;001;098;010;05;368;215;153
001;002;001;001;01;416;224;192
001;002;001;001;02;416;219;197
001;002;001;001;03;409;206;203
001;002;001;001;04;408;220;188
001;002;001;001;05;408;231;177
001;002;001;002;01;417;201;216
001;002;001;002;02;416;211;205
001;002;001;002;03;416;221;195
001;002;001;003;01;392;200;192
001;002;001;003;02;392;191;201
001;002;001;003;03;392;193;199
001;002;001;003;04;390;212;178
001;002;001;004;01;338;175;163
001;002;001;004;02;336;194;142
001;002;001;004;03;336;165;171
001;002;001;005;01;432;228;204
001;002;001;005;02;432;239;193
001;002;001;005;03;425;232;193
001;002;001;006;01;400;197;203
001;002;001;006;02;400;218;182
001;002;001;006;03;400;206;194
001;002;001;006;04;392;197;195
001;002;001;006;05;392;196;196
001;002;001;007;01;370;178;192
001;002;001;007;02;368;178;190
001;002;001;007;03;368;211;157
001;002;001;007;04;368;183;185
001;002;001;007;05;368;188;180
001;002;001;008;01;305;150;155
001;002;001;008;02;304;189;115
001;002;001;008;03;304;169;135
001;002;001;009;01;368;198;170
001;002;001;009;02;364;196;168
001;002;001;010;01;402;219;183
001;002;001;010;02;400;222;178
001;002;001;011;01;259;174;85
001;002;001;012;01;290;160;130
001;002;001;012;02;288;158;130
001;002;001;013;01;60;33;27
001;002;098;001;01;383;203;180
001;002;098;002;01;240;132;108
001;002;098;002;02;234;123;111
001;002;098;003;01;131;67;64
001;002;098;004;01;186;93;93
001;003;001;001;01;422;231;191
001;003;001;001;02;416;203;213
001;003;001;001;03;416;213;203
001;003;001;001;04;416;209;207
001;003;001;001;05;416;210;206
001;003;001;002;01;441;252;189
001;003;001;002;02;440;265;175
001;003;001;002;03;440;243;197
001;003;001;003;01;384;212;172
001;003;001;003;02;380;201;179
001;003;001;004;01;408;206;202
001;003;001;004;02;408;198;210
001;003;001;004;03;407;206;201
001;003;001;004;04;400;216;184
001;003;001;005;01;368;192;176
001;003;001;005;02;368;180;188
001;003;001;005;03;366;182;184
001;003;001;005;04;360;198;162
001;003;001;005;05;360;192;168
001;003;001;006;01;334;168;166
001;003;001;007;01;176;98;78
001;003;001;008;01;375;224;151
001;003;001;009;01;163;107;56
001;003;001;010;01;422;234;188
001;003;001;011;01;188;110;78
001;003;001;012;01;77;48;29
001;003;001;013;01;51;32;19
001;003;098;001;01;336;173;163
001;003;098;001;02;336;198;138
001;003;098;002;01;359;200;159
001;003;098;003;01;320;155;165
001;003;098;003;02;312;181;131
001;003;098;004;01;344;163;181
001;003;098;004;02;342;177;165
001;003;098;005;01;248;137;111
001;003;098;005;02;241;148;93
001;003;098;006;01;146;69;77
001;003;098;007;01;194;112;82
001;003;098;008;01;276;137;139
001;003;098;009;01;368;184;184
001;003;098;009;02;363;163;200
001;004;098;001;01;416;204;212
001;004;098;001;02;416;190;226
001;004;098;001;03;416;215;201
001;004;098;001;04;416;198;218
001;004;098;001;05;416;207;209
001;004;098;001;06;416;226;190
001;004;098;001;07;412;210;202
001;004;098;001;08;408;198;210
001;004;098;001;09;408;193;215
001;004;098;002;01;336;157;179
001;004;098;002;02;331;162;169
001;004;098;002;03;328;142;186
001;004;098;003;01;368;187;181
001;004;098;003;02;364;173;191
001;004;098;003;03;360;158;202
001;004;098;003;04;360;171;189
001;004;098;003;05;360;174;186
001;004;098;004;01;392;207;185
001;004;098;004;02;385;180;205
001;004;098;004;03;384;193;191
001;004;098;005;01;353;185;168
001;004;098;005;02;352;171;181
001;004;098;006;01;416;210;206
001;004;098;006;02;413;200;213
001;004;098;006;03;408;181;227
001;004;098;007;01;189;120;69
001;004;098;008;01;245;135;110
001;004;098;009;01;89;38;51
001;004;098;010;01;23;15;8
001;005;098;001;01;440;211;229
001;005;098;001;02;440;218;222
001;005;098;001;03;433;244;189
001;005;098;001;04;432;202;230
001;005;098;001;05;432;228;204
001;005;098;001;06;432;235;197
001;005;098;003;01;207;116;91
001;006;098;001;01;400;198;202
001;006;098;001;02;400;205;195
001;006;098;001;03;400;207;193
001;006;098;001;04;400;217;183
001;006;098;001;05;399;196;203
001;006;098;002;01;328;182;146
001;006;098;002;02;328;166;162
001;006;098;002;03;326;190;136
001;006;098;003;01;305;167;138
001;006;098;003;02;304;158;146
001;006;098;004;01;132;72;60
001;006;098;006;01;340;163;177
001;006;098;006;02;336;185;151
001;006;098;007;01;215;121;94
001;006;098;008;01;126;79;47
001;006;098;009;01;367;210;157
001;006;098;010;01;356;198;158
001;006;098;011;01;145;82;63
001;007;098;001;01;416;226;190
001;007;098;001;02;416;241;175
001;007;098;001;03;416;205;211
001;007;098;001;04;416;223;193
001;007;098;001;05;413;209;204
001;007;098;001;06;408;213;195
001;007;098;001;07;408;232;176
001;007;098;002;01;284;154;130
001;007;098;003;01;432;212;220
001;007;098;003;02;432;222;210
001;007;098;003;03;426;243;183
001;007;098;004;01;366;172;194
001;007;098;004;02;360;183;177
001;007;098;004;03;360;191;169
001;007;098;005;01;185;111;74
001;007;098;006;01;173;96;77
001;007;098;008;01;230;137;93
001;008;098;001;01;383;220;163
001;008;098;002;01;89;56;33
001;008;098;003;01;393;194;199
001;008;098;003;02;392;206;186
001;008;098;003;03;392;201;191
001;008;098;003;04;392;204;188
001;008;098;003;05;392;201;191
001;008;098;004;01;352;178;174
001;008;098;004;02;352;187;165
001;008;098;004;03;352;188;164
001;008;098;004;04;345;177;168
001;008;098;005;01;362;199;163
001;008;098;006;01;76;52;24
001;009;098;001;01;419;214;205
001;009;098;001;02;416;206;210
001;009;098;001;03;416;216;200
001;009;098;001;04;416;213;203
001;009;098;002;01;344;144;200
001;009;098;002;02;340;175;165
001;009;098;002;03;336;155;181
001;009;098;002;04;336;157;179
001;009;098;003;01;138;87;51
001;009;098;004;01;200;127;73
001;009;098;005;01;432;223;209
001;009;098;005;02;426;226;200
001;009;098;006;01;407;235;172
001;009;098;007;01;416;217;199
001;009;098;007;02;416;177;239
001;009;098;007;03;416;214;202
001;009;098;007;04;409;190;219
001;009;098;008;01;344;182;162
001;009;098;008;02;344;166;178
001;009;098;008;03;341;171;170
001;009;098;008;04;336;182;154
001;010;098;001;01;258;131;127
001;010;098;002;01;276;143;133
001;010;098;002;02;272;137;135
001;010;098;004;01;336;167;169
001;010;098;004;02;335;171;164
001;010;098;004;03;328;156;172
001;010;098;005;01;415;215;200
001;010;098;006;01;408;206;202
001;010;098;006;02;408;201;207
001;010;098;007;01;320;162;158
001;010;098;007;02;320;164;156
001;010;098;007;03;315;150;165
001;010;098;008;01;352;139;213
001;010;098;008;02;352;160;192
001;010;098;008;03;349;186;163
001;010;098;008;04;344;200;144
001;010;098;009;01;240;117;123
001;010;098;009;02;232;125;107
001;010;098;010;01;400;201;199
001;010;098;010;02;397;209;188
001;010;098;011;01;262;143;119
001;010;098;012;01;368;206;162
001;010;098;012;02;368;208;160
001;010;098;012;03;362;179;183
001;010;098;013;01;195;122;73
001;011;098;001;01;367;180;187
001;011;098;001;02;360;184;176
001;011;098;001;03;360;167;193
001;011;098;002;01;428;216;212
001;011;098;002;02;424;196;228
001;011;098;002;03;424;231;193
001;011;098;003;01;450;238;212
001;011;098;003;02;448;223;225
001;011;098;003;03;448;226;222
001;011;098;003;04;448;208;240
001;011;098;004;01;396;209;187
001;011;098;004;02;392;176;216
001;011;098;005;01;400;192;208
001;011;098;005;02;400;191;209
001;011;098;005;03;400;191;209
001;011;098;005;04;400;197;203
001;011;098;005;05;396;183;213
001;011;098;005;06;392;191;201
002;001;098;001;01;352;156;196
002;001;098;001;02;348;187;161
002;001;098;001;03;344;167;177
002;001;098;002;01;440;232;208
002;001;098;002;02;438;233;205
002;001;098;002;03;432;234;198
002;001;098;002;04;432;230;202
002;001;098;003;01;352;184;168
002;001;098;003;02;352;153;199
002;001;098;003;03;350;180;170
002;001;098;003;04;344;185;159
002;001;098;004;01;419;206;213
002;001;098;004;02;416;209;207
002;001;098;004;03;416;234;182
002;001;098;005;01;368;190;178
002;001;098;005;02;368;177;191
002;001;098;005;03;368;214;154
002;001;098;005;04;364;181;183
002;001;098;006;01;398;192;206
002;001;098;006;02;392;201;191
002;001;098;006;03;392;200;192
002;001;098;006;04;392;186;206
002;001;098;007;01;234;135;99
002;001;098;007;02;232;138;94
002;001;098;008;01;369;243;126
002;001;098;010;01;132;86;46
002;001;098;011;01;104;62;42
002;001;098;013;01;144;84;60
002;002;001;001;01;440;220;220
002;002;001;001;02;432;211;221
002;002;001;001;03;432;206;226
002;002;001;001;04;432;224;208
002;002;001;002;01;440;215;225
002;002;001;002;02;440;212;228
002;002;001;002;03;438;217;221
002;002;001;002;04;432;214;218
002;002;001;002;05;432;212;220
002;002;001;002;06;432;219;213
002;002;001;003;01;408;215;193
002;002;001;003;02;408;225;183
002;002;001;003;03;408;224;184
002;002;001;003;04;408;250;158
002;002;001;003;05;408;202;206
002;002;001;003;06;404;230;174
002;002;001;004;01;447;231;216
002;002;001;004;02;440;222;218
002;002;001;004;03;440;248;192
002;002;001;004;04;440;266;174
002;002;001;005;01;416;217;199
002;002;001;005;02;414;203;211
002;002;001;005;03;408;228;180
002;002;001;005;04;408;216;192
002;002;001;005;05;408;218;190
002;002;001;006;01;321;175;146
002;002;001;006;02;320;169;151
002;002;001;006;03;320;178;142
002;002;001;007;01;437;277;160
002;002;001;008;01;408;206;202
002;002;001;008;02;408;182;226
002;002;001;008;03;406;197;209
002;002;001;009;01;397;218;179
002;002;001;009;02;392;192;200
002;002;001;009;03;392;216;176
002;002;001;009;04;392;206;186
002;002;001;009;05;392;198;194
002;002;001;010;01;408;199;209
002;002;001;010;02;408;212;196
002;002;001;010;03;403;222;181
002;002;001;011;01;424;224;200
002;002;001;011;02;424;213;211
002;002;001;011;03;424;229;195
002;002;001;011;04;424;219;205
002;002;001;011;05;424;233;191
002;002;001;011;06;420;223;197
002;002;001;011;07;416;209;207
002;002;001;011;08;416;213;203
002;002;001;012;01;408;194;214
002;002;001;012;02;403;221;182
002;002;001;012;03;400;208;192
002;002;001;013;01;336;168;168
002;002;001;013;02;336;186;150
002;002;001;013;03;328;170;158
002;002;001;014;01;344;194;150
002;002;001;014;02;344;210;134
002;002;001;014;03;336;205;131
002;002;001;014;04;336;210;126
002;002;001;015;01;162;90;72
002;002;001;016;01;280;170;110
002;002;001;016;02;277;166;111
002;002;001;017;01;336;183;153
002;002;001;017;02;329;181;148
002;002;001;018;01;294;138;156
002;002;001;018;02;288;146;142
002;002;001;019;01;128;92;36
002;002;001;020;01;90;47;43
002;002;001;021;01;112;63;49
002;002;098;001;01;392;230;162
002;002;098;002;01;442;258;184
002;002;098;002;02;440;251;189
002;002;098;002;03;440;243;197
002;002;098;004;01;328;160;168
002;002;098;004;02;328;186;142
003;002;001;001;01;400;215;185
003;002;001;001;02;400;208;192
003;002;001;001;03;394;188;206
003;002;001;001;04;392;194;198
003;002;001;001;05;392;209;183
003;002;001;001;06;392;225;167
003;002;001;002;01;432;219;213
003;002;001;002;02;428;232;196
003;002;001;002;03;424;221;203
003;002;001;002;04;424;214;210
003;002;001;002;05;424;213;211
003;002;001;002;06;424;220;204
003;002;001;002;07;424;221;203
003;002;001;002;08;424;218;206
003;002;001;002;09;424;201;223
003;002;001;002;10;424;225;199
003;002;001;002;11;424;209;215
003;002;001;003;01;448;250;198
003;002;001;003;02;448;266;182
003;002;001;003;03;446;250;196
003;002;001;004;01;360;188;172
003;002;001;004;02;360;196;164
003;002;001;004;03;360;204;156
003;002;001;004;04;356;196;160
003;002;001;005;01;416;215;201
003;002;001;005;02;415;204;211
003;002;001;005;03;408;205;203
003;002;001;005;04;408;186;222
003;002;001;005;05;408;210;198
003;002;001;005;06;408;203;205
003;002;001;005;07;408;211;197
003;002;001;005;08;408;217;191
003;002;001;006;01;450;213;237
003;002;001;006;02;450;224;226
003;002;001;006;03;450;217;233
003;002;001;006;04;449;220;229
003;002;001;006;05;448;218;230
003;002;001;006;06;448;231;217
003;002;001;007;01;312;212;100
003;002;001;007;02;312;205;107
003;002;001;007;03;306;212;94
003;002;001;008;01;310;184;126
003;002;001;009;01;168;89;79
003;002;001;010;01;344;151;193
003;002;001;010;02;344;177;167
003;002;001;010;03;338;162;176
003;002;001;010;04;336;174;162
003;002;001;011;01;372;230;142
003;002;001;012;01;368;198;170
003;002;001;013;01;425;246;179
003;002;001;014;01;334;164;170
003;002;001;014;02;328;182;146
003;002;001;015;01;319;218;101
003;002;001;016;01;316;172;144
003;002;001;017;01;81;49;32
003;002;001;018;01;371;201;170
003;002;001;018;02;368;212;156
003;002;001;019;01;299;158;141
003;002;001;019;02;296;176;120
003;002;001;025;01;296;171;125
003;002;001;025;02;294;171;123
003;002;098;001;01;449;243;206
003;002;098;003;01;211;140;71
003;002;098;004;01;242;124;118
003;002;098;004;02;240;130;110
003;002;098;005;01;304;145;159
003;002;098;005;02;299;159;140
003;002;098;006;01;400;213;187
003;002;098;006;02;400;212;188
003;002;098;006;03;400;199;201
003;002;098;006;04;400;214;186
003;002;098;006;05;400;197;203
003;002;098;006;06;398;226;172
003;002;098;006;07;392;222;170
003;002;098;007;01;58;34;24
003;002;098;008;01;400;218;182
003;002;098;008;02;394;234;160
003;002;098;009;01;211;123;88
003;002;098;010;01;143;84;59
003;002;098;011;01;99;55;44
003;002;098;012;01;80;47;33
003;002;098;015;01;102;60;42
003;002;098;018;01;236;133;103
003;002;098;020;01;380;207;173
003;002;098;021;01;171;92;79
003;002;098;022;01;148;93;55
003;003;098;001;01;416;230;186
003;003;098;002;01;376;173;203
003;003;098;002;02;368;157;211
003;003;098;002;03;368;185;183
003;003;098;002;04;368;200;168
003;003;098;003;01;342;194;148
003;003;098;003;02;336;188;148
003;003;098;003;03;336;192;144
003;003;098;005;01;368;191;177
003;003;098;005;02;368;193;175
003;003;098;005;03;363;186;177
003;003;098;006;01;339;219;120
003;003;098;007;01;279;158;121
003;003;098;007;02;272;145;127
003;003;098;008;01;221;115;106
003;003;098;009;01;334;172;162
003;003;098;009;02;328;182;146
003;003;098;009;03;328;193;135
003;003;098;010;01;411;213;198
003;003;098;010;02;408;233;175
003;003;098;010;03;408;208;200
003;003;098;010;04;408;214;194
003;003;098;011;01;96;59;37
003;003;098;013;01;226;151;75
003;003;098;014;01;138;78;60
003;003;098;015;01;33;19;14
003;004;098;001;01;360;195;165
003;004;098;001;02;360;208;152
003;004;098;001;03;353;188;165
003;004;098;002;01;240;124;116
003;004;098;002;02;235;125;110
003;004;098;003;01;375;205;170
003;004;098;003;02;368;210;158
003;004;098;004;01;432;208;224
003;004;098;004;02;432;217;215
003;004;098;005;01;304;158;146
003;004;098;005;02;301;159;142
003;004;098;006;01;259;156;103
003;004;098;007;01;269;151;118
003;004;098;007;02;264;149;115
003;004;098;008;01;403;215;188
003;004;098;009;01;352;211;141
003;004;098;009;02;350;196;154
003;004;098;010;01;400;211;189
003;004;098;011;01;118;63;55
003;004;098;012;01;348;183;165
003;004;098;012;02;344;166;178
003;004;098;012;03;344;195;149
003;004;098;013;01;296;171;125
003;004;098;014;01;181;113;68
003;004;098;015;01;113;72;41
003;004;098;016;01;306;170;136
003;004;098;017;01;150;73;77
003;004;098;018;01;111;56;55
003;004;098;019;01;226;124;102
003;004;098;020;01;185;99;86
003;004;098;021;01;319;189;130
003;004;098;022;01;213;121;92
003;004;098;023;01;71;37;34
003;004;098;024;01;338;167;171
003;004;098;024;02;336;157;179
003;004;098;024;03;336;181;155
003;004;098;025;01;170;101;69
003;004;098;026;01;62;37;25
003;004;098;027;01;132;79;53
003;004;098;028;01;117;67;50
003;004;098;029;01;107;62;45
003;005;001;001;01;400;190;210
003;005;001;001;02;400;178;222
003;005;001;001;03;399;202;197
003;005;001;002;01;434;237;197
003;005;001;003;01;432;223;209
003;005;001;003;02;432;231;201
003;005;001;003;03;432;241;191
003;005;001;003;04;430;232;198
003;005;001;004;01;257;150;107
003;005;001;004;02;256;129;127
003;005;001;005;01;408;178;230
003;005;001;005;02;408;211;197
003;005;001;005;03;400;213;187
003;005;001;005;04;400;212;188
003;005;001;006;01;387;206;181
003;005;001;006;02;384;222;162
003;005;001;006;03;384;217;167
003;005;001;007;01;416;199;217
003;005;001;007;02;416;219;197
003;005;001;007;03;416;229;187
003;005;001;007;04;416;165;251
003;005;001;007;05;416;233;183
003;005;001;007;06;416;226;190
003;005;001;007;07;416;198;218
003;005;001;007;08;416;227;189
003;005;001;007;09;413;191;222
003;005;001;008;01;400;208;192
003;005;001;008;02;400;188;212
003;005;001;008;03;400;219;181
003;005;001;008;04;400;213;187
003;005;001;008;05;400;234;166
003;005;001;008;06;392;193;199
003;005;001;009;01;424;236;188
003;005;001;009;02;424;219;205
003;005;001;009;03;424;198;226
003;005;001;009;04;424;228;196
003;005;001;009;05;424;225;199
003;005;001;009;06;424;213;211
003;005;001;009;07;424;220;204
003;005;001;009;08;424;240;184
003;005;001;009;09;423;244;179
003;005;001;010;01;450;248;202
003;005;001;010;02;450;226;224
003;005;001;010;03;450;261;189
003;005;001;011;01;440;248;192
003;005;001;011;02;440;238;202
003;005;001;011;03;436;249;187
003;005;001;012;01;216;121;95
003;005;001;013;01;172;91;81
003;005;001;014;01;133;74;59
003;005;001;015;01;207;108;99
003;005;001;016;01;333;186;147
003;005;001;017;01;233;153;80
003;005;001;018;01;124;70;54
003;005;098;001;01;205;130;75
003;005;098;002;01;450;229;221
003;005;098;002;02;450;226;224
003;005;098;003;01;43;29;14
003;005;098;004;01;112;80;32
003;005;098;009;01;188;107;81
003;005;098;010;01;133;65;68
003;005;098;011;01;136;85;51
003;005;098;012;01;74;48;26
003;005;098;013;01;64;29;35
003;005;098;014;01;195;118;77
003;005;098;015;01;301;168;133
003;005;098;016;01;107;55;52
003;005;098;018;01;182;95;87
003;005;098;019;01;301;163;138
004;001;001;001;01;424;216;208
004;001;001;001;02;417;216;201
004;001;001;002;01;288;125;163
004;001;001;002;02;281;140;141
004;001;001;003;01;379;187;192
004;001;001;004;01;155;92;63
004;001;001;005;01;221;132;89
004;001;001;006;01;323;163;160
004;001;001;007;01;243;124;119
004;001;001;008;01;105;52;53
004;001;001;009;01;365;190;175
004;001;001;010;01;58;34;24
004;001;001;011;01;336;157;179
004;001;001;011;02;335;168;167
004;001;001;012;01;86;43;43
004;001;001;013;01;359;179;180
004;001;001;014;01;346;211;135
004;001;001;015;01;194;93;101
004;001;001;016;01;156;82;74
004;001;001;017;01;375;207;168
004;001;001;020;01;119;66;53
004;001;098;001;01;113;59;54
004;001;098;002;01;186;106;80
004;001;098;003;01;196;110;86
004;001;098;004;01;85;51;34
004;001;098;005;01;86;46;40
004;001;098;006;01;194;87;107
004;001;098;007;01;103;64;39
004;001;098;008;01;88;47;41
004;001;098;009;01;103;60;43
004;001;098;010;01;449;220;229
004;001;098;011;01;187;111;76
004;001;098;012;01;175;79;96
004;001;098;013;01;90;49;41
004;001;098;014;01;174;107;67
004;001;098;015;01;297;155;142
004;001;098;016;01;106;47;59
004;001;098;017;01;121;62;59
004;001;098;018;01;106;61;45
004;001;098;019;01;341;184;157
004;001;098;020;01;73;44;29
004;002;001;001;01;440;209;231
004;002;001;001;02;435;227;208
004;002;001;001;03;432;216;216
004;002;001;002;01;280;137;143
004;002;001;002;02;280;154;126
004;002;001;003;01;238;141;97
004;002;001;004;01;66;34;32
004;002;001;005;01;108;63;45
004;002;098;001;01;122;62;60
004;002;098;002;01;265;141;124
004;002;098;003;01;75;42;33
004;002;098;004;01;81;41;40
004;002;098;006;01;296;151;145
004;002;098;006;02;292;136;156
004;006;001;001;01;408;239;169
004;006;001;001;02;408;201;207
004;006;001;001;03;408;202;206
004;006;001;001;04;408;195;213
004;006;001;001;05;404;197;207
004;006;001;001;06;400;218;182
004;006;001;002;01;320;168;152
004;006;001;002;02;317;184;133
004;006;001;003;01;320;170;150
004;006;001;003;02;320;157;163
004;006;001;003;03;315;194;121
004;006;001;004;01;400;225;175
004;006;001;004;02;392;228;164
004;006;001;005;01;247;119;128
004;006;001;006;01;338;154;184
004;006;001;006;02;336;169;167
004;006;001;007;01;381;180;201
004;006;001;007;02;376;170;206
004;006;001;008;01;356;174;182
004;006;001;008;02;352;180;172
004;006;001;009;01;338;154;184
004;006;001;009;02;336;180;156
004;006;001;009;03;336;189;147
004;006;098;001;01;146;70;76
004;006;098;002;01;97;71;26
004;006;098;003;01;161;78;83
004;006;098;004;01;294;140;154
004;006;098;005;01;109;59;50
004;006;098;006;01;375;179;196
004;006;098;007;01;277;141;136
004;006;098;007;02;272;156;116
004;006;098;008;01;240;138;102
004;006;098;008;02;235;139;96
004;006;098;009;01;256;155;101
004;006;098;009;02;253;155;98
004;006;098;010;01;378;200;178
004;006;098;010;02;376;222;154
004;006;098;010;03;376;214;162
004;006;098;011;01;307;181;126
004;006;098;012;01;96;56;40
004;006;098;013;01;316;185;131
004;006;098;013;02;312;194;118
004;007;098;001;01;137;66;71
004;007;098;002;01;259;125;134
004;007;098;003;01;236;125;111
004;007;098;004;01;149;86;63
004;007;098;005;01;204;98;106
004;007;098;006;01;144;75;69
004;007;098;007;01;109;62;47
004;007;098;008;01;368;158;210
004;007;098;008;02;364;171;193
004;007;098;009;01;147;76;71
004;008;098;001;01;131;68;63
004;008;098;002;01;217;107;110
004;008;098;003;01;240;130;110
004;008;098;003;02;234;107;127
004;008;098;004;01;432;201;231
004;008;098;004;02;432;210;222
004;008;098;004;03;424;223;201
004;008;098;005;01;269;145;124
004;008;098;006;01;146;81;65
004;008;098;007;01;361;191;170
004;008;098;008;01;208;101;107
004;008;098;009;01;167;91;76
005;005;001;001;01;327;167;160
005;005;001;001;02;320;158;162
005;005;001;001;03;320;196;124
005;005;001;002;01;347;168;179
005;005;001;003;01;231;113;118
005;005;001;004;01;328;168;160
005;005;001;004;02;321;157;164
005;005;001;005;01;107;47;60
005;005;001;006;01;272;127;145
005;005;001;007;01;227;107;120
005;005;001;007;02;224;116;108
005;005;001;008;01;304;156;148
005;005;001;008;02;304;160;144
005;005;001;008;03;297;143;154
005;005;001;009;01;79;41;38
005;005;001;010;01;138;75;63
005;005;001;011;01;194;97;97
005;005;001;012;01;84;43;41
005;005;001;013;01;120;70;50
005;005;001;014;01;141;66;75
005;005;001;015;01;147;91;56
005;005;098;001;01;161;78;83
005;005;098;002;01;324;178;146
005;005;098;005;01;156;90;66
005;007;001;001;01;448;231;217
005;007;001;001;02;448;213;235
005;007;001;001;03;446;235;211
005;007;001;001;04;440;226;214
005;007;001;002;01;441;189;252
005;007;001;002;02;440;195;245
005;007;001;002;03;440;207;233
005;007;001;003;01;296;161;135
005;007;001;003;02;289;133;156
005;007;001;004;01;272;107;165
005;007;001;004;02;269;133;136
005;007;001;005;01;263;127;136
005;007;001;005;02;256;118;138
005;007;001;006;01;155;82;73
005;007;001;007;01;278;131;147
005;007;001;008;01;426;203;223
005;007;001;009;01;266;138;128
005;007;001;010;01;448;199;249
005;007;001;010;02;448;200;248
005;007;001;011;01;289;129;160
005;007;001;012;01;179;84;95
005;007;001;013;01;326;152;174
005;007;001;014;01;382;172;210
005;007;001;015;01;130;58;72
005;007;001;016;01;244;116;128
005;007;098;001;01;186;91;95
005;007;098;002;01;117;63;54
005;007;098;003;01;227;126;101
005;007;098;004;01;134;78;56
005;007;098;005;01;193;100;93
005;007;098;006;01;73;34;39
005;007;098;007;01;89;41;48
005;007;098;008;01;40;14;26
005;007;098;009;01;102;42;60
005;007;098;010;01;273;137;136
005;007;098;011;01;310;153;157
005;007;098;012;01;371;168;203
005;007;098;013;01;197;95;102
005;007;098;014;01;280;126;154
005;007;098;015;01;127;58;69
005;007;098;016;01;447;198;249
005;007;098;017;01;137;66;71
005;007;098;018;01;132;62;70
005;008;098;001;01;182;76;106
005;008;098;002;01;137;64;73
005;008;098;003;01;439;195;244
005;008;098;004;01;157;70;87
005;008;098;005;01;364;183;181
005;008;098;006;01;48;23;25
005;008;098;007;01;100;55;45
005;008;098;008;01;111;52;59
005;008;098;009;01;80;42;38
005;008;098;010;01;115;55;60
005;008;098;011;01;235;105;130
005;008;098;013;01;216;109;107
005;008;098;014;01;63;29;34
005;009;098;001;01;128;65;63
005;009;098;002;01;240;110;130
005;009;098;003;01;82;40;42
005;009;098;004;01;376;191;185
005;009;098;005;01;317;147;170
005;009;098;006;01;99;52;47
005;009;098;007;01;117;58;59
005;009;098;008;01;197;102;95
005;010;098;001;01;273;127;146
005;010;098;002;01;322;141;181
005;010;098;002;02;320;162;158
005;010;098;002;03;320;139;181
005;010;098;003;01;86;42;44
005;010;098;004;01;154;68;86
005;010;098;005;01;64;33;31
005;011;098;001;01;64;32;32
005;011;098;002;01;346;166;180
005;011;098;003;01;447;174;273
005;011;098;003;02;440;239;201
005;011;098;004;01;202;93;109
005;011;098;005;01;133;67;66
005;011;098;006;01;208;101;107
005;011;098;007;01;210;96;114
005;011;098;008;01;279;155;124
005;011;098;009;01;333;152;181
005;011;098;010;01;85;44;41
006;003;098;001;01;236;132;104
006;003;098;002;01;88;43;45
006;003;098;003;01;403;220;183
006;003;098;004;01;409;244;165
006;003;098;005;01;299;172;127
006;003;098;006;01;123;68;55
006;003;098;007;01;274;128;146
006;003;098;008;01;279;158;121
006;003;098;009;01;129;71;58
006;003;098;010;01;203;108;95
006;003;098;011;01;356;184;172
006;003;098;012;01;446;252;194
006;003;098;013;01;388;199;189
006;003;098;014;01;153;79;74
006;003;098;015;01;93;46;47
006;003;098;016;01;71;37;34
006;003;098;017;01;215;119;96
006;003;098;018;01;160;71;89
006;003;098;019;01;82;41;41
006;003;098;020;01;382;206;176
006;003;098;020;02;376;219;157
006;003;098;021;01;231;129;102
006;003;098;022;01;157;83;74
006;003;098;023;01;265;112;153
006;003;098;024;01;123;61;62
006;003;098;025;01;182;82;100
006;003;098;026;01;179;99;80
006;003;098;027;01;267;120;147
006;003;098;028;01;232;98;134
006;003;098;028;02;231;110;121
006;003;098;029;01;300;150;150
006;003;098;030;01;112;49;63
006;003;098;031;01;148;70;78
006;003;098;032;01;141;75;66
006;003;098;033;01;111;61;50
006;003;098;034;01;266;140;126
006;003;098;035;01;247;124;123
006;003;098;036;01;107;50;57
006;003;098;037;01;109;56;53
006;004;001;001;01;419;158;261
006;004;001;001;02;416;202;214
006;004;001;001;03;416;217;199
006;004;001;002;01;231;116;115
006;004;001;003;01;216;118;98
006;004;001;004;01;240;140;100
006;004;001;004;02;232;155;77
006;004;001;005;01;364;201;163
006;004;001;005;02;360;176;184
006;004;001;005;03;360;216;144
006;004;001;006;01;345;160;185
006;004;001;007;01;142;83;59
006;004;001;008;01;241;127;114
006;004;001;009;01;241;138;103
006;004;098;001;01;327;175;152
006;004;098;002;01;171;91;80
006;004;098;003;01;372;217;155
006;004;098;004;01;157;89;68
006;004;098;005;01;336;159;177
006;004;098;006;01;340;173;167
006;004;098;007;01;101;51;50
006;004;098;008;01;125;64;61
006;004;098;009;01;152;112;40
006;008;001;001;01;392;170;222
006;008;001;001;02;392;199;193
006;008;001;001;03;390;183;207
006;008;001;002;01;280;150;130
006;008;001;002;02;279;161;118
006;008;001;003;01;416;207;209
006;008;001;003;02;416;180;236
006;008;001;003;03;409;201;208
006;008;001;004;01;312;172;140
006;008;001;004;02;308;182;126
006;008;001;004;03;304;174;130
006;008;001;005;01;320;181;139
006;008;001;005;02;317;187;130
006;008;001;006;01;368;177;191
006;008;001;006;02;368;161;207
006;008;001;006;03;368;171;197
006;008;001;006;04;368;163;205
006;008;001;006;05;365;185;180
006;008;001;007;01;392;220;172
006;008;001;007;02;392;232;160
006;008;001;007;03;388;202;186
006;008;001;007;04;384;207;177
006;008;001;008;01;434;231;203
006;008;001;008;02;432;253;179
006;008;001;009;01;317;162;155
006;008;001;010;01;424;209;215
006;008;001;010;02;424;195;229
006;008;001;010;03;423;229;194
006;008;001;011;01;263;120;143
006;008;001;012;01;251;150;101
006;008;001;013;01;170;81;89
006;008;001;014;01;145;76;69
006;008;001;015;01;184;94;90
006;008;001;016;01;251;121;130
006;008;001;017;01;121;61;60
006;008;001;018;01;90;38;52
006;008;001;019;01;158;74;84
006;008;001;020;01;133;63;70
006;008;001;021;01;206;96;110
006;008;001;022;01;385;181;204
006;008;001;023;01;307;157;150
006;008;001;023;02;304;157;147
006;008;001;024;01;335;140;195
006;008;001;024;02;328;141;187
006;008;001;024;03;328;161;167
006;008;001;025;01;312;159;153
006;008;001;025;02;309;157;152
006;008;098;001;01;55;26;29
006;008;098;002;01;400;197;203
006;008;098;003;01;147;73;74
006;008;098;004;01;256;124;132
006;008;098;005;01;177;83;94
006;008;098;006;01;231;112;119
006;008;098;007;01;240;118;122
006;008;098;008;01;109;53;56
006;008;098;009;01;55;32;23
006;008;098;010;01;77;36;41
006;008;098;011;01;101;43;58
006;008;098;012;01;358;163;195
006;008;098;013;01;61;28;33
006;008;098;014;01;81;40;41
006;008;098;016;01;172;79;93
006;008;098;017;01;119;54;65
006;008;098;018;01;125;54;71
006;008;098;019;01;174;87;87
006;008;098;020;01;111;51;60
006;008;098;021;01;295;150;145
006;008;098;022;01;170;78;92
006;008;098;023;01;83;53;30
006;008;098;024;01;118;56;62
006;009;098;001;01;174;92;82
006;009;098;002;01;289;132;157
006;009;098;003;01;369;150;219
006;009;098;003;02;368;195;173
006;009;098;004;01;197;95;102
006;009;098;005;01;108;48;60
006;009;098;006;01;109;44;65
006;009;098;007;01;119;53;66
006;009;098;008;01;226;121;105
006;009;098;009;01;405;184;221
006;009;098;010;01;343;176;167
007;001;001;001;01;392;200;192
007;001;001;001;02;392;193;199
007;001;001;001;03;392;188;204
007;001;001;001;04;392;195;197
007;001;001;001;05;392;178;214
007;001;001;001;06;392;186;206
007;001;001;001;07;386;202;184
007;001;001;002;01;416;224;192
007;001;001;002;02;412;197;215
007;001;001;002;03;408;203;205
007;001;001;002;04;408;222;186
007;001;001;003;01;376;189;187
007;001;001;003;02;376;186;190
007;001;001;003;03;376;207;169
007;001;001;003;04;376;176;200
007;001;001;003;05;374;201;173
007;001;001;004;01;432;223;209
007;001;001;004;02;432;199;233
007;001;001;004;03;432;210;222
007;001;001;004;04;432;185;247
007;001;001;004;05;432;234;198
007;001;001;004;06;432;214;218
007;001;001;004;07;432;216;216
007;001;001;004;08;429;198;231
007;001;001;004;09;424;210;214
007;001;001;004;10;424;222;202
007;001;001;005;01;328;189;139
007;001;001;005;02;328;180;148
007;001;001;005;03;327;195;132
007;001;001;006;01;400;221;179
007;001;001;006;02;400;224;176
007;001;001;006;03;392;211;181
007;001;001;006;04;392;221;171
007;001;001;006;05;392;214;178
007;001;001;007;01;446;229;217
007;001;001;007;02;440;210;230
007;001;001;007;03;440;217;223
007;001;001;007;04;440;232;208
007;001;001;007;05;440;229;211
007;001;001;008;01;376;191;185
007;001;001;008;02;376;194;182
007;001;001;008;03;374;198;176
007;001;001;008;04;368;191;177
007;001;001;008;05;368;209;159
007;001;001;009;01;384;187;197
007;001;001;009;02;383;196;187
007;001;001;009;03;376;199;177
007;001;001;009;04;376;205;171
007;001;001;009;05;376;173;203
007;001;001;009;06;376;186;190
007;001;001;010;01;445;203;242
007;001;001;010;02;440;198;242
007;001;001;011;01;328;160;168
007;001;001;011;02;328;178;150
007;001;001;012;01;243;114;129
007;001;001;013;01;368;170;198
007;001;001;013;02;362;173;189
007;001;001;013;03;360;191;169
007;001;001;014;01;424;245;179
007;001;001;014;02;418;215;203
007;001;001;014;03;416;226;190
007;001;001;015;01;350;174;176
007;001;001;015;02;344;166;178
007;001;001;016;01;359;175;184
007;001;001;017;01;193;101;92
007;001;098;001;01;392;186;206
007;001;098;001;02;388;192;196
007;001;098;002;01;240;138;102
007;001;098;002;02;233;139;94
007;001;098;003;01;340;181;159
007;001;098;004;01;254;120;134
007;001;098;005;01;352;178;174
007;001;098;005;02;344;159;185
007;001;098;006;01;300;142;158
007;001;098;007;01;264;115;149
007;001;098;007;02;257;135;122
007;001;098;008;01;360;179;181
007;001;098;008;02;355;179;176
007;001;098;009;01;337;165;172
007;001;098;010;01;105;65;40
007;001;098;011;01;177;101;76
007;001;098;012;01;210;109;101
007;001;098;013;01;250;126;124
007;001;098;014;01;352;184;168
007;001;098;015;01;47;27;20
007;003;001;001;01;384;200;184
007;003;001;001;02;380;199;181
007;003;001;002;01;336;157;179
007;003;001;002;02;330;162;168
007;003;001;003;01;392;160;232
007;003;001;003;02;392;164;228
007;003;001;003;03;385;215;170
007;003;001;004;01;438;225;213
007;003;001;004;02;432;211;221
007;003;001;005;01;363;183;180
007;003;001;006;01;427;207;220
007;003;001;007;01;425;203;222
007;003;001;008;01;245;148;97
007;003;001;009;01;389;196;193
007;003;001;010;01;102;63;39
007;003;098;001;01;287;159;128
007;003;098;002;01;146;73;73
007;003;098;003;01;392;215;177
007;003;098;003;02;386;188;198
007;003;098;004;01;416;208;208
007;003;098;004;02;416;214;202
007;003;098;005;01;368;154;214
007;003;098;005;02;368;213;155
007;003;098;005;03;363;162;201
007;003;098;005;04;360;194;166
007;003;098;006;01;373;174;199
007;003;098;006;02;368;208;160
007;003;098;007;01;359;177;182
007;003;098;008;01;203;129;74
007;003;098;009;01;175;98;77
007;003;098;010;01;320;153;167
007;003;098;010;02;320;170;150
007;003;098;011;01;119;71;48
007;004;098;001;01;376;172;204
007;004;098;001;02;376;184;192
007;004;098;001;03;369;223;146
007;004;098;001;04;368;184;184
007;004;098;002;01;436;222;214
007;005;098;001;01;234;121;113
007;005;098;002;01;332;178;154
007;005;098;002;02;328;153;175
007;005;098;002;03;328;151;177
007;005;098;003;01;339;178;161
007;005;098;004;01;344;159;185
007;005;098;004;02;344;182;162
007;005;098;004;03;342;153;189
007;005;098;005;01;285;140;145
007;005;098;006;01;187;93;94
007;005;098;007;01;355;175;180
007;005;098;008;01;410;183;227
007;005;098;009;01;392;188;204
007;005;098;009;02;385;177;208
007;005;098;010;01;205;113;92
007;005;098;011;01;194;103;91
007;005;098;012;01;322;150;172
007;005;098;013;01;385;194;191
007;005;098;014;01;198;114;84
007;005;098;015;01;130;83;47
007;005;098;016;01;59;33;26
007;006;098;001;01;257;122;135
007;006;098;001;02;256;112;144
007;006;098;002;01;328;166;162
007;006;098;002;02;327;162;165
007;006;098;003;01;243;102;141
007;006;098;003;02;240;125;115
007;006;098;004;01;159;82;77
007;006;098;005;01;339;172;167
007;006;098;006;01;433;234;199
007;006;098;007;01;400;223;177
007;006;098;007;02;400;191;209
007;006;098;007;03;398;191;207
007;006;098;007;04;392;210;182
007;006;098;008;01;288;153;135
007;006;098;008;02;283;140;143
007;006;098;009;01;104;57;47
007;006;098;010;01;290;136;154
007;006;098;011;01;134;70;64
007;006;098;012;01;174;93;81
007;006;098;013;01;175;90;85
007;006;098;014;01;78;45;33
007;006;098;015;01;77;44;33
007;006;098;016;01;303;144;159
007;006;098;017;01;108;63;45
007;006;098;018;01;45;23;22
008;002;001;001;01;366;171;195
008;002;001;001;02;360;188;172
008;002;001;001;03;360;143;217
008;002;001;001;04;360;195;165
008;002;001;002;01;368;200;168
008;002;001;002;02;363;173;190
008;002;001;002;03;360;182;178
008;002;001;002;04;360;172;188
008;002;001;002;05;360;193;167
008;002;001;003;01;400;184;216
008;002;001;003;02;400;190;210
008;002;001;003;03;395;185;210
008;002;001;004;01;402;188;214
008;002;001;005;01;401;213;188
008;002;098;001;01;447;206;241
008;002;098;002;01;376;201;175
008;002;098;002;02;376;193;183
008;002;098;002;03;376;175;201
008;002;098;002;04;372;173;199
008;002;098;003;01;328;156;172
008;002;098;003;02;327;167;160
008;002;098;004;01;351;180;171
008;002;098;005;01;304;142;162
008;002;098;005;02;301;135;166
008;002;098;005;03;296;126;170
008;002;098;006;01;201;88;113
008;002;098;007;01;432;196;236
008;002;098;007;02;425;215;210
008;002;098;007;03;424;182;242
008;002;098;007;04;424;199;225
008;002;098;008;01;300;149;151
008;004;001;001;01;448;205;243
008;004;001;001;02;448;203;245
008;004;001;001;03;442;209;233
008;004;001;001;04;440;205;235
008;004;001;002;01;332;184;148
008;004;001;002;02;328;165;163
008;004;001;002;03;328;156;172
008;004;001;003;01;423;202;221
008;004;001;003;02;416;204;212
008;004;001;004;01;392;200;192
008;004;001;004;02;392;148;244
008;004;001;004;03;392;183;209
008;004;001;005;01;125;68;57
008;004;001;006;01;123;74;49
008;004;098;001;01;400;192;208
008;004;098;001;02;399;183;216
008;004;098;002;01;424;206;218
008;004;098;002;02;418;199;219
008;004;098;003;01;404;197;207
008;004;098;004;01;328;175;153
008;004;098;004;02;327;155;172
008;004;098;005;01;326;140;186
008;004;098;005;02;320;156;164
008;004;098;006;01;293;139;154
008;004;098;006;02;288;133;155
008;004;098;007;01;171;92;79
008;004;098;008;01;304;144;160
008;004;098;008;02;301;142;159
008;004;098;009;01;263;128;135
008;004;098;009;02;256;114;142
008;004;098;010;01;302;146;156
008;005;001;001;01;344;185;159
008;005;001;001;02;340;160;180
008;005;001;001;03;336;179;157
008;005;001;001;04;336;169;167
008;005;001;002;01;365;208;157
008;005;001;002;02;360;177;183
008;005;001;002;03;360;190;170
008;005;001;002;04;360;186;174
008;005;001;003;01;392;220;172
008;005;001;003;02;392;197;195
008;005;001;003;03;384;171;213
008;005;001;003;04;384;189;195
008;005;001;004;01;344;173;171
008;005;001;004;02;344;165;179
008;005;001;004;03;344;163;181
008;005;001;005;01;408;183;225
008;005;001;005;02;405;185;220
008;005;001;005;03;400;187;213
008;005;001;006;01;365;169;196
008;005;001;007;01;275;143;132
008;005;001;007;02;272;123;149
008;005;001;008;01;153;60;93
008;005;001;009;01;341;143;198
008;005;098;001;01;248;117;131
008;005;098;001;02;246;120;126
008;005;098;002;01;317;145;172
008;005;098;002;02;312;134;178
008;005;098;002;03;312;121;191
008;005;098;003;01;240;134;106
008;005;098;003;02;232;107;125
008;005;098;004;01;376;176;200
008;005;098;004;02;375;180;195
008;005;098;005;01;368;179;189
008;005;098;005;02;365;161;204
008;005;098;005;03;360;142;218
008;005;098;005;04;360;166;194
008;005;098;005;05;360;172;188
008;005;098;006;01;448;212;236
008;005;098;006;02;448;230;218
008;005;098;006;03;448;199;249
008;005;098;006;04;447;222;225
008;005;098;007;01;403;205;198
008;005;098;008;01;115;51;64
008;006;098;001;01;341;149;192
008;006;098;001;02;336;150;186
008;006;098;002;01;397;198;199
008;006;098;002;02;392;168;224
008;006;098;002;03;392;199;193
008;006;098;002;04;392;176;216
008;006;098;003;01;270;118;152
008;006;098;004;01;384;178;206
008;006;098;004;02;379;171;208
008;006;098;005;01;403;173;230
008;006;098;006;01;294;154;140
008;006;098;006;02;288;106;182
008;006;098;007;01;237;122;115
008;006;098;008;01;187;114;73
008;006;098;009;01;303;143;160
008;006;098;010;01;124;76;48
008;007;098;001;01;312;144;168
008;007;098;001;02;312;160;152
008;007;098;001;03;304;144;160
008;007;098;002;01;400;200;200
008;007;098;002;02;400;194;206
008;007;098;002;03;400;160;240
008;007;098;002;04;398;203;195
008;007;098;003;01;445;207;238
008;007;098;003;02;440;206;234
008;007;098;004;01;226;116;110
008;007;098;005;01;248;130;118
008;007;098;005;02;243;110;133
008;007;098;006;01;368;182;186
008;007;098;006;02;365;173;192
008;007;098;006;03;360;154;206
008;007;098;006;04;360;163;197
008;007;098;007;01;416;203;213
008;007;098;007;02;413;212;201
008;007;098;007;03;408;185;223
008;007;098;007;04;408;213;195
008;007;098;008;01;360;212;148
008;007;098;008;02;360;192;168
008;007;098;008;03;360;197;163
008;007;098;009;01;400;209;191
008;007;098;009;02;394;179;215
008;007;098;009;03;392;187;205
009;001;001;001;01;408;195;213
009;001;001;001;02;407;219;188
009;001;001;001;03;400;219;181
009;001;001;001;04;400;181;219
009;001;001;001;05;400;214;186
009;001;001;001;06;400;222;178
009;001;001;002;01;140;70;70
009;001;001;003;01;306;153;153
009;001;001;003;02;304;152;152
009;001;001;004;01;440;186;254
009;001;001;004;02;440;219;221
009;001;001;004;03;435;196;239
009;001;001;005;01;344;160;184
009;001;001;005;02;342;172;170
009;001;001;006;01;336;178;158
009;001;001;006;02;336;161;175
009;001;001;007;01;422;207;215
009;001;001;007;02;416;217;199
009;001;001;008;01;384;228;156
009;001;001;009;01;167;108;59
009;002;001;001;01;432;214;218
009;002;001;001;02;429;200;229
009;002;001;001;03;424;206;218
009;002;001;001;04;424;196;228
009;002;001;001;05;424;229;195
009;002;001;002;01;422;213;209
009;002;001;002;02;416;207;209
009;002;001;002;03;416;214;202
009;002;001;003;01;408;229;179
009;002;001;003;02;408;238;170
009;002;001;003;03;408;214;194
009;002;001;003;04;408;235;173
009;002;001;003;05;403;230;173
009;002;001;004;01;360;203;157
009;002;001;004;02;356;176;180
009;002;001;004;03;352;177;175
009;002;001;005;01;360;204;156
009;002;001;005;02;360;210;150
009;002;001;005;03;355;174;181
009;002;001;005;04;352;211;141
009;002;001;006;01;434;243;191
009;002;001;006;02;432;216;216
009;002;001;006;03;432;231;201
009;002;001;006;04;432;214;218
009;002;001;006;05;432;196;236
009;002;001;006;06;432;231;201
009;002;001;006;07;432;231;201
009;002;001;006;08;432;234;198
009;002;001;008;01;384;253;131
009;002;001;008;02;384;256;128
009;002;001;009;01;174;89;85
009;002;001;010;01;278;141;137
009;002;001;011;01;238;113;125
009;002;001;012;01;358;183;175
009;002;001;013;01;133;59;74
009;002;001;014;01;304;144;160
009;002;001;015;01;272;138;134
009;002;001;016;01;207;109;98
009;002;001;017;01;115;63;52
009;002;001;018;01;250;126;124
009;002;001;019;01;169;89;80
009;002;001;020;01;211;110;101
009;002;001;021;01;214;103;111
009;002;001;022;01;428;207;221
009;002;001;023;01;272;119;153
009;002;001;023;02;265;128;137
009;002;001;024;01;312;182;130
009;002;001;024;02;307;165;142
009;002;098;001;01;439;201;238
009;002;098;001;02;432;229;203
009;002;098;001;03;432;197;235
009;002;098;001;04;432;186;246
009;002;098;002;01;320;130;190
009;002;098;002;02;319;163;156
009;002;098;003;01;425;201;224
009;002;098;003;02;424;195;229
009;002;098;004;01;432;216;216
009;002;098;004;02;432;196;236
009;002;098;004;03;431;189;242
009;002;098;005;01;213;105;108
009;002;098;006;01;312;136;176
009;002;098;006;02;312;141;171
009;002;098;006;03;308;166;142
009;002;098;007;01;416;194;222
009;002;098;007;02;414;185;229
009;002;098;007;03;408;197;211
009;002;098;007;04;408;198;210
009;002;098;008;01;303;140;163
009;002;098;009;01;300;132;168
009;002;098;010;01;364;182;182
009;002;098;011;01;157;75;82
009;002;098;012;01;355;188;167
009;002;098;013;01;86;44;42
009;003;098;001;01;376;192;184
009;003;098;001;02;375;169;206
009;003;098;001;03;368;180;188
009;003;098;002;01;184;83;101
009;003;098;003;01;392;183;209
009;003;098;004;01;97;52;45
009;004;098;001;01;286;145;141
009;004;098;002;01;310;151;159
009;004;098;003;01;78;38;40
009;004;098;004;01;116;65;51
009;004;098;005;01;163;92;71
009;004;098;006;01;420;210;210
009;004;098;006;02;416;216;200
009;004;098;006;03;416;243;173
009;004;098;007;01;43;22;21
009;004;098;008;01;113;62;51
010;002;001;001;01;384;189;195
010;002;001;001;02;384;211;173
010;002;001;001;03;384;195;189
010;002;001;001;04;378;199;179
010;002;001;002;01;392;214;178
010;002;001;002;02;392;177;215
010;002;001;002;03;389;214;175
010;002;001;002;04;384;182;202
010;002;001;003;01;400;195;205
010;002;001;004;01;248;102;146
010;002;001;004;02;244;117;127
010;002;001;005;01;252;123;129
010;002;001;006;01;290;125;165
010;002;001;006;02;288;141;147
010;002;001;007;01;240;104;136
010;002;001;007;02;236;115;121
010;002;001;008;01;404;189;215
010;002;001;008;02;400;183;217
010;002;001;009;01;167;78;89
010;002;001;010;01;359;154;205
010;002;001;011;01;369;225;144
010;002;001;012;01;264;128;136
010;002;001;013;01;298;160;138
010;002;001;014;01;258;159;99
010;002;001;015;01;340;176;164
010;002;001;016;01;448;245;203
010;002;001;016;02;448;248;200
010;002;001;016;03;444;227;217
010;002;001;017;01;63;37;26
010;002;098;001;01;103;52;51
010;002;098;002;01;271;119;152
010;002;098;003;01;296;129;167
010;002;098;003;02;294;137;157
010;002;098;004;01;230;96;134
010;002;098;004;02;224;97;127
010;002;098;005;01;325;170;155
010;002;098;006;01;184;86;98
010;002;098;007;01;184;71;113
010;002;098;008;01;373;156;217
010;002;098;009;01;156;63;93
010;002;098;010;01;207;92;115
010;002;098;011;01;79;31;48
010;002;098;012;01;282;129;153
010;002;098;013;01;165;64;101
010;003;001;001;01;348;146;202
010;003;001;001;02;344;177;167
010;003;001;001;03;344;156;188
010;003;001;001;04;344;151;193
010;003;001;002;01;286;118;168
010;003;001;003;01;324;159;165
010;003;001;004;01;343;133;210
010;003;001;005;01;279;120;159
010;003;001;006;01;315;125;190
010;003;001;007;01;156;64;92
010;003;001;008;01;90;38;52
010;003;001;009;01;295;118;177
010;003;001;010;01;216;88;128
010;003;001;011;01;170;66;104
010;003;001;012;01;144;63;81
010;003;098;001;01;318;142;176
010;003;098;002;01;383;146;237
010;003;098;003;01;129;50;79
010;004;098;001;01;433;205;228
010;004;098;002;01;89;42;47
010;004;098;003;01;185;87;98
010;004;098;004;01;284;126;158
010;004;098;005;01;155;72;83
010;004;098;006;01;344;129;215
010;004;098;007;01;289;134;155
010;004;098;008;01;256;99;157
010;004;098;008;02;252;100;152
010;004;098;009;01;355;173;182
010;004;098;010;01;352;152;200
010;004;098;010;02;352;131;221
010;004;098;011;01;358;172;186
010;004;098;012;01;357;145;212
010;005;098;002;01;336;144;192
010;005;098;002;02;332;143;189
010;005;098;003;01;285;107;178
010;005;098;004;01;445;179;266
010;005;098;005;01;232;97;135
010;005;098;005;02;229;91;138
010;005;098;006;01;241;93;148
010;005;098;007;01;214;102;112
010;005;098;008;01;259;103;156
010;005;098;009;01;327;129;198
010;005;098;010;01;259;91;168
010;005;098;011;01;385;123;262
010;005;098;012;01;294;126;168
010;005;098;013;01;336;121;215
010;005;098;014;01;408;183;225
010;005;098;014;02;405;199;206
010;005;098;015;01;256;124;132
010;005;098;016;01;203;82;121
010;005;098;017;01;449;175;274
010;005;098;018;01;173;67;106
010;005;098;019;01;319;123;196
010;005;098;020;01;113;41;72
010;005;098;021;01;297;122;175
010;005;098;022;01;179;90;89
010;005;098;023;01;164;72;92
010;005;098;024;01;233;84;149
010;005;098;025;01;241;109;132
010;005;098;026;01;127;55;72
010;005;098;027;01;318;139;179
010;005;098;028;01;150;38;112
010;005;098;029;01;144;42;102
010;005;098;030;01;105;37;68
010;005;098;031;01;160;62;98
010;005;098;032;01;168;69;99
010;005;098;033;01;237;90;147
010;006;098;001;01;384;170;214
010;006;098;002;01;262;113;149
010;006;098;003;01;440;213;227
010;006;098;003;02;434;220;214
010;006;098;003;03;432;219;213
010;006;098;004;01;312;149;163
010;006;098;004;02;312;136;176
010;006;098;004;03;305;150;155
010;006;098;005;01;324;136;188
010;006;098;006;01;320;114;206
010;006;098;006;02;315;120;195
010;006;098;007;01;327;131;196
010;006;098;007;02;320;137;183
010;006;098;008;01;76;36;40
010;006;098;009;01;248;109;139
010;006;098;010;01;223;81;142
010;006;098;011;01;235;98;137
010;006;098;012;01;203;92;111
011;001;001;001;01;405;205;200
011;001;001;001;02;400;199;201
011;001;001;001;03;400;172;228
011;001;001;001;04;400;193;207
011;001;001;001;05;400;209;191
011;001;001;002;01;353;186;167
011;001;001;002;02;352;184;168
011;001;001;003;01;450;232;218
011;001;001;003;02;450;225;225
011;001;001;003;03;450;236;214
011;001;001;003;04;450;240;210
011;001;001;003;05;450;247;203
011;001;001;004;01;424;231;193
011;001;001;004;02;424;188;236
011;001;001;004;03;424;229;195
011;001;001;004;04;424;231;193
011;001;001;004;05;422;236;186
011;001;001;004;06;416;231;185
011;001;001;005;01;368;203;165
011;001;001;005;02;362;207;155
011;001;001;005;03;360;190;170
011;001;001;006;01;312;152;160
011;001;001;006;02;308;135;173
011;001;001;007;01;368;174;194
011;001;001;007;02;361;203;158
011;001;001;008;01;312;189;123
011;001;001;008;02;312;165;147
011;001;001;008;03;309;180;129
011;001;001;009;01;288;134;154
011;001;001;009;02;284;149;135
011;001;001;010;01;296;133;163
011;001;001;010;02;294;154;140
011;001;001;011;01;316;141;175
011;001;001;011;02;312;154;158
011;001;001;012;01;296;137;159
011;001;001;012;02;295;156;139
011;001;001;013;01;357;182;175
011;001;001;013;02;352;160;192
011;001;001;014;01;282;141;141
011;001;001;015;01;101;45;56
011;001;001;016;01;328;149;179
011;001;001;016;02;323;179;144
011;001;001;017;01;248;129;119
011;001;001;017;02;245;134;111
011;001;001;018;01;289;161;128
011;001;098;001;01;240;126;114
011;001;098;001;02;232;111;121
011;001;098;002;01;312;136;176
011;001;098;002;02;308;153;155
011;001;098;003;01;373;177;196
011;001;098;003;02;368;161;207
011;001;098;003;03;368;198;170
011;001;098;004;01;280;107;173
011;001;098;004;02;278;124;154
011;001;098;005;01;242;105;137
011;001;098;006;01;327;168;159
011;001;098;007;01;282;107;175
011;001;098;007;02;280;120;160
011;001;098;008;01;440;165;275
011;001;098;009;01;268;133;135
011;001;098;010;01;319;148;171
011;001;098;011;01;349;162;187
011;001;098;012;01;389;143;246
011;001;098;013;01;401;165;236
011;001;098;014;01;297;155;142
011;001;098;014;02;296;139;157
011;001;098;015;01;249;122;127
011;001;098;016;01;185;95;90
011;001;098;017;01;387;174;213
011;001;098;018;01;129;55;74
011;001;098;019;01;231;104;127
011;001;098;020;01;146;53;93
011;001;098;021;01;226;107;119
011;001;098;022;01;375;161;214
011;001;098;023;01;390;171;219
011;001;098;024;01;92;45;47
011;002;098;001;01;386;170;216
011;002;098;002;01;256;119;137
011;002;098;003;01;353;161;192
011;002;098;003;02;352;173;179
011;002;098;004;01;372;170;202
011;002;098;005;01;265;122;143
011;002;098;005;02;264;118;146
011;002;098;006;01;349;154;195
011;002;098;006;02;344;186;158
011;002;098;007;01;280;116;164
011;002;098;007;02;280;142;138
011;002;098;008;01;275;116;159
011;002;098;009;01;201;87;114
011;002;098;010;01;161;73;88
011;002;098;011;01;45;22;23
011;002;098;012;01;106;46;60
011;002;098;013;01;180;78;102
011;002;098;014;01;264;125;139
011;002;098;015;01;174;74;100
011;002;098;016;01;98;45;53
011;002;098;017;01;76;31;45
011;002;098;018;01;72;30;42
011;002;098;019;01;185;82;103
011;002;098;020;01;145;72;73
011;002;098;021;01;190;91;99
011;002;098;022;01;54;28;26
011;002;098;023;01;65;28;37
011;003;098;001;01;304;157;147
011;003;098;001;02;302;151;151
011;003;098;001;03;296;173;123
011;003;098;002;01;400;175;225
011;003;098;002;02;400;194;206
011;003;098;003;01;329;166;163
011;003;098;003;02;328;179;149
011;003;098;004;01;379;195;184
011;003;098;004;02;376;165;211
011;003;098;004;03;376;193;183
011;003;098;005;01;260;125;135
011;003;098;006;01;260;111;149
011;003;098;006;02;256;139;117
011;003;098;007;01;424;238;186
011;003;098;008;01;389;202;187
011;003;098;009;01;273;131;142
011;003;098;009;02;272;148;124
011;003;098;010;01;232;114;118
011;003;098;010;02;228;142;86
011;003;098;012;01;422;202;220
011;003;098;013;01;226;104;122
011;003;098;014;01;262;132;130
011;003;098;015;01;71;40;31
011;004;098;001;01;240;106;134
011;004;098;001;02;233;113;120
011;004;098;002;01;338;157;181
011;004;098;003;01;240;101;139
011;004;098;003;02;232;108;124
011;004;098;004;01;213;92;121
011;004;098;005;01;284;150;134
011;004;098;005;02;280;120;160
011;004;098;006;01;445;222;223
011;004;098;007;01;211;91;120
011;004;098;008;01;300;135;165
011;004;098;009;01;253;117;136
011;004;098;009;02;248;133;115
011;004;098;010;01;285;117;168
011;004;098;011;01;144;56;88
011;004;098;012;01;246;102;144
011;004;098;012;02;240;109;131
011;004;098;013;01;119;55;64
011;004;098;014;01;208;91;117
011;004;098;015;01;96;42;54
011;004;098;016;01;238;116;122
012;001;098;001;01;420;176;244
012;001;098;001;02;416;190;226
012;001;098;002;01;342;163;179
012;001;098;003;01;265;128;137
012;001;098;004;01;419;195;224
012;001;098;005;01;318;143;175
012;001;098;005;02;312;144;168
012;001;098;005;03;312;157;155
012;001;098;006;01;132;61;71
012;001;098;007;01;126;51;75
012;001;098;008;01;275;113;162
012;001;098;009;01;433;191;242
012;001;098;010;01;432;210;222
012;001;098;010;02;427;178;249
012;001;098;010;03;424;219;205
012;001;098;011;01;356;181;175
012;003;001;001;01;424;213;211
012;003;001;001;02;424;217;207
012;003;001;001;03;424;195;229
012;003;001;001;04;424;221;203
012;003;001;001;05;423;208;215
012;003;001;001;06;416;214;202
012;003;001;001;07;416;240;176
012;003;001;001;08;416;204;212
012;003;001;002;01;418;196;222
012;003;001;002;02;416;193;223
012;003;001;002;03;416;230;186
012;003;001;002;04;416;158;258
012;003;001;002;05;416;219;197
012;003;001;002;06;416;235;181
012;003;001;003;01;320;142;178
012;003;001;003;02;320;153;167
012;003;001;003;03;318;166;152
012;003;001;004;01;399;217;182
012;003;001;004;02;392;191;201
012;003;001;005;01;424;222;202
012;003;001;005;02;417;224;193
012;003;001;005;03;416;216;200
012;003;001;006;01;67;38;29
012;003;001;008;01;91;43;48
012;003;098;001;01;268;133;135
012;003;098;001;02;264;134;130
012;003;098;002;01;179;99;80
012;003;098;003;01;352;149;203
012;003;098;003;02;348;159;189
012;003;098;004;01;368;158;210
012;003;098;005;01;320;173;147
012;003;098;006;01;253;130;123
012;003;098;007;01;71;31;40
012;003;098;008;01;236;124;112
012;003;098;009;01;328;167;161
012;003;098;010;01;234;128;106
012;003;098;011;01;107;60;47
012;004;098;001;01;238;115;123
012;004;098;002;01;320;139;181
012;004;098;002;02;320;159;161
012;004;098;003;01;400;188;212
012;004;098;003;02;393;220;173
012;004;098;003;03;392;203;189
012;004;098;004;01;279;114;165
012;004;098;004;02;272;125;147
012;004;098;005;01;332;177;155
012;004;098;005;02;328;174;154
012;004;098;006;01;400;203;197
012;004;098;006;02;400;164;236
012;004;098;006;03;400;237;163
012;004;098;006;04;400;185;215
012;004;098;006;05;400;229;171
012;004;098;007;01;450;236;214
012;004;098;008;01;177;98;79
012;004;098;009;01;335;167;168
012;004;098;010;01;172;112;60
012;004;098;011;01;311;150;161
012;004;098;011;02;304;171;133
012;004;098;012;01;346;166;180
012;004;098;012;02;344;174;170
012;004;098;012;03;344;189;155
012;004;098;012;04;344;185;159
012;004;098;013;01;226;143;83
012;004;098;014;01;123;72;51
012;005;001;001;01;368;191;177
012;005;001;001;02;360;201;159
012;005;001;001;03;360;202;158
012;005;001;001;04;360;210;150
012;005;001;002;01;382;189;193
012;005;001;002;02;376;171;205
012;005;001;002;03;376;160;216
012;005;001;002;04;376;206;170
012;005;001;003;01;448;247;201
012;005;001;003;02;448;233;215
012;005;001;003;03;446;228;218
012;005;001;004;01;424;181;243
012;005;001;004;02;424;196;228
012;005;001;004;03;424;178;246
012;005;001;004;04;417;178;239
012;005;001;004;05;416;199;217
012;005;001;004;06;416;208;208
012;005;001;004;07;416;203;213
012;005;001;005;01;384;185;199
012;005;001;005;02;384;162;222
012;005;001;005;03;378;171;207
012;005;001;005;04;376;191;185
012;005;001;006;01;380;183;197
012;005;001;006;02;376;170;206
012;005;001;006;03;376;187;189
012;005;001;006;04;376;181;195
012;005;001;007;01;424;217;207
012;005;001;007;02;424;210;214
012;005;001;007;03;417;179;238
012;005;001;007;04;416;201;215
012;005;001;007;05;416;222;194
012;005;001;008;01;416;200;216
012;005;001;008;02;416;186;230
012;005;001;008;03;416;178;238
012;005;001;008;04;416;192;224
012;005;001;008;05;413;198;215
012;005;001;008;06;408;221;187
012;005;001;009;01;355;178;177
012;005;001;009;02;352;182;170
012;005;001;009;03;352;174;178
012;005;001;009;04;352;190;162
012;005;001;010;01;408;219;189
012;005;001;010;02;403;213;190
012;005;001;010;03;400;174;226
012;005;001;010;04;400;226;174
012;005;001;010;05;400;205;195
012;005;001;011;01;368;194;174
012;005;001;011;02;368;200;168
012;005;001;011;03;361;196;165
012;005;001;012;01;399;192;207
012;005;001;012;02;392;190;202
012;005;001;012;03;392;211;181
012;005;001;013;01;440;226;214
012;005;001;013;02;440;226;214
012;005;001;013;03;440;233;207
012;005;001;013;04;432;214;218
012;005;001;014;01;376;195;181
012;005;001;014;02;376;155;221
012;005;001;014;03;376;161;215
012;005;001;014;04;371;185;186
012;005;001;015;01;320;153;167
012;005;001;015;02;320;179;141
012;005;001;015;03;317;159;158
012;005;001;016;01;399;219;180
012;005;001;017;01;433;219;214
012;005;001;018;01;363;168;195
012;005;001;018;02;360;187;173
012;005;001;018;03;360;192;168
012;005;001;019;01;344;167;177
012;005;001;019;02;340;173;167
012;005;001;020;01;262;147;115
012;005;001;021;01;353;179;174
012;005;001;021;02;352;171;181
012;005;001;022;01;285;128;157
012;005;001;023;01;237;109;128
012;005;001;023;02;232;117;115
012;005;001;024;01;384;170;214
012;005;001;024;02;383;179;204
012;005;001;024;03;376;186;190
012;005;001;025;01;337;177;160
012;005;001;025;02;336;153;183
012;005;001;025;03;336;156;180
012;005;001;026;01;360;174;186
012;005;001;026;02;355;179;176
012;005;098;001;01;264;130;134
012;005;098;001;02;256;134;122
012;005;098;002;01;232;109;123
012;005;098;002;02;229;109;120
012;005;098;003;01;165;80;85
012;005;098;004;01;312;152;160
012;005;098;004;02;310;144;166
012;005;098;005;01;219;97;122
012;005;098;006;01;292;139;153
012;005;098;007;01;413;211;202
012;005;098;008;01;142;71;71
012;005;098;009;01;229;122;107
012;005;098;010;01;313;155;158
012;005;098;011;01;308;125;183
012;005;098;012;01;264;110;154
012;005;098;013;01;205;83;122
012;005;098;014;01;225;105;120
012;005;098;015;01;247;144;103
012;005;098;016;01;384;193;191
012;005;098;016;02;382;174;208
013;004;001;001;01;408;212;196
013;004;001;001;02;407;199;208
013;004;001;001;03;400;203;197
013;004;001;001;04;400;185;215
013;004;001;001;05;400;192;208
013;004;001;001;06;400;220;180
013;004;001;002;01;328;175;153
013;004;001;002;02;328;172;156
013;004;001;002;03;320;169;151
013;004;001;003;01;448;215;233
013;004;001;003;02;447;198;249
013;004;001;004;01;312;170;142
013;004;001;004;02;307;147;160
013;004;001;004;03;304;142;162
013;004;001;005;01;431;199;232
013;004;001;005;02;424;241;183
013;004;001;005;03;424;209;215
013;004;001;006;01;328;169;159
013;004;001;006;02;321;140;181
013;004;001;006;03;320;164;156
013;004;001;007;01;394;225;169
013;004;001;008;01;357;170;187
013;004;001;008;02;352;170;182
013;004;001;009;01;264;142;122
013;004;001;009;02;260;118;142
013;004;001;010;01;336;164;172
013;004;001;010;02;334;120;214
013;004;001;010;03;328;194;134
013;004;001;011;01;352;201;151
013;004;001;011;02;350;192;158
013;004;001;012;01;427;238;189
013;004;001;013;01;359;202;157
013;004;001;013;02;352;169;183
013;004;001;014;01;288;163;125
013;004;001;014;02;282;137;145
013;004;001;015;01;406;198;208
013;004;001;016;01;351;206;145
013;004;001;017;01;257;143;114
013;004;001;018;01;358;211;147
013;004;001;019;01;312;172;140
013;004;001;019;02;307;142;165
013;004;001;020;01;125;64;61
013;004;001;021;01;347;187;160
013;004;001;022;01;318;165;153
013;004;098;001;01;400;229;171
013;004;098;002;01;105;58;47
013;004;098;003;01;105;50;55
013;004;098;004;01;310;164;146
013;004;098;004;02;304;170;134
013;004;098;005;01;376;207;169
013;004;098;005;02;376;169;207
013;004;098;005;03;376;181;195
013;004;098;005;04;376;227;149
013;004;098;005;05;375;210;165
013;004;098;006;01;368;211;157
013;004;098;006;02;360;201;159
013;004;098;007;01;191;97;94
013;004;098;008;01;361;205;156
013;004;098;008;02;360;160;200
013;004;098;008;03;360;166;194
013;004;098;009;01;288;132;156
013;004;098;009;02;283;141;142
013;004;098;010;01;424;213;211
013;004;098;011;01;199;109;90
013;004;098;012;01;324;199;125
013;004;098;013;01;240;125;115
013;004;098;013;02;239;130;109
013;004;098;014;01;236;116;120
013;004;098;015;01;295;175;120
013;004;098;016;01;200;113;87
013;004;098;017;01;280;155;125
013;004;098;017;02;273;153;120
013;004;098;018;01;203;115;88
013;005;098;001;01;328;173;155
013;005;098;002;01;264;145;119
013;005;098;002;02;260;154;106
013;005;098;003;01;392;221;171
013;005;098;004;01;347;195;152
013;005;098;004;02;344;156;188
013;005;098;005;01;304;160;144
013;005;098;005;02;304;158;146
013;005;098;005;03;301;134;167
013;005;098;006;01;350;175;175
013;005;098;007;01;344;194;150
013;005;098;007;02;344;225;119
013;005;098;007;03;337;123;214
013;005;098;008;01;445;236;209
013;005;098;009;01;226;129;97
013;005;098;010;01;183;102;81
013;005;098;011;01;181;107;74
013;005;098;012;01;244;138;106
013;005;098;013;01;149;84;65
013;005;098;014;01;247;135;112
013;005;098;014;02;240;126;114
013;005;098;015;01;275;151;124
013;005;098;015;02;272;140;132
013;005;098;016;01;432;228;204
013;005;098;017;01;138;82;56
013;005;098;018;01;360;204;156
013;005;098;018;02;358;189;169
013;005;098;019;01;395;228;167
013;005;098;020;01;321;158;163
013;005;098;021;01;282;162;120
013;005;098;022;01;245;140;105
013;005;098;023;01;338;188;150
013;005;098;024;01;148;81;67
013;006;001;001;01;437;234;203
013;006;001;001;02;432;245;187
013;006;001;001;03;432;202;230
013;006;001;001;04;432;217;215
013;006;001;001;05;432;240;192
013;006;001;002;01;368;194;174
013;006;001;002;02;366;197;169
013;006;001;003;01;232;117;115
013;006;001;003;02;230;115;115
013;006;001;004;01;216;122;94
013;006;001;005;01;424;226;198
013;006;001;006;01;340;177;163
013;006;001;007;01;278;153;125
013;006;001;007;02;272;145;127
013;006;001;008;01;233;125;108
013;006;001;009;01;151;79;72
013;006;001;010;01;245;122;123
013;006;098;001;01;440;244;196
013;006;098;001;02;437;227;210
013;006;098;002;01;245;146;99
013;006;098;003;01;248;132;116
013;006;098;004;01;197;105;92
013;006;098;005;01;317;170;147
013;006;098;005;02;312;187;125
013;006;098;006;01;325;182;143
013;006;098;007;01;304;154;150
013;006;098;007;02;300;155;145
013;006;098;008;01;403;210;193
013;006;098;008;02;400;232;168
013;006;098;009;01;258;156;102
013;006;098;010;01;237;137;100
013;006;098;011;01;118;71;47
013;006;098;012;01;170;93;77
013;006;098;013;01;273;165;108
013;006;098;014;01;284;153;131
013;006;098;015;01;204;114;90
013;006;098;016;01;191;91;100
013;006;098;017;01;49;24;25
013;006;098;018;01;130;72;58
013;006;098;019;01;150;85;65
013;006;098;021;01;66;42;24
013;006;098;026;01;113;65;48
013;006;098;027;01;148;98;50
013;006;098;028;01;177;105;72
013;006;098;029;01;221;120;101
013;007;001;001;01;360;205;155
013;007;001;001;02;360;220;140
013;007;001;001;03;360;124;236
013;007;001;001;04;354;148;206
013;007;001;002;01;368;226;142
013;007;001;002;02;368;265;103
013;007;001;002;03;368;125;243
013;007;001;002;04;368;161;207
013;007;001;002;05;365;216;149
013;007;001;003;01;284;178;106
013;007;001;003;02;280;112;168
013;007;001;004;01;242;126;116
013;007;001;005;01;203;111;92
013;007;001;006;01;264;180;84
013;007;001;006;02;263;110;153
013;007;001;007;01;212;120;92
013;007;098;001;01;192;108;84
013;007;098;002;01;344;196;148
013;007;098;002;02;342;190;152
013;007;098;003;01;251;121;130
013;007;098;003;02;248;139;109
013;007;098;004;01;186;111;75
013;007;098;005;01;173;92;81
013;007;098;006;01;232;134;98
013;007;098;006;02;225;97;128
013;007;098;007;01;408;272;136
013;007;098;008;01;365;188;177
013;007;098;008;02;360;185;175
013;007;098;009;01;435;218;217
013;007;098;010;01;432;208;224
013;007;098;010;02;428;229;199
013;007;098;011;01;275;151;124
013;007;098;012;01;296;163;133
013;007;098;013;01;184;103;81
013;007;098;014;01;317;162;155
013;007;098;015;01;195;111;84
013;007;098;016;01;288;161;127
013;007;098;016;02;281;161;120
013;007;098;017;01;103;60;43
013;007;098;018;01;53;34;19
013;007;098;019;01;113;68;45
013;007;098;020;01;304;166;138
013;007;098;021;01;255;150;105
013;007;098;022;01;305;160;145
013;007;098;023;01;123;67;56
013;007;098;024;01;145;84;61
013;007;098;025;01;197;123;74
013;007;098;026;01;246;159;87
013;007;098;027;01;237;139;98
013;007;098;028;01;195;125;70
013;007;098;029;01;167;87;80
013;007;098;030;01;137;78;59
013;007;098;034;01;168;93;75
013;008;098;001;01;249;137;112
013;008;098;002;01;240;128;112
013;008;098;002;02;235;140;95
013;008;098;003;01;385;221;164
013;008;098;003;02;384;188;196
013;008;098;003;03;384;207;177
013;008;098;004;01;332;219;113
013;008;098;004;02;328;126;202
013;008;098;004;03;328;168;160
013;008;098;005;01;352;189;163
013;008;098;005;02;351;93;258
013;008;098;005;03;344;140;204
013;008;098;006;01;290;183;107
013;008;098;006;02;288;179;109
013;008;098;007;01;326;170;156
013;008;098;008;01;280;138;142
013;008;098;008;02;277;153;124
013;008;098;009;01;353;161;192
013;008;098;010;01;197;94;103
013;008;098;011;01;256;134;122
013;008;098;012;01;303;163;140
013;008;098;012;02;296;168;128
013;008;098;013;01;246;146;100
013;008;098;014;01;306;181;125
013;008;098;015;01;292;156;136
013;008;098;016;01;111;60;51
013;008;098;017;01;340;184;156
013;008;098;018;01;242;133;109
013;008;098;018;02;240;120;120
013;008;098;019;01;364;171;193
013;008;098;020;01;232;117;115
013;008;098;020;02;228;137;91
013;008;098;021;01;82;43;39
013;008;098;022;01;302;163;139
013;008;098;023;01;140;76;64
013;008;098;024;01;275;170;105
013;008;098;025;01;240;146;94
013;008;098;026;01;232;123;109
013;008;098;026;02;231;112;119
013;008;098;027;01;133;86;47
013;008;098;028;01;133;68;65
013;008;098;029;01;219;120;99
014;002;001;001;01;368;163;205
014;002;001;001;02;368;144;224
014;002;001;001;03;368;181;187
014;002;001;001;04;368;204;164
014;002;001;001;05;363;196;167
014;002;001;002;01;392;201;191
014;002;001;002;02;391;211;180
014;002;001;003;01;320;163;157
014;002;001;003;02;313;175;138
014;002;001;004;01;369;203;166
014;002;001;005;01;384;184;200
014;002;001;005;02;384;199;185
014;002;001;005;03;376;196;180
014;002;001;006;01;320;172;148
014;002;001;006;02;316;174;142
014;002;001;007;01;327;186;141
014;002;001;008;01;116;68;48
014;002;001;009;01;248;143;105
014;002;001;009;02;247;117;130
014;002;001;010;01;317;187;130
014;002;001;011;01;320;187;133
014;002;001;011;02;320;142;178
014;002;001;011;03;317;169;148
014;002;098;001;01;380;189;191
014;002;098;002;01;346;188;158
014;002;098;002;02;344;161;183
014;002;098;003;01;308;168;140
014;002;098;004;01;424;228;196
014;002;098;005;01;135;77;58
014;002;098;006;01;247;152;95
014;002;098;007;01;280;152;128
014;002;098;007;02;274;161;113
014;002;098;008;01;84;58;26
014;002;098;009;01;133;95;38
014;002;098;010;01;42;25;17
014;002;098;011;01;144;95;49
014;002;098;012;01;94;64;30
014;002;098;013;01;61;43;18
014;002;098;014;01;144;100;44
014;002;098;015;01;250;145;105
014;002;098;015;02;248;147;101
014;003;001;001;01;440;245;195
014;003;001;001;02;440;236;204
014;003;001;001;03;440;206;234
014;003;001;001;04;432;209;223
014;003;001;001;05;432;234;198
014;003;001;001;06;432;210;222
014;003;001;002;01;363;216;147
014;003;001;002;02;360;198;162
014;003;001;003;01;322;174;148
014;003;001;004;01;251;128;123
014;003;001;005;01;145;65;80
014;003;001;006;01;392;206;186
014;003;001;006;02;391;187;204
014;003;001;007;01;384;195;189
014;003;001;008;01;425;227;198
014;003;001;008;02;424;243;181
014;003;001;009;01;313;160;153
014;003;001;009;02;312;156;156
014;003;001;010;01;336;156;180
014;003;001;011;01;273;143;130
014;003;001;011;02;272;139;133
014;003;001;012;01;262;130;132
014;003;001;013;01;281;145;136
014;003;098;001;01;408;224;184
014;003;098;001;02;405;238;167
014;003;098;002;01;152;91;61
014;003;098;003;01;127;67;60
014;003;098;005;01;256;127;129
014;003;098;005;02;251;159;92
014;003;098;006;01;296;181;115
014;003;098;007;01;141;71;70
014;003;098;009;01;448;266;182
014;003;098;009;02;443;249;194
014;003;098;010;01;238;144;94
014;003;098;012;01;115;60;55
014;003;098;013;01;155;94;61
014;003;098;014;01;226;128;98
014;003;098;015;01;209;124;85
014;003;098;016;01;86;45;41
014;003;098;018;01;240;139;101
014;003;098;018;02;237;138;99
014;003;098;019;01;145;82;63
014;003;098;025;01;141;74;67
015;001;001;001;01;384;221;163
015;001;001;001;02;376;218;158
015;001;001;002;01;312;154;158
015;001;001;002;02;304;148;156
015;001;001;002;03;304;153;151
015;001;001;003;01;448;226;222
015;001;001;003;02;448;196;252
015;001;001;003;03;448;244;204
015;001;001;003;04;445;230;215
015;001;001;004;01;416;188;228
015;001;001;004;02;416;224;192
015;001;001;004;03;416;200;216
015;001;001;004;04;416;199;217
015;001;001;004;05;410;203;207
015;001;001;004;06;408;203;205
015;001;001;005;01;304;128;176
015;001;001;005;02;304;152;152
015;001;001;005;03;298;138;160
015;001;001;006;01;376;167;209
015;001;001;006;02;376;200;176
015;001;001;006;03;376;188;188
015;001;001;006;04;369;180;189
015;001;001;006;05;368;202;166
015;001;001;007;01;376;138;238
015;001;001;007;02;376;197;179
015;001;001;007;03;376;188;188
015;001;001;007;04;369;172;197
015;001;001;008;01;408;205;203
015;001;001;008;02;408;186;222
015;001;001;008;03;408;205;203
015;001;001;008;04;400;180;220
015;001;001;008;05;400;189;211
015;001;001;009;01;280;153;127
015;001;001;009;02;278;140;138
015;001;001;010;01;430;208;222
015;001;001;011;01;381;206;175
015;001;001;012;01;219;124;95
015;001;001;013;01;166;92;74
015;001;001;014;01;88;41;47
015;001;001;015;01;123;68;55
015;001;001;016;01;63;31;32
015;001;001;017;01;84;38;46
015;001;001;018;01;302;175;127
015;001;001;019;01;127;67;60
015;001;001;020;01;84;46;38
015;001;001;021;01;144;65;79
015;001;001;022;01;265;123;142
015;001;098;001;01;232;117;115
015;001;098;001;02;226;121;105
015;001;098;002;01;274;147;127
015;001;098;002;02;272;160;112
015;001;098;003;01;311;167;144
015;001;098;003;02;304;172;132
015;001;098;004;01;325;159;166
015;001;098;005;01;263;127;136
015;001;098;006;01;412;216;196
015;001;098;007;01;361;202;159
015;001;098;009;01;236;151;85
015;001;098;010;01;294;184;110
015;001;098;010;02;288;166;122
015;001;098;011;01;389;251;138
015;001;098;012;01;149;96;53
015;001;098;013;01;424;232;192
015;001;098;013;02;416;204;212
015;001;098;014;01;367;212;155
015;001;098;015;01;310;181;129
015;001;098;016;01;373;180;193
015;001;098;018;01;314;155;159
015;001;098;020;01;209;100;109
015;001;098;023;01;148;122;26
015;001;098;024;01;272;137;135
015;001;098;026;01;232;127;105
015;001;098;027;01;158;83;75
015;001;098;028;01;114;69;45
015;001;098;029;01;134;71;63
015;001;098;030;01;208;114;94
015;001;098;031;01;256;127;129
015;001;098;032;01;117;79;38
015;001;098;033;01;114;70;44
015;002;098;001;01;63;47;16
015;002;098;002;01;360;159;201
015;002;098;002;02;360;201;159
015;002;098;002;03;359;192;167
015;002;098;003;01;352;175;177
015;002;098;003;02;352;174;178
015;002;098;003;03;352;185;167
015;002;098;004;01;204;111;93
015;002;098;005;01;240;125;115
015;002;098;006;01;160;86;74
015;003;098;001;01;320;167;153
015;003;098;001;02;320;156;164
015;003;098;001;03;314;165;149
015;003;098;002;01;299;164;135
015;003;098;003;01;360;184;176
015;003;098;003;02;356;167;189
015;003;098;003;03;352;169;183
015;003;098;003;04;352;176;176
015;003;098;004;01;376;188;188
015;003;098;004;02;374;191;183
015;003;098;005;01;408;167;241
015;003;098;005;02;408;228;180
015;003;098;005;03;401;211;190
015;003;098;006;01;41;30;11
015;003;098;007;01;308;158;150
015;003;098;008;01;199;97;102
015;003;098;009;01;141;98;43
015;003;098;010;01;78;48;30
015;003;098;011;01;132;98;34
015;003;098;012;01;76;23;53
015;003;098;013;01;255;139;116
015;003;098;013;02;248;119;129
015;003;098;014;01;155;93;62
015;003;098;015;01;192;106;86
015;003;098;016;01;110;74;36
015;004;098;001;01;291;175;116
015;004;098;001;02;288;156;132
015;004;098;002;01;232;128;104
015;004;098;002;02;225;117;108
015;004;098;003;01;259;132;127
015;004;098;003;02;256;134;122
015;004;098;004;01;316;152;164
015;004;098;004;02;312;181;131
015;004;098;005;01;240;135;105
015;004;098;005;02;232;126;106
015;004;098;006;01;417;245;172
015;004;098;007;01;272;144;128
015;004;098;007;02;265;148;117
015;004;098;008;01;236;132;104
015;004;098;009;01;109;72;37
015;004;098;010;01;142;94;48
015;004;098;011;01;164;89;75
015;004;098;012;01;260;136;124
016;002;001;001;01;392;235;157
016;002;001;001;02;392;201;191
016;002;001;001;03;392;170;222
016;002;001;001;04;392;222;170
016;002;001;001;05;392;233;159
016;002;001;001;06;386;222;164
016;002;001;002;01;440;237;203
016;002;001;002;02;437;240;197
016;002;001;002;03;432;243;189
016;002;001;002;04;432;233;199
016;002;001;002;05;432;197;235
016;002;001;002;06;432;180;252
016;002;001;002;07;432;254;178
016;002;001;002;08;432;245;187
016;002;001;003;01;320;152;168
016;002;001;003;02;314;157;157
016;002;001;003;03;312;145;167
016;002;001;004;01;296;166;130
016;002;001;005;01;408;200;208
016;002;001;005;02;408;198;210
016;002;001;005;03;408;181;227
016;002;001;005;04;408;216;192
016;002;001;006;01;373;189;184
016;002;001;007;01;408;228;180
016;002;001;007;02;406;222;184
016;002;001;007;03;400;231;169
016;002;001;008;01;188;96;92
016;002;001;009;01;162;63;99
016;002;001;010;01;232;126;106
016;002;001;011;01;128;58;70
016;002;001;012;01;257;128;129
016;002;001;013;01;67;28;39
016;002;001;014;01;363;192;171
016;002;001;015;01;152;80;72
016;002;098;001;01;425;201;224
016;002;098;002;01;280;130;150
016;002;098;002;02;279;128;151
016;002;098;003;01;287;143;144
016;002;098;004;01;161;96;65
016;002;098;005;01;199;103;96
016;002;098;008;01;166;107;59
016;002;098;009;01;331;224;107
016;002;098;010;01;283;150;133
016;002;098;011;01;136;70;66
016;003;098;001;01;256;146;110
016;003;098;001;02;248;148;100
016;003;098;002;01;39;25;14
016;003;098;003;01;352;228;124
016;003;098;004;01;262;163;99
016;003;098;005;01;294;184;110
016;003;098;006;01;248;129;119
016;004;098;001;01;360;151;209
016;004;098;001;02;360;215;145
016;004;098;002;01;189;93;96
016;004;098;003;01;157;80;77
016;004;098;004;01;200;93;107
016;004;098;005;01;69;48;21
016;005;098;001;01;398;243;155
016;005;098;001;02;392;231;161
016;005;098;002;01;336;213;123
016;005;098;003;01;99;68;31
016;005;098;004;01;274;157;117
016;005;098;004;02;272;157;115
016;005;098;005;01;203;110;93
016;005;098;006;01;189;106;83
016;005;098;007;01;140;83;57
016;005;098;008;01;118;61;57
017;001;098;004;01;252;128;124
017;001;098;005;01;294;140;154
017;001;098;006;01;247;117;130
017;001;098;006;02;240;122;118
017;001;098;007;01;181;88;93
017;001;098;008;01;125;67;58
017;003;001;001;01;353;159;194
017;003;001;001;02;352;185;167
017;003;001;001;03;352;175;177
017;003;001;002;01;450;200;250
017;003;001;002;02;450;205;245
017;003;001;002;03;450;235;215
017;003;001;003;01;352;150;202
017;003;001;003;02;346;160;186
017;003;001;003;03;344;170;174
017;003;001;004;01;407;191;216
017;003;001;004;02;400;189;211
017;003;001;005;01;284;146;138
017;003;001;005;02;280;146;134
017;003;001;006;01;308;143;165
017;003;001;007;01;366;169;197
017;003;001;007;02;360;173;187
017;003;001;008;01;94;49;45
017;003;001;009;01;393;197;196
017;003;001;010;01;371;202;169
017;003;001;011;01;434;219;215
017;003;001;012;01;336;164;172
017;003;001;012;02;336;178;158
017;003;098;001;01;274;121;153
017;003;098;002;01;234;111;123
017;003;098;003;01;317;144;173
017;003;098;004;01;419;200;219
017;003;098;004;02;416;195;221
017;003;098;005;01;280;118;162
017;003;098;005;02;277;135;142
017;003;098;006;01;373;180;193
017;003;098;007;01;116;61;55
017;003;098;015;01;37;22;15
017;004;098;001;01;272;128;144
017;004;098;001;02;266;152;114
017;004;098;002;01;399;170;229
017;004;098;002;02;392;198;194
017;004;098;003;01;288;143;145
017;004;098;003;02;284;141;143
017;004;098;004;01;365;170;195
017;004;098;005;01;127;75;52
017;004;098;006;01;75;37;38
017;006;098;001;01;280;133;147
017;006;098;001;02;279;139;140
017;006;098;002;01;288;129;159
017;006;098;002;02;288;139;149
017;006;098;003;01;256;117;139
017;006;098;003;02;253;130;123
017;006;098;004;01;152;94;58
017;006;098;005;01;131;61;70
017;006;098;006;01;205;105;100
017;006;098;007;01;317;150;167
017;006;098;007;02;312;181;131
017;006;098;008;01;312;158;154
017;006;098;009;01;90;53;37
017;006;098;010;01;102;56;46
017;006;098;011;01;335;145;190
017;007;098;001;01;259;119;140
017;007;098;001;02;256;112;144
017;007;098;002;01;353;160;193
017;007;098;002;02;352;164;188
017;007;098;003;01;94;53;41
017;007;098;006;01;340;163;177
017;007;098;007;01;194;94;100
017;007;098;008;01;178;84;94
017;007;098;009;01;295;161;134
017;007;098;010;01;256;131;125
017;007;098;010;02;249;100;149
017;007;098;011;01;164;78;86
017;007;098;013;01;421;224;197
017;007;098;015;01;129;66;63
018;004;001;001;01;275;149;126
018;004;001;001;02;272;154;118
018;004;001;002;01;408;201;207
018;004;001;002;02;408;196;212
018;004;001;002;03;408;232;176
018;004;001;003;01;373;186;187
018;004;001;004;01;148;80;68
018;004;001;005;01;251;131;120
018;004;001;006;01;269;140;129
018;004;001;006;02;264;155;109
018;004;001;007;01;344;196;148
018;004;001;008;01;220;113;107
018;004;001;009;01;288;149;139
018;004;001;010;01;94;50;44
018;004;098;001;01;132;61;71
018;004;098;002;01;97;50;47
018;004;098;003;01;265;141;124
018;004;098;004;01;98;48;50
018;004;098;005;01;88;51;37
018;004;098;006;01;168;122;46
018;004;098;008;01;78;44;34
018;004;098;009;01;168;131;37
018;004;098;010;01;69;38;31
018;005;098;001;01;191;125;66
018;005;098;002;01;114;95;19
018;005;098;003;01;182;98;84
018;005;098;004;01;296;214;82
018;005;098;005;01;79;45;34
018;005;098;006;01;371;201;170
018;005;098;006;02;368;228;140
018;006;098;001;01;236;152;84
018;006;098;002;01;194;118;76
018;006;098;003;01;197;114;83
018;006;098;004;01;209;112;97
018;006;098;005;01;317;194;123
018;006;098;005;02;312;162;150
018;006;098;006;01;273;152;121
018;006;098;006;02;272;155;117
018;006;098;007;01;344;202;142
018;006;098;007;02;344;195;149
018;006;098;007;03;344;165;179
018;006;098;007;04;336;196;140
018;006;098;008;01;115;87;28
018;006;098;009;01;109;61;48
018;006;098;010;01;199;133;66
018;006;098;011;01;75;48;27
019;001;001;001;01;344;194;150
019;001;001;001;02;344;176;168
019;001;001;001;03;338;197;141
019;001;001;001;04;336;210;126
019;001;001;002;01;352;184;168
019;001;001;002;02;352;194;158
019;001;001;002;03;349;197;152
019;001;001;003;01;375;199;176
019;001;001;003;02;368;169;199
019;001;001;003;03;368;200;168
019;001;001;004;01;427;252;175
019;001;001;004;02;424;220;204
019;001;001;004;03;424;197;227
019;001;001;004;04;424;253;171
019;001;001;004;05;424;256;168
019;001;001;004;06;424;226;198
019;001;001;004;07;424;258;166
019;001;001;005;01;328;169;159
019;001;001;005;02;323;166;157
019;001;001;006;01;388;188;200
019;001;001;006;02;384;187;197
019;001;001;006;03;384;194;190
019;001;001;007;01;352;184;168
019;001;001;007;02;351;176;175
019;001;001;008;01;445;230;215
019;001;001;008;02;440;235;205
019;001;001;009;01;312;169;143
019;001;001;009;02;310;162;148
019;001;001;009;03;304;165;139
019;001;001;010;01;320;155;165
019;001;001;010;02;318;181;137
019;001;001;010;03;312;182;130
019;001;001;011;01;362;202;160
019;001;001;011;02;360;213;147
019;001;001;012;01;225;177;48
019;001;001;013;01;393;228;165
019;001;001;015;01;306;198;108
019;001;001;017;01;398;280;118
019;001;001;018;01;115;60;55
019;001;098;001;01;239;146;93
019;001;098;002;01;280;174;106
019;001;098;003;01;330;205;125
019;001;098;004;01;122;74;48
019;001;098;005;01;272;163;109
019;001;098;006;01;280;178;102
019;001;098;006;02;272;167;105
019;001;098;007;01;385;263;122
019;001;098;008;01;270;154;116
019;001;098;009;01;187;100;87
019;001;098;010;01;410;253;157
019;001;098;011;01;342;204;138
019;001;098;012;01;264;156;108
019;001;098;012;02;263;144;119
019;001;098;013;01;191;94;97
019;001;098;014;01;89;49;40
019;001;098;015;01;240;137;103
019;001;098;015;02;238;156;82
019;001;098;016;01;259;154;105
019;001;098;017;01;307;226;81
019;001;098;018;01;89;66;23
019;002;098;001;01;360;217;143
019;002;098;001;02;355;202;153
019;002;098;001;03;352;212;140
019;002;098;001;04;352;177;175
019;002;098;002;01;284;163;121
019;002;098;003;01;324;197;127
019;002;098;004;01;93;76;17
019;002;098;005;01;241;167;74
019;002;098;006;01;246;190;56
019;002;098;007;01;223;170;53
019;002;098;008;01;164;114;50
019;003;098;001;01;256;148;108
019;003;098;001;02;248;154;94
019;003;098;002;01;241;112;129
019;003;098;002;02;240;123;117
019;003;098;003;01;233;140;93
019;003;098;004;01;406;209;197
019;003;098;005;01;260;125;135
019;003;098;005;02;256;145;111
019;003;098;006;01;275;134;141
019;003;098;007;01;384;204;180
019;003;098;007;02;377;197;180
019;003;098;008;01;164;105;59
019;003;098;009;01;297;146;151
019;003;098;010;01;423;210;213
019;003;098;011;01;404;210;194
019;003;098;012;01;240;117;123
019;003;098;012;02;236;136;100
019;003;098;013;01;46;30;16
019;003;098;014;01;384;267;117
019;004;098;001;01;300;165;135
019;004;098;002;01;151;96;55
019;004;098;003;01;233;128;105
019;004;098;003;02;232;110;122
019;004;098;004;01;291;179;112
019;004;098;005;01;446;243;203
019;004;098;005;02;440;247;193
019;004;098;006;01;168;122;46
019;004;098;007;01;225;121;104
019;004;098;008;01;95;49;46
019;004;098;009;01;16;9;7
019;005;098;001;01;182;99;83
019;005;098;002;01;240;136;104
019;005;098;002;02;237;132;105
019;005;098;003;01;408;230;178
019;005;098;003;02;401;247;154
019;005;098;004;01;408;225;183
019;005;098;004;02;408;233;175
019;005;098;004;03;403;234;169
019;005;098;004;04;400;207;193
019;005;098;005;01;357;190;167
019;005;098;010;01;103;78;25
019;005;098;023;01;280;190;90
019;005;098;023;02;276;188;88
019;005;098;029;01;118;73;45
020;001;001;001;01;432;234;198
020;001;001;001;02;432;218;214
020;001;001;001;03;432;227;205
020;001;001;001;04;429;249;180
020;001;001;001;05;424;208;216
020;001;001;001;06;424;212;212
020;001;001;001;07;424;226;198
020;001;001;002;01;384;207;177
020;001;001;002;02;384;202;182
020;001;001;002;03;384;214;170
020;001;001;002;04;382;189;193
020;001;001;002;05;376;210;166
020;001;001;003;01;392;217;175
020;001;001;003;02;392;196;196
020;001;001;003;03;391;215;176
020;001;001;003;04;384;206;178
020;001;001;003;05;384;221;163
020;001;001;004;01;369;202;167
020;001;001;004;02;368;196;172
020;001;001;004;03;368;207;161
020;001;001;004;04;368;195;173
020;001;001;004;05;368;212;156
020;001;001;005;01;352;194;158
020;001;001;005;02;352;204;148
020;001;001;005;03;352;199;153
020;001;001;005;04;344;197;147
020;001;001;006;01;392;203;189
020;001;001;006;02;386;189;197
020;001;001;006;03;384;179;205
020;001;001;006;04;384;187;197
020;001;001;006;05;384;188;196
020;001;001;006;06;384;182;202
020;001;001;007;01;376;222;154
020;001;001;007;02;376;188;188
020;001;001;007;03;371;213;158
020;001;001;007;04;368;189;179
020;001;001;007;05;368;211;157
020;001;001;008;01;408;233;175
020;001;001;008;02;401;218;183
020;001;001;008;03;400;221;179
020;001;001;008;04;400;233;167
020;001;001;008;05;400;230;170
020;001;001;008;06;400;235;165
020;001;001;009;01;416;235;181
020;001;001;009;02;416;208;208
020;001;001;009;03;412;221;191
020;001;001;009;04;408;199;209
020;001;001;009;05;408;205;203
020;001;001;010;01;416;211;205
020;001;001;010;02;416;201;215
020;001;001;010;03;416;227;189
020;001;001;010;04;416;212;204
020;001;001;010;05;411;199;212
020;001;001;011;01;432;238;194
020;001;001;011;02;424;224;200
020;001;001;011;03;424;233;191
020;001;001;011;04;424;219;205
020;001;001;011;05;424;225;199
020;001;001;011;06;424;243;181
020;001;001;012;01;392;219;173
020;001;001;012;02;392;203;189
020;001;001;012;03;392;226;166
020;001;001;012;04;391;230;161
020;001;001;012;05;384;209;175
020;001;001;012;06;384;217;167
020;001;001;013;01;374;200;174
020;001;001;014;01;320;179;141
020;001;001;014;02;320;182;138
020;001;001;014;03;315;159;156
020;001;001;015;01;424;239;185
020;001;001;015;02;420;222;198
020;001;001;016;01;424;230;194
020;001;001;016;02;419;229;190
020;001;001;016;03;416;224;192
020;001;001;017;01;412;218;194
020;001;001;018;01;350;195;155
020;001;001;018;02;344;186;158
020;001;001;018;03;344;194;150
020;001;001;018;04;344;198;146
020;001;001;019;01;382;194;188
020;001;001;019;02;376;208;168
020;001;001;019;03;376;211;165
020;001;001;020;01;237;151;86
020;001;001;021;01;413;249;164
020;001;001;022;01;328;167;161
020;001;001;022;02;323;158;165
020;001;001;023;01;290;164;126
020;001;001;024;01;312;156;156
020;001;001;024;02;311;178;133
020;001;001;024;03;304;159;145
020;001;001;025;01;201;102;99
020;001;001;026;01;286;172;114
020;001;001;027;01;259;145;114
020;001;001;028;01;383;237;146
020;001;001;029;01;166;103;63
020;001;098;001;01;172;95;77
020;001;098;002;01;291;166;125
020;001;098;003;01;236;125;111
020;001;098;003;02;232;121;111
020;001;098;004;01;342;208;134
020;001;098;005;01;256;147;109
020;001;098;005;02;250;144;106
020;001;098;006;01;208;124;84
020;001;098;007;01;170;94;76
020;001;098;008;01;304;170;134
020;001;098;008;02;304;183;121
020;001;098;008;03;298;183;115
020;001;098;009;01;240;119;121
020;001;098;009;02;234;123;111
020;001;098;010;01;230;154;76
020;001;098;011;01;369;245;124
020;001;098;012;01;101;52;49
020;001;098;013;01;403;238;165
020;001;098;014;01;253;139;114
020;001;098;015;01;255;164;91
020;001;098;016;01;233;173;60
020;002;098;001;01;384;199;185
020;002;098;001;02;381;182;199
020;002;098;001;03;376;204;172
020;002;098;001;04;376;204;172
020;002;098;002;01;431;234;197
020;002;098;003;01;259;141;118
020;002;098;003;02;256;153;103
020;002;098;004;01;125;71;54
020;003;098;001;01;304;152;152
020;003;098;001;02;296;159;137
020;003;098;002;01;359;228;131
020;003;098;003;01;312;163;149
020;003;098;003;02;312;165;147
020;003;098;003;03;308;164;144
020;003;098;004;01;232;138;94
020;003;098;004;02;229;162;67
020;003;098;005;01;414;260;154
020;003;098;006;01;385;205;180
020;003;098;007;01;248;134;114
020;003;098;007;02;245;157;88
020;003;098;008;01;448;286;162
020;003;098;009;01;327;186;141
020;003;098;009;02;320;178;142
020;003;098;009;03;320;180;140
020;003;098;010;01;277;169;108
020;003;098;011;01;222;129;93
020;003;098;012;01;87;47;40
020;004;098;001;01;329;179;150
020;004;098;001;02;328;186;142
020;004;098;001;03;328;186;142
020;004;098;002;01;133;82;51
020;004;098;003;01;312;154;158
020;004;098;003;02;311;172;139
020;004;098;003;03;304;169;135
020;004;098;004;01;284;192;92
020;004;098;005;01;240;158;82
020;004;098;005;02;235;162;73
021;001;098;001;01;326;175;151
021;001;098;002;01;415;225;190
021;001;098;003;01;312;157;155
021;001;098;003;02;312;149;163
021;001;098;004;01;283;139;144
021;001;098;005;01;62;32;30
021;001;098;006;01;141;73;68
021;002;098;001;01;264;132;132
021;002;098;001;02;263;135;128
021;002;098;002;01;239;108;131
021;002;098;003;01;378;195;183
021;002;098;003;02;376;189;187
021;002;098;004;01;353;164;189
021;002;098;005;01;270;140;130
021;002;098;006;01;370;196;174
021;002;098;007;01;327;167;160
021;002;098;008;01;237;120;117
021;002;098;009;01;90;51;39
021;003;098;001;01;147;82;65
021;003;098;002;01;353;159;194
021;003;098;003;01;204;98;106
021;003;098;004;01;288;139;149
021;003;098;004;02;281;136;145
021;003;098;005;01;115;55;60
021;003;098;006;01;427;191;236
021;003;098;007;01;87;40;47
021;003;098;008;01;257;133;124
021;003;098;009;01;70;26;44
021;003;098;010;01;69;40;29
021;004;001;001;01;322;180;142
021;004;001;001;02;320;190;130
021;004;001;002;01;400;209;191
021;004;001;002;02;400;210;190
021;004;001;002;03;398;210;188
021;004;001;002;04;392;202;190
021;004;001;002;05;392;214;178
021;004;001;003;01;369;181;188
021;004;001;003;02;368;198;170
021;004;001;003;03;368;176;192
021;004;001;004;01;320;148;172
021;004;001;004;02;320;174;146
021;004;001;004;03;319;151;168
021;004;001;005;01;424;198;226
021;004;001;005;02;423;206;217
021;004;001;006;01;163;76;87
021;004;001;007;01;274;141;133
021;004;001;008;01;328;165;163
021;004;001;008;02;320;156;164
021;004;001;009;01;157;80;77
021;004;001;010;01;267;148;119
021;004;001;011;01;261;127;134
021;004;001;011;02;256;125;131
021;004;001;012;01;344;170;174
021;004;001;012;02;340;162;178
021;004;001;013;01;253;120;133
021;004;001;013;02;248;122;126
021;004;001;014;01;369;172;197
021;004;001;014;02;368;196;172
021;004;001;015;01;408;223;185
021;004;001;015;02;401;228;173
021;004;001;016;01;263;151;112
021;004;001;017;01;224;125;99
021;004;001;018;01;61;30;31
021;004;001;019;01;177;91;86
021;004;001;020;01;166;89;77
021;004;001;021;01;70;33;37
021;004;098;001;01;102;59;43
021;005;098;001;01;240;124;116
021;005;098;001;02;238;128;110
021;005;098;002;01;247;141;106
021;005;098;003;01;392;242;150
021;005;098;004;01;255;147;108
021;005;098;005;01;316;170;146
021;005;098;006;01;167;74;93
021;005;098;007;01;253;130;123
021;005;098;008;01;432;239;193
021;005;098;008;02;427;215;212
021;005;098;009;01;103;58;45
021;006;098;001;01;304;131;173
021;006;098;002;01;121;58;63
021;006;098;003;01;129;63;66
021;006;098;004;01;215;113;102
021;006;098;005;01;143;77;66
021;006;098;006;01;69;34;35
022;001;001;001;01;400;203;197
022;001;001;001;02;400;221;179
022;001;001;001;03;400;207;193
022;001;001;001;04;400;186;214
022;001;001;001;05;400;203;197
022;001;001;001;06;397;194;203
022;001;001;002;01;416;216;200
022;001;001;002;02;416;232;184
022;001;001;002;03;416;202;214
022;001;001;002;04;416;224;192
022;001;001;002;05;416;208;208
022;001;001;002;06;415;226;189
022;001;001;002;07;408;234;174
022;001;001;003;01;408;237;171
022;001;001;003;02;408;215;193
022;001;001;003;03;408;217;191
022;001;001;003;04;401;193;208
022;001;001;003;05;400;235;165
022;001;001;003;06;400;203;197
022;001;001;004;01;400;216;184
022;001;001;004;02;400;228;172
022;001;001;004;03;400;220;180
022;001;001;004;04;400;223;177
022;001;001;004;05;400;201;199
022;001;001;004;06;397;212;185
022;001;001;004;07;392;202;190
022;001;001;005;01;448;234;214
022;001;001;005;02;448;240;208
022;001;001;005;03;448;226;222
022;001;001;005;04;448;235;213
022;001;001;005;05;446;223;223
022;001;001;006;01;450;261;189
022;001;001;006;02;450;255;195
022;001;001;006;03;450;284;166
022;001;001;006;04;450;238;212
022;001;001;006;05;450;252;198
022;001;001;006;06;448;263;185
022;001;001;006;07;448;247;201
022;001;001;006;08;448;274;174
022;001;001;006;09;448;272;176
022;001;001;007;01;416;228;188
022;001;001;007;02;416;227;189
022;001;001;007;03;416;228;188
022;001;001;007;04;416;195;221
022;001;001;007;05;414;229;185
022;001;001;007;06;408;226;182
022;001;001;007;07;408;234;174
022;001;001;008;01;392;204;188
022;001;001;008;02;392;212;180
022;001;001;008;03;392;208;184
022;001;001;008;04;392;194;198
022;001;001;008;05;392;202;190
022;001;001;008;06;387;213;174
022;001;001;009;01;450;238;212
022;001;001;009;02;450;273;177
022;001;001;009;03;450;240;210
022;001;001;009;04;450;238;212
022;001;001;009;05;450;244;206
022;001;001;009;06;448;242;206
022;001;001;010;01;432;211;221
022;001;001;010;02;432;211;221
022;001;001;010;03;427;210;217
022;001;001;010;04;424;222;202
022;001;001;011;01;416;207;209
022;001;001;011;02;416;237;179
022;001;001;011;03;408;228;180
022;001;001;011;04;408;213;195
022;001;001;011;05;408;197;211
022;001;001;011;06;408;220;188
022;001;001;011;07;408;209;199
022;001;001;012;01;440;211;229
022;001;001;012;02;440;231;209
022;001;001;012;03;433;226;207
022;001;001;012;04;432;215;217
022;001;001;012;05;432;213;219
022;001;001;012;06;432;222;210
022;001;001;013;01;400;189;211
022;001;001;013;02;400;210;190
022;001;001;013;03;400;196;204
022;001;001;013;04;400;217;183
022;001;001;013;05;397;197;200
022;001;001;013;06;392;196;196
022;001;001;013;07;392;204;188
022;001;001;014;01;424;223;201
022;001;001;014;02;424;227;197
022;001;001;014;03;424;222;202
022;001;001;014;04;424;205;219
022;001;001;014;05;424;213;211
022;001;001;014;06;417;220;197
022;001;001;014;07;416;220;196
022;001;001;015;01;416;191;225
022;001;001;015;02;416;219;197
022;001;001;015;03;416;216;200
022;001;001;015;04;416;221;195
022;001;001;015;05;416;214;202
022;001;001;015;06;416;215;201
022;001;001;015;07;414;213;201
022;001;001;015;08;408;214;194
022;001;001;016;01;424;223;201
022;001;001;016;02;424;236;188
022;001;001;016;03;421;214;207
022;001;001;016;04;416;206;210
022;001;001;016;05;416;211;205
022;001;001;016;06;416;228;188
022;001;001;016;07;416;207;209
022;001;001;017;01;392;192;200
022;001;001;017;02;390;220;170
022;001;001;017;03;384;190;194
022;001;001;017;04;384;191;193
022;001;001;017;05;384;183;201
022;001;001;017;06;384;172;212
022;001;001;018;01;440;249;191
022;001;001;018;02;440;250;190
022;001;001;018;03;435;225;210
022;001;001;018;04;432;223;209
022;001;001;018;05;432;227;205
022;001;001;018;06;432;242;190
022;001;001;019;01;416;197;219
022;001;001;019;02;410;226;184
022;001;001;019;03;408;201;207
022;001;001;019;04;408;207;201
022;001;001;019;05;408;202;206
022;001;001;019;06;408;213;195
022;001;001;019;07;408;223;185
022;001;001;019;08;408;198;210
022;001;001;020;01;424;211;213
022;001;001;020;02;424;210;214
022;001;001;020;03;424;185;239
022;001;001;020;04;416;196;220
022;001;001;020;05;416;200;216
022;001;001;021;01;384;202;182
022;001;001;021;02;384;208;176
022;001;001;021;03;380;189;191
022;001;001;021;04;376;204;172
022;001;001;021;05;376;203;173
022;001;001;021;06;376;200;176
022;001;001;022;01;416;213;203
022;001;001;022;02;416;224;192
022;001;001;022;03;413;195;218
022;001;001;022;04;408;222;186
022;001;001;023;01;408;204;204
022;001;001;023;02;405;197;208
022;001;001;023;03;400;187;213
022;001;001;023;04;400;217;183
022;001;001;023;05;400;221;179
022;001;001;024;01;440;233;207
022;001;001;024;02;440;210;230
022;001;001;024;03;434;233;201
022;001;001;024;04;432;209;223
022;001;001;024;05;432;221;211
022;001;001;025;01;440;251;189
022;001;001;025;02;440;223;217
022;001;001;025;03;439;226;213
022;001;001;025;04;432;256;176
022;001;001;026;01;440;221;219
022;001;001;026;02;439;242;197
022;001;001;026;03;432;241;191
022;001;001;026;04;432;241;191
022;001;001;026;05;432;210;222
022;001;001;026;06;432;208;224
022;001;001;026;07;432;212;220
022;001;001;026;08;432;216;216
022;001;001;026;09;432;230;202
022;001;001;026;10;432;217;215
022;001;001;027;01;426;221;205
022;001;001;027;02;424;242;182
022;001;001;027;03;424;251;173
022;001;001;027;04;424;227;197
022;001;001;027;05;424;221;203
022;001;001;027;06;424;240;184
022;001;001;027;07;424;218;206
022;001;001;027;08;424;250;174
022;001;001;027;09;424;250;174
022;001;001;028;01;432;226;206
022;001;001;028;02;432;223;209
022;001;001;028;03;425;225;200
022;001;001;028;04;424;234;190
022;001;001;028;05;424;212;212
022;001;001;029;01;448;250;198
022;001;001;029;02;448;253;195
022;001;001;029;03;448;250;198
022;001;001;029;04;448;248;200
022;001;001;029;05;446;250;196
022;001;001;029;06;440;247;193
022;001;001;030;01;400;194;206
022;001;001;030;02;400;219;181
022;001;001;030;03;400;205;195
022;001;001;030;04;400;194;206
022;001;001;030;05;400;203;197
022;001;001;030;06;400;198;202
022;001;001;030;07;398;205;193
022;001;001;031;01;416;235;181
022;001;001;031;02;416;241;175
022;001;001;031;03;416;219;197
022;001;001;031;04;416;219;197
022;001;001;031;05;416;212;204
022;001;001;031;06;411;227;184
022;001;001;032;01;432;265;167
022;001;001;032;02;432;247;185
022;001;001;032;03;426;230;196
022;001;001;032;04;424;222;202
022;001;001;032;05;424;241;183
022;001;001;032;06;424;252;172
022;001;001;033;01;414;231;183
022;001;001;033;02;408;220;188
022;001;001;033;03;408;230;178
022;001;001;033;04;408;192;216
022;001;001;033;05;408;225;183
022;001;001;034;01;408;201;207
022;001;001;034;02;408;209;199
022;001;001;034;03;408;223;185
022;001;001;034;04;408;206;202
022;001;001;034;05;408;218;190
022;001;001;034;06;400;192;208
022;001;001;034;07;400;236;164
022;001;001;034;08;400;221;179
022;001;001;035;01;440;259;181
022;001;001;035;02;440;256;184
022;001;001;035;03;440;242;198
022;001;001;035;04;440;252;188
022;001;001;035;05;440;255;185
022;001;001;035;06;436;229;207
022;001;001;035;07;432;257;175
022;001;001;035;08;432;257;175
022;001;001;036;01;432;211;221
022;001;001;036;02;432;219;213
022;001;001;036;03;432;247;185
022;001;001;036;04;432;232;200
022;001;001;036;05;424;248;176
022;001;001;036;06;424;223;201
022;001;001;036;07;424;213;211
022;001;001;036;08;424;247;177
022;001;001;036;09;424;196;228
022;001;001;036;10;424;200;224
022;001;001;036;11;424;218;206
022;001;001;036;12;424;247;177
022;001;001;036;13;424;227;197
022;001;001;036;14;424;243;181
022;001;001;037;01;392;187;205
022;001;001;037;02;392;198;194
022;001;001;037;03;392;171;221
022;001;001;037;04;387;193;194
022;001;001;037;05;384;170;214
022;001;001;037;06;384;199;185
022;001;001;038;01;448;219;229
022;001;001;038;02;448;226;222
022;001;001;038;03;448;217;231
022;001;001;038;04;448;220;228
022;001;001;038;05;448;240;208
022;001;001;038;06;441;243;198
022;001;001;039;01;432;218;214
022;001;001;039;02;432;215;217
022;001;001;039;03;432;235;197
022;001;001;039;04;432;229;203
022;001;001;039;05;432;238;194
022;001;001;039;06;432;239;193
022;001;001;039;07;428;220;208
022;001;001;039;08;424;205;219
022;001;001;039;09;424;253;171
022;001;001;039;10;424;260;164
022;001;001;039;11;424;247;177
022;001;001;040;01;400;198;202
022;001;001;040;02;400;218;182
022;001;001;040;03;393;205;188
022;001;001;040;04;392;199;193
022;001;001;040;05;392;188;204
022;001;001;040;06;392;206;186
022;001;001;040;07;392;229;163
022;001;001;041;01;436;212;224
022;001;001;041;02;432;228;204
022;001;001;041;03;432;221;211
022;001;001;041;04;432;238;194
022;001;001;041;05;432;221;211
022;001;001;041;06;432;236;196
022;001;001;041;07;432;192;240
022;001;001;041;08;432;196;236
022;001;001;041;09;432;209;223
022;001;001;041;10;432;237;195
022;001;001;041;11;432;221;211
022;001;001;042;01;408;238;170
022;001;001;042;02;408;218;190
022;001;001;042;03;408;200;208
022;001;001;042;04;401;192;209
022;001;001;042;05;400;187;213
022;001;001;042;06;400;230;170
022;001;001;042;07;400;200;200
022;001;001;043;01;440;207;233
022;001;001;043;02;440;238;202
022;001;001;043;03;440;239;201
022;001;001;043;04;440;215;225
022;001;001;043;05;440;234;206
022;001;001;043;06;440;216;224
022;001;001;043;07;440;198;242
022;001;001;043;08;440;207;233
022;001;001;043;09;438;243;195
022;001;001;043;10;432;224;208
022;001;001;044;01;408;187;221
022;001;001;044;02;408;197;211
022;001;001;044;03;408;206;202
022;001;001;044;04;408;207;201
022;001;001;044;05;408;173;235
022;001;001;044;06;404;213;191
022;001;001;044;07;400;200;200
022;001;001;045;01;424;208;216
022;001;001;045;02;424;191;233
022;001;001;045;03;420;206;214
022;001;001;045;04;416;180;236
022;001;001;045;05;416;186;230
022;001;001;045;06;416;207;209
022;001;001;045;07;416;195;221
022;001;001;045;08;416;203;213
022;001;001;045;09;416;208;208
022;001;001;046;01;408;205;203
022;001;001;046;02;408;180;228
022;001;001;046;03;408;188;220
022;001;001;046;04;408;204;204
022;001;001;046;05;408;200;208
022;001;001;046;06;408;194;214
022;001;001;046;07;408;198;210
022;001;001;046;08;402;195;207
022;001;001;046;09;400;186;214
022;001;001;047;01;424;199;225
022;001;001;047;02;424;185;239
022;001;001;047;03;424;186;238
022;001;001;047;04;424;168;256
022;001;001;048;01;440;227;213
022;001;001;048;02;440;242;198
022;001;001;048;03;438;241;197
022;001;001;048;04;432;249;183
022;001;001;048;05;432;237;195
022;001;001;048;06;432;245;187
022;001;001;049;01;440;249;191
022;001;001;049;02;440;259;181
022;001;001;049;03;435;216;219
022;001;001;049;04;432;225;207
022;001;001;049;05;432;217;215
022;001;001;049;06;432;250;182
022;001;001;050;01;432;265;167
022;001;001;050;02;432;266;166
022;001;001;050;03;431;232;199
022;001;001;050;04;424;248;176
022;001;001;050;05;424;239;185
022;001;001;050;06;424;253;171
022;001;001;050;07;424;252;172
022;001;001;051;01;400;209;191
022;001;001;051;02;400;205;195
022;001;001;051;03;400;213;187
022;001;001;051;04;400;209;191
022;001;001;051;05;400;211;189
022;001;001;051;06;392;194;198
022;001;001;052;01;408;197;211
022;001;001;052;02;408;218;190
022;001;001;052;03;408;209;199
022;001;001;052;04;408;188;220
022;001;001;052;05;408;204;204
022;001;001;052;06;408;211;197
022;001;001;052;07;408;217;191
022;001;001;052;08;404;195;209
022;001;001;053;01;440;206;234
022;001;001;053;02;440;219;221
022;001;001;053;03;440;208;232
022;001;001;053;04;433;210;223
022;001;001;054;01;450;204;246
022;001;001;054;02;450;232;218
022;001;001;054;03;450;213;237
022;001;001;054;04;450;212;238
022;001;001;054;05;448;218;230
022;001;001;054;06;448;203;245
022;001;001;054;07;448;192;256
022;001;001;054;08;448;230;218
022;001;001;054;09;448;233;215
022;001;001;055;01;408;215;193
022;001;001;055;02;408;228;180
022;001;001;055;03;408;222;186
022;001;001;055;04;408;196;212
022;001;001;055;05;408;194;214
022;001;001;055;06;405;224;181
022;001;001;055;07;400;220;180
022;001;001;056;01;376;216;160
022;001;001;056;02;376;207;169
022;001;001;056;03;376;189;187
022;001;001;056;04;376;197;179
022;001;001;056;05;373;206;167
022;001;001;057;01;384;225;159
022;001;001;057;02;383;218;165
022;001;001;057;03;376;222;154
022;001;001;057;04;376;194;182
022;001;001;057;05;376;231;145
022;001;001;058;01;448;236;212
022;001;001;058;02;448;213;235
022;001;001;058;03;443;230;213
022;001;001;059;01;416;238;178
022;001;001;059;02;416;238;178
022;001;001;059;03;416;228;188
022;001;001;059;04;416;237;179
022;001;001;059;05;416;219;197
022;001;001;059;06;416;214;202
022;001;001;059;07;409;222;187
022;001;001;060;01;384;221;163
022;001;001;060;02;384;204;180
022;001;001;060;03;384;191;193
022;001;001;060;04;383;207;176
022;001;001;060;05;376;193;183
022;001;001;061;01;426;192;234
022;001;001;061;02;424;221;203
022;001;001;061;03;424;204;220
022;001;001;061;04;424;208;216
022;001;001;061;05;424;197;227
022;001;001;061;06;424;213;211
022;001;001;061;07;424;197;227
022;001;001;062;01;416;216;200
022;001;001;062;02;414;214;200
022;001;001;062;03;408;201;207
022;001;001;062;04;408;229;179
022;001;001;062;05;408;203;205
022;001;001;062;06;408;223;185
022;001;001;062;07;408;213;195
022;001;001;063;01;424;231;193
022;001;001;063;02;424;222;202
022;001;001;063;03;424;227;197
022;001;001;063;04;417;243;174
022;001;001;064;01;432;235;197
022;001;001;064;02;432;222;210
022;001;001;064;03;424;226;198
022;001;001;064;04;424;214;210
022;001;001;064;05;424;234;190
022;001;001;065;01;408;206;202
022;001;001;065;02;408;209;199
022;001;001;065;03;408;189;219
022;001;001;065;04;407;199;208
022;001;001;065;05;400;214;186
022;001;001;066;01;408;202;206
022;001;001;066;02;406;201;205
022;001;001;066;03;400;188;212
022;001;001;066;04;400;195;205
022;001;001;067;01;408;196;212
022;001;001;067;02;402;199;203
022;001;001;067;03;400;160;240
022;001;001;068;01;408;196;212
022;001;001;068;02;408;207;201
022;001;001;068;03;408;245;163
022;001;001;068;04;408;208;200
022;001;001;068;05;408;202;206
022;001;001;068;06;408;207;201
022;001;001;068;07;406;217;189
022;001;001;068;08;400;194;206
022;001;001;069;01;360;210;150
022;001;001;069;02;360;194;166
022;001;001;069;03;360;192;168
022;001;001;069;04;360;188;172
022;001;001;070;01;440;233;207
022;001;001;070;02;440;232;208
022;001;001;070;03;440;235;205
022;001;001;070;04;440;239;201
022;001;001;070;05;436;206;230
022;001;001;070;06;432;245;187
022;001;001;071;01;392;204;188
022;001;001;071;02;392;200;192
022;001;001;071;03;392;214;178
022;001;001;071;04;392;200;192
022;001;001;071;05;385;215;170
022;001;001;072;01;416;214;202
022;001;001;072;02;416;222;194
022;001;001;072;03;416;225;191
022;001;001;072;04;416;225;191
022;001;001;072;05;416;218;198
022;001;001;072;06;416;206;210
022;001;001;072;07;416;229;187
022;001;001;072;08;415;208;207
022;001;001;073;01;408;213;195
022;001;001;073;02;408;227;181
022;001;001;073;03;408;194;214
022;001;001;073;04;407;218;189
022;001;001;073;05;400;214;186
022;001;001;074;01;440;242;198
022;001;001;074;02;440;227;213
022;001;001;074;03;440;242;198
022;001;001;074;04;440;213;227
022;001;001;074;05;435;238;197
022;001;001;075;01;440;202;238
022;001;001;075;02;438;234;204
022;001;001;075;03;432;228;204
022;001;001;075;04;432;214;218
022;001;001;075;05;432;225;207
022;001;001;075;06;432;215;217
022;001;001;076;01;440;240;200
022;001;001;076;02;434;268;166
022;001;001;076;03;432;241;191
022;001;001;076;04;432;246;186
022;001;001;077;01;407;188;219
022;001;001;077;02;400;216;184
022;001;001;077;03;400;204;196
022;001;001;077;04;400;212;188
022;001;001;077;05;400;224;176
022;001;001;078;01;400;213;187
022;001;001;078;02;400;229;171
022;001;001;078;03;400;209;191
022;001;001;078;04;400;212;188
022;001;001;078;05;394;220;174
022;001;001;078;06;392;230;162
022;001;001;079;01;416;211;205
022;001;001;079;02;416;220;196
022;001;001;079;03;416;198;218
022;001;001;079;04;416;208;208
022;001;001;079;05;409;192;217
022;001;001;079;06;408;223;185
022;001;001;080;01;368;189;179
022;001;001;080;02;368;200;168
022;001;001;080;03;360;201;159
022;001;001;080;04;360;175;185
022;001;001;080;05;360;195;165
022;001;001;081;01;400;223;177
022;001;001;081;02;400;233;167
022;001;001;081;03;397;216;181
022;001;001;081;04;392;234;158
022;001;001;082;01;408;210;198
022;001;001;082;02;408;233;175
022;001;001;082;03;408;226;182
022;001;001;082;04;408;231;177
022;001;001;082;05;400;217;183
022;001;001;082;06;400;215;185
022;001;001;082;07;400;204;196
022;001;001;082;08;400;229;171
022;001;001;082;09;400;237;163
022;001;001;083;01;400;217;183
022;001;001;083;02;400;231;169
022;001;001;083;03;396;179;217
022;001;001;083;04;392;187;205
022;001;001;083;05;392;195;197
022;001;001;083;06;392;217;175
022;001;001;084;01;400;211;189
022;001;001;084;02;400;245;155
022;001;001;084;03;400;202;198
022;001;001;084;04;400;196;204
022;001;001;084;05;395;201;194
022;001;001;085;01;392;197;195
022;001;001;085;02;392;220;172
022;001;001;085;03;387;203;184
022;001;001;085;04;384;205;179
022;001;001;085;05;384;166;218
022;001;001;085;06;384;200;184
022;001;001;085;07;384;196;188
022;001;001;086;01;424;226;198
022;001;001;086;02;424;230;194
022;001;001;086;03;419;223;196
022;001;001;086;04;416;227;189
022;001;001;086;05;416;216;200
022;001;001;086;06;416;230;186
022;001;001;086;07;416;223;193
022;001;001;087;01;444;231;213
022;001;001;087;02;440;228;212
022;001;001;087;03;440;238;202
022;001;001;087;04;440;216;224
022;001;001;087;05;440;211;229
022;001;001;087;06;440;241;199
022;001;001;088;01;408;219;189
022;001;001;088;02;402;215;187
022;001;001;088;03;400;191;209
022;001;001;088;04;400;189;211
022;001;001;088;05;400;212;188
022;001;001;088;06;400;216;184
022;001;001;089;01;448;221;227
022;001;001;089;02;448;246;202
022;001;001;089;03;448;245;203
022;001;001;089;04;448;247;201
022;001;001;090;01;416;203;213
022;001;001;090;02;410;220;190
022;001;001;090;03;408;220;188
022;001;001;090;04;408;209;199
022;001;001;090;05;408;195;213
022;001;001;090;06;408;216;192
022;001;001;091;01;430;211;219
022;001;001;091;02;424;203;221
022;001;001;091;03;424;197;227
022;001;001;091;04;424;206;218
022;001;001;091;05;424;226;198
022;001;001;092;01;450;227;223
022;001;001;092;02;450;233;217
022;001;001;092;03;450;251;199
022;001;001;092;04;448;218;230
022;001;001;092;05;448;231;217
022;001;001;092;06;448;229;219
022;001;001;092;07;448;242;206
022;001;001;093;01;440;241;199
022;001;001;093;02;440;235;205
022;001;001;093;03;440;247;193
022;001;001;093;04;439;228;211
022;001;001;093;05;432;235;197
022;001;001;093;06;432;256;176
022;001;001;093;07;432;208;224
022;001;001;093;08;432;246;186
022;001;001;093;09;432;235;197
022;001;001;094;01;440;219;221
022;001;001;094;02;440;206;234
022;001;001;094;03;440;222;218
022;001;001;094;04;440;227;213
022;001;001;094;05;440;215;225
022;001;001;094;06;440;219;221
022;001;001;094;07;439;221;218
022;001;001;095;01;450;237;213
022;001;001;095;02;449;237;212
022;001;001;095;03;448;243;205
022;001;001;095;04;448;265;183
022;001;001;095;05;448;245;203
022;001;001;096;01;424;254;170
022;001;001;096;02;424;257;167
022;001;001;096;03;417;234;183
022;001;001;096;04;416;239;177
022;001;001;096;05;416;240;176
022;001;001;096;06;416;235;181
022;001;001;097;01;408;220;188
022;001;001;097;02;408;208;200
022;001;001;097;03;408;205;203
022;001;001;097;04;408;230;178
022;001;001;097;05;408;188;220
022;001;001;097;06;400;196;204
022;001;001;098;01;416;197;219
022;001;001;098;02;416;231;185
022;001;001;098;03;416;214;202
022;001;001;098;04;410;194;216
022;001;001;098;05;408;210;198
022;001;001;098;06;408;191;217
022;001;001;098;07;408;207;201
022;001;001;098;08;408;214;194
022;001;001;099;01;432;253;179
022;001;001;099;02;432;215;217
022;001;001;099;03;432;245;187
022;001;001;099;04;432;230;202
022;001;001;099;05;424;229;195
022;001;001;099;06;424;225;199
022;001;001;099;07;424;240;184
022;001;001;100;01;424;228;196
022;001;001;100;02;424;220;204
022;001;001;100;03;424;231;193
022;001;001;100;04;424;230;194
022;001;001;100;05;418;222;196
022;001;001;100;06;416;230;186
022;001;001;100;07;416;207;209
022;001;001;100;08;416;209;207
022;001;001;101;01;424;232;192
022;001;001;101;02;424;255;169
022;001;001;101;03;424;234;190
022;001;001;101;04;424;247;177
022;001;001;101;05;424;215;209
022;001;001;101;06;419;232;187
022;001;001;102;01;435;195;240
022;001;001;102;02;432;211;221
022;001;001;102;03;432;207;225
022;001;001;102;04;432;219;213
022;001;001;103;01;377;208;169
022;001;001;103;02;376;204;172
022;001;001;103;03;376;206;170
022;001;001;103;04;376;191;185
022;001;001;103;05;376;231;145
022;001;001;103;06;376;220;156
022;001;001;104;01;432;232;200
022;001;001;104;02;432;231;201
022;001;001;104;03;432;241;191
022;001;001;104;04;432;243;189
022;001;001;104;05;432;225;207
022;001;001;104;06;431;242;189
022;001;001;104;07;424;234;190
022;001;001;104;08;424;247;177
022;001;001;104;09;424;233;191
022;001;001;105;01;400;238;162
022;001;001;105;02;400;240;160
022;001;001;105;03;400;245;155
022;001;001;105;04;397;237;160
022;001;001;105;05;392;234;158
022;001;001;105;06;392;217;175
022;001;001;105;07;392;240;152
022;001;001;105;08;392;239;153
022;001;001;106;01;419;223;196
022;001;001;106;02;416;226;190
022;001;001;106;03;416;231;185
022;001;001;106;04;416;206;210
022;001;001;106;05;416;247;169
022;001;001;107;01;400;208;192
022;001;001;107;02;400;217;183
022;001;001;107;03;400;210;190
022;001;001;107;04;400;215;185
022;001;001;107;05;400;209;191
022;001;001;107;06;400;215;185
022;001;001;107;07;396;221;175
022;001;001;108;01;436;237;199
022;001;001;108;02;432;214;218
022;001;001;108;03;432;245;187
022;001;001;108;04;432;230;202
022;001;001;108;05;432;235;197
022;001;001;109;01;408;204;204
022;001;001;109;02;408;212;196
022;001;001;109;03;408;203;205
022;001;001;109;04;408;192;216
022;001;001;109;05;408;219;189
022;001;001;109;06;408;213;195
022;001;001;109;07;408;223;185
022;001;001;109;08;406;213;193
022;001;001;110;01;440;241;199
022;001;001;110;02;440;240;200
022;001;001;110;03;440;250;190
022;001;001;110;04;440;254;186
022;001;001;110;05;440;223;217
022;001;001;110;06;440;225;215
022;001;001;110;07;439;234;205
022;001;001;111;01;448;251;197
022;001;001;111;02;448;246;202
022;001;001;111;03;448;238;210
022;001;001;111;04;448;231;217
022;001;001;111;05;445;223;222
022;001;001;112;01;432;213;219
022;001;001;112;02;432;223;209
022;001;001;112;03;432;230;202
022;001;001;112;04;432;231;201
022;001;001;112;05;432;226;206
022;001;001;112;06;432;214;218
022;001;001;112;07;432;227;205
022;001;001;112;08;432;229;203
022;001;001;112;09;432;225;207
022;001;001;112;10;431;226;205
022;001;001;113;01;412;234;178
022;001;001;113;02;408;208;200
022;001;001;113;03;408;218;190
022;001;001;113;04;408;231;177
022;001;001;113;05;408;215;193
022;001;001;113;06;408;232;176
022;001;001;113;07;408;226;182
022;001;001;113;08;408;228;180
022;001;001;114;01;424;216;208
022;001;001;114;02;420;225;195
022;001;001;114;03;416;223;193
022;001;001;114;04;416;232;184
022;001;001;115;01;379;187;192
022;001;001;115;02;376;182;194
022;001;001;115;03;376;190;186
022;001;001;115;04;376;182;194
022;001;001;115;05;376;179;197
022;001;001;115;06;376;202;174
022;001;001;116;01;372;196;176
022;001;001;116;02;368;206;162
022;001;001;116;03;368;179;189
022;001;001;116;04;368;211;157
022;001;001;116;05;368;199;169
022;001;001;117;01;448;219;229
022;001;001;117;02;441;221;220
022;001;001;117;03;440;210;230
022;001;001;117;04;440;223;217
022;001;001;117;05;440;221;219
022;001;001;117;06;440;232;208
022;001;001;117;07;440;225;215
022;001;001;118;01;392;183;209
022;001;001;118;02;392;200;192
022;001;001;118;03;392;204;188
022;001;001;118;04;392;174;218
022;001;001;118;05;392;191;201
022;001;001;118;06;385;193;192
022;001;001;118;07;384;192;192
022;001;001;119;01;408;236;172
022;001;001;119;02;408;203;205
022;001;001;119;03;408;229;179
022;001;001;119;04;408;215;193
022;001;001;119;05;401;240;161
022;001;001;119;06;400;191;209
022;001;001;119;07;400;202;198
022;001;001;119;08;400;227;173
022;001;001;120;01;448;240;208
022;001;001;120;02;448;239;209
022;001;001;120;03;444;210;234
022;001;001;120;04;440;239;201
022;001;001;121;01;432;216;216
022;001;001;121;02;432;226;206
022;001;001;121;03;427;216;211
022;001;001;121;04;424;212;212
022;001;001;122;01;400;211;189
022;001;001;122;02;400;214;186
022;001;001;122;03;400;214;186
022;001;001;122;04;394;192;202
022;001;001;122;05;392;194;198
022;001;001;122;06;392;227;165
022;001;001;122;07;392;221;171
022;001;001;123;01;400;198;202
022;001;001;123;02;397;190;207
022;001;001;123;03;392;176;216
022;001;001;123;04;392;199;193
022;001;001;124;01;441;213;228
022;001;001;124;02;440;230;210
022;001;001;124;03;440;219;221
022;001;001;124;04;440;199;241
022;001;001;124;05;440;222;218
022;001;001;125;01;392;201;191
022;001;001;125;02;391;180;211
022;001;001;125;03;384;185;199
022;001;001;126;01;408;199;209
022;001;001;126;02;408;180;228
022;001;001;126;03;408;193;215
022;001;001;126;04;408;197;211
022;001;001;126;05;408;169;239
022;001;001;126;06;404;206;198
022;001;001;126;07;400;206;194
022;001;001;126;08;400;197;203
022;001;001;127;01;408;215;193
022;001;001;127;02;408;204;204
022;001;001;127;03;407;217;190
022;001;001;127;04;400;215;185
022;001;001;127;05;400;189;211
022;001;001;128;01;408;219;189
022;001;001;128;02;408;245;163
022;001;001;128;03;408;208;200
022;001;001;128;04;406;218;188
022;001;001;128;05;400;213;187
022;001;001;129;01;416;230;186
022;001;001;129;02;416;226;190
022;001;001;129;03;416;217;199
022;001;001;129;04;416;221;195
022;001;001;129;05;414;193;221
022;001;001;129;06;408;208;200
022;001;001;129;07;408;219;189
022;001;001;129;08;408;210;198
022;001;001;130;01;400;191;209
022;001;001;130;02;400;216;184
022;001;001;130;03;400;213;187
022;001;001;130;04;400;205;195
022;001;001;130;05;400;193;207
022;001;001;130;06;400;213;187
022;001;001;130;07;393;206;187
022;001;001;131;01;376;204;172
022;001;001;131;02;376;195;181
022;001;001;131;03;376;177;199
022;001;001;131;04;376;197;179
022;001;001;131;05;368;201;167
022;001;001;132;01;432;235;197
022;001;001;132;02;432;225;207
022;001;001;132;03;432;211;221
022;001;001;132;04;429;245;184
022;001;001;132;05;424;224;200
022;001;001;132;06;424;232;192
022;001;001;133;01;432;201;231
022;001;001;133;02;432;213;219
022;001;001;133;03;428;216;212
022;001;001;133;04;424;204;220
022;001;001;133;05;424;209;215
022;001;001;133;06;424;225;199
022;001;001;134;01;408;208;200
022;001;001;134;02;408;245;163
022;001;001;134;03;408;240;168
022;001;001;134;04;408;230;178
022;001;001;134;05;408;241;167
022;001;001;134;06;408;209;199
022;001;001;134;07;403;216;187
022;001;001;134;08;400;234;166
022;001;001;134;09;400;222;178
022;001;001;135;01;424;253;171
022;001;001;135;02;424;244;180
022;001;001;135;03;424;224;200
022;001;001;135;04;424;245;179
022;001;001;135;05;424;226;198
022;001;001;135;06;424;234;190
022;001;001;135;07;424;245;179
022;001;001;135;08;417;234;183
022;001;001;136;01;440;224;216
022;001;001;136;02;440;203;237
022;001;001;136;03;440;209;231
022;001;001;136;04;440;208;232
022;001;001;136;05;440;220;220
022;001;001;136;06;432;213;219
022;001;001;136;07;432;220;212
022;001;001;137;01;431;228;203
022;001;001;137;02;424;240;184
022;001;001;137;03;424;235;189
022;001;001;137;04;424;222;202
022;001;001;137;05;424;202;222
022;001;001;137;06;424;217;207
022;001;001;137;07;424;197;227
022;001;001;138;01;424;199;225
022;001;001;138;02;419;217;202
022;001;001;138;03;416;217;199
022;001;001;138;04;416;203;213
022;001;001;138;05;416;209;207
022;001;001;138;06;416;204;212
022;001;001;138;07;416;230;186
022;001;001;138;08;416;206;210
022;001;001;139;01;416;236;180
022;001;001;139;02;416;216;200
022;001;001;139;03;416;206;210
022;001;001;139;04;416;205;211
022;001;001;139;05;408;197;211
022;001;001;140;01;448;237;211
022;001;001;140;02;448;246;202
022;001;001;140;03;444;211;233
022;001;001;140;04;440;238;202
022;001;001;141;01;385;189;196
022;001;001;141;02;384;184;200
022;001;001;141;03;384;173;211
022;001;001;141;04;384;195;189
022;001;001;141;05;384;192;192
022;001;001;142;01;440;224;216
022;001;001;142;02;440;223;217
022;001;001;142;03;440;233;207
022;001;001;142;04;440;232;208
022;001;001;142;05;440;221;219
022;001;001;142;06;435;227;208
022;001;001;143;01;432;221;211
022;001;001;143;02;432;233;199
022;001;001;143;03;425;196;229
022;001;001;143;04;424;214;210
022;001;001;143;05;424;237;187
022;001;001;144;01;448;236;212
022;001;001;144;02;448;240;208
022;001;001;144;03;440;230;210
022;001;001;144;04;440;204;236
022;001;001;144;05;440;241;199
022;001;001;144;06;440;240;200
022;001;001;145;01;416;220;196
022;001;001;145;02;416;219;197
022;001;001;145;03;416;193;223
022;001;001;145;04;416;217;199
022;001;001;145;05;416;199;217
022;001;001;145;06;416;225;191
022;001;001;145;07;408;213;195
022;001;001;145;08;408;214;194
022;001;001;145;09;408;195;213
022;001;001;146;01;400;212;188
022;001;001;146;02;400;199;201
022;001;001;146;03;398;207;191
022;001;001;146;04;392;187;205
022;001;001;147;01;376;183;193
022;001;001;147;02;376;197;179
022;001;001;147;03;376;179;197
022;001;001;147;04;376;166;210
022;001;001;147;05;376;189;187
022;001;001;147;06;374;206;168
022;001;001;148;01;422;238;184
022;001;001;148;02;416;238;178
022;001;001;148;03;416;221;195
022;001;001;148;04;416;222;194
022;001;001;149;01;450;260;190
022;001;001;149;02;450;222;228
022;001;001;149;03;450;229;221
022;001;001;149;04;450;249;201
022;001;001;149;05;450;245;205
022;001;001;149;06;449;232;217
022;001;001;149;07;448;234;214
022;001;001;149;08;448;242;206
022;001;001;150;01;433;260;173
022;001;001;150;02;432;258;174
022;001;001;150;03;432;237;195
022;001;001;150;04;432;245;187
022;001;001;150;05;432;248;184
022;001;001;150;06;432;250;182
022;001;001;150;07;432;284;148
022;001;001;150;08;432;255;177
022;001;001;151;01;424;220;204
022;001;001;151;02;424;222;202
022;001;001;151;03;424;220;204
022;001;001;151;04;424;210;214
022;001;001;151;05;424;238;186
022;001;001;151;06;422;226;196
022;001;001;152;01;448;246;202
022;001;001;152;02;448;248;200
022;001;001;152;03;448;226;222
022;001;001;152;04;448;234;214
022;001;001;152;05;448;256;192
022;001;001;152;06;444;260;184
022;001;001;153;01;450;246;204
022;001;001;153;02;450;243;207
022;001;001;153;03;450;231;219
022;001;001;153;04;449;245;204
022;001;001;153;05;448;237;211
022;001;001;153;06;448;247;201
022;001;001;154;01;440;224;216
022;001;001;154;02;440;237;203
022;001;001;154;03;440;233;207
022;001;001;154;04;440;210;230
022;001;001;154;05;440;233;207
022;001;001;155;01;432;223;209
022;001;001;155;02;432;219;213
022;001;001;155;03;432;210;222
022;001;001;155;04;424;233;191
022;001;001;155;05;424;205;219
022;001;001;156;01;384;207;177
022;001;001;156;02;384;192;192
022;001;001;156;03;384;213;171
022;001;001;156;04;379;189;190
022;001;001;157;01;366;202;164
022;001;001;157;02;360;191;169
022;001;001;157;03;360;191;169
022;001;001;157;04;360;180;180
022;001;001;158;01;448;207;241
022;001;001;158;02;441;204;237
022;001;001;159;01;396;229;167
022;001;001;159;02;392;224;168
022;001;001;159;03;392;222;170
022;001;001;160;01;392;221;171
022;001;001;160;02;392;205;187
022;001;001;160;03;392;198;194
022;001;001;160;04;392;226;166
022;001;001;160;05;392;212;180
022;001;001;160;06;392;220;172
022;001;001;160;07;388;225;163
022;001;001;161;01;448;247;201
022;001;001;161;02;442;251;191
022;001;001;161;03;440;258;182
022;001;001;161;04;440;234;206
022;001;001;161;05;440;230;210
022;001;001;162;01;432;226;206
022;001;001;162;02;432;224;208
022;001;001;162;03;432;233;199
022;001;001;162;04;432;246;186
022;001;001;162;05;432;226;206
022;001;001;162;06;429;224;205
022;001;001;162;07;424;219;205
022;001;001;162;08;424;221;203
022;001;001;163;01;318;146;172
022;001;001;163;02;312;169;143
022;001;001;163;03;312;152;160
022;001;001;164;01;432;214;218
022;001;001;164;02;432;212;220
022;001;001;164;03;432;236;196
022;001;001;164;04;432;236;196
022;001;001;164;05;432;216;216
022;001;001;164;06;432;223;209
022;001;001;164;07;429;241;188
022;001;001;164;08;424;239;185
022;001;001;165;01;448;212;236
022;001;001;165;02;448;224;224
022;001;001;165;03;443;215;228
022;001;001;165;04;440;223;217
022;001;001;166;01;400;226;174
022;001;001;166;02;400;247;153
022;001;001;166;03;398;240;158
022;001;001;166;04;392;225;167
022;001;001;167;01;246;116;130
022;001;001;167;02;240;121;119
022;001;001;168;01;260;143;117
022;001;001;168;02;256;145;111
022;001;001;169;01;306;156;150
022;001;001;170;01;156;103;53
022;001;001;171;01;304;159;145
022;001;001;172;01;279;143;136
022;001;001;173;01;352;200;152
022;001;001;173;02;352;193;159
022;001;001;173;03;347;224;123
022;001;001;173;04;344;195;149
022;001;001;174;01;432;215;217
022;001;001;174;02;428;228;200
022;001;001;174;03;424;207;217
022;001;001;175;01;396;203;193
022;001;001;175;02;392;214;178
022;001;001;176;01;317;170;147
022;001;001;176;02;312;155;157
022;001;001;176;03;312;172;140
022;001;001;177;01;278;142;136
022;001;001;177;02;272;140;132
022;001;001;178;01;288;137;151
022;001;001;178;02;287;143;144
022;001;001;179;01;300;138;162
022;001;001;180;01;303;147;156
022;001;001;180;02;296;142;154
022;001;001;181;01;433;195;238
022;001;002;001;01;400;185;215
022;001;002;001;02;400;225;175
022;001;002;001;03;400;204;196
022;001;002;001;04;400;193;207
022;001;002;001;05;400;202;198
022;001;002;001;06;399;203;196
022;001;002;002;01;400;209;191
022;001;002;002;02;400;216;184
022;001;002;002;03;400;198;202
022;001;002;002;04;393;218;175
022;001;002;002;05;392;200;192
022;001;002;002;06;392;206;186
022;001;002;002;07;392;207;185
022;001;002;002;08;392;208;184
022;001;002;003;01;424;247;177
022;001;002;003;02;424;237;187
022;001;002;003;03;421;239;182
022;001;002;003;04;416;230;186
022;001;002;003;05;416;249;167
022;001;002;004;01;432;237;195
022;001;002;004;02;432;239;193
022;001;002;004;03;432;281;151
022;001;002;004;04;432;216;216
022;001;002;004;05;432;247;185
022;001;002;004;06;432;237;195
022;001;002;004;07;428;252;176
022;001;002;004;08;424;236;188
022;001;002;005;01;368;192;176
022;001;002;005;02;368;174;194
022;001;002;005;03;366;167;199
022;001;002;005;04;360;183;177
022;001;002;006;01;384;200;184
022;001;002;006;02;384;204;180
022;001;002;006;03;376;179;197
022;001;002;006;04;376;183;193
022;001;002;006;05;376;201;175
022;001;002;007;01;400;192;208
022;001;002;007;02;400;204;196
022;001;002;007;03;400;198;202
022;001;002;007;04;400;197;203
022;001;002;007;05;395;201;194
022;001;002;008;01;432;206;226
022;001;002;008;02;429;209;220
022;001;002;008;03;424;221;203
022;001;002;008;04;424;207;217
022;001;002;008;05;424;196;228
022;001;002;008;06;424;221;203
022;001;002;008;07;424;217;207
022;001;002;008;08;424;245;179
022;001;002;009;01;424;214;210
022;001;002;009;02;424;216;208
022;001;002;009;03;424;228;196
022;001;002;009;04;417;211;206
022;001;002;009;05;416;223;193
022;001;002;009;06;416;224;192
022;001;002;009;07;416;226;190
022;001;002;010;01;440;233;207
022;001;002;010;02;439;252;187
022;001;002;010;03;432;233;199
022;001;002;010;04;432;243;189
022;001;002;010;05;432;224;208
022;001;002;010;06;432;226;206
022;001;002;011;01;424;241;183
022;001;002;011;02;424;221;203
022;001;002;011;03;418;197;221
022;001;002;011;04;416;216;200
022;001;002;011;05;416;233;183
022;001;002;012;01;376;195;181
022;001;002;012;02;376;186;190
022;001;002;012;03;372;193;179
022;001;002;012;04;368;171;197
022;001;002;012;05;368;197;171
022;001;002;013;01;448;245;203
022;001;002;013;02;440;227;213
022;001;002;013;03;440;248;192
022;001;002;013;04;440;251;189
022;001;002;013;05;440;237;203
022;001;002;014;01;360;197;163
022;001;002;014;02;357;177;180
022;001;002;014;03;352;205;147
022;001;002;015;01;448;253;195
022;001;002;015;02;448;261;187
022;001;002;015;03;448;246;202
022;001;002;015;04;440;296;144
022;001;002;016;01;384;177;207
022;001;002;016;02;384;190;194
022;001;002;016;03;384;165;219
022;001;002;016;04;384;188;196
022;001;002;016;05;384;178;206
022;001;002;017;01;400;233;167
022;001;002;017;02;400;213;187
022;001;002;017;03;400;182;218
022;001;002;017;04;400;191;209
022;001;002;017;05;400;215;185
022;001;002;017;06;398;222;176
022;001;002;018;01;440;181;259
022;001;002;018;02;440;187;253
022;001;002;018;03;436;192;244
022;001;002;018;04;432;215;217
022;001;002;018;05;432;172;260
022;001;002;019;01;440;233;207
022;001;002;019;02;440;239;201
022;001;002;019;03;440;220;220
022;001;002;019;04;440;229;211
022;001;002;019;05;438;232;206
022;001;002;020;01;440;264;176
022;001;002;020;02;440;284;156
022;001;002;020;03;440;235;205
022;001;002;020;04;433;234;199
022;001;002;020;05;432;222;210
022;001;002;020;06;432;265;167
022;001;002;020;07;432;245;187
022;001;002;021;01;440;264;176
022;001;002;021;02;440;269;171
022;001;002;021;03;436;260;176
022;001;002;021;04;432;257;175
022;001;002;021;05;432;238;194
022;001;002;022;01;400;224;176
022;001;002;022;02;400;216;184
022;001;002;022;03;400;195;205
022;001;002;022;04;393;200;193
022;001;002;022;05;392;199;193
022;001;002;022;06;392;217;175
022;001;002;022;07;392;200;192
022;001;002;023;01;448;245;203
022;001;002;023;02;448;264;184
022;001;002;023;03;448;244;204
022;001;002;023;04;448;238;210
022;001;002;023;05;445;246;199
022;001;002;024;01;441;280;161
022;001;002;024;02;440;264;176
022;001;002;024;03;440;242;198
022;001;002;024;04;440;254;186
022;001;002;024;05;440;260;180
022;001;002;025;01;448;264;184
022;001;002;025;02;448;270;178
022;001;002;025;03;440;256;184
022;001;002;025;04;440;255;185
022;001;002;025;05;440;296;144
022;001;002;026;01;408;208;200
022;001;002;026;02;408;232;176
022;001;002;026;03;408;201;207
022;001;002;026;04;401;201;200
022;001;002;026;05;400;212;188
022;001;002;026;06;400;231;169
022;001;002;026;07;400;218;182
022;001;002;027;01;416;208;208
022;001;002;027;02;416;215;201
022;001;002;027;03;416;215;201
022;001;002;027;04;416;221;195
022;001;002;027;05;411;213;198
022;001;002;028;01;448;218;230
022;001;002;028;02;448;236;212
022;001;002;028;03;448;264;184
022;001;002;028;04;448;218;230
022;001;002;028;05;448;226;222
022;001;002;028;06;448;219;229
022;001;002;028;07;448;215;233
022;001;002;028;08;448;238;210
022;001;002;028;09;446;209;237
022;001;002;028;10;440;228;212
022;001;002;028;11;440;247;193
022;001;002;028;12;440;234;206
022;001;002;029;01;432;209;223
022;001;002;029;02;432;231;201
022;001;002;029;03;432;222;210
022;001;002;029;04;431;229;202
022;001;002;030;01;384;186;198
022;001;002;030;02;381;208;173
022;001;002;030;03;376;175;201
022;001;002;030;04;376;183;193
022;001;002;030;05;376;174;202
022;001;002;030;06;376;187;189
022;001;002;031;01;423;230;193
022;001;002;031;02;416;237;179
022;001;002;031;03;416;211;205
022;001;002;031;04;416;207;209
022;001;002;031;05;416;226;190
022;001;002;031;06;416;202;214
022;001;002;031;07;416;238;178
022;001;002;031;08;416;220;196
022;001;002;032;01;432;229;203
022;001;002;032;02;432;213;219
022;001;002;032;03;432;221;211
022;001;002;032;04;432;219;213
022;001;002;032;05;432;213;219
022;001;002;032;06;432;205;227
022;001;002;032;07;432;206;226
022;001;002;032;08;432;220;212
022;001;002;032;09;432;224;208
022;001;002;032;10;425;206;219
022;001;002;033;01;384;200;184
022;001;002;033;02;382;185;197
022;001;002;033;03;376;176;200
022;001;002;033;04;376;187;189
022;001;002;033;05;376;183;193
022;001;002;033;06;376;199;177
022;001;002;034;01;432;234;198
022;001;002;034;02;432;217;215
022;001;002;034;03;432;208;224
022;001;002;034;04;432;238;194
022;001;002;034;05;432;202;230
022;001;002;034;06;432;206;226
022;001;002;034;07;432;189;243
022;001;002;034;08;432;226;206
022;001;002;034;09;428;226;202
022;001;002;034;10;424;220;204
022;001;002;035;01;416;202;214
022;001;002;035;02;416;238;178
022;001;002;035;03;416;199;217
022;001;002;035;04;416;215;201
022;001;002;035;05;416;213;203
022;001;002;035;06;416;219;197
022;001;002;035;07;415;198;217
022;001;002;036;01;448;233;215
022;001;002;036;02;448;247;201
022;001;002;036;03;448;243;205
022;001;002;036;04;448;244;204
022;001;002;036;05;448;247;201
022;001;002;036;06;448;252;196
022;001;002;036;07;446;235;211
022;001;002;036;08;440;214;226
022;001;002;036;09;440;232;208
022;001;002;036;10;440;242;198
022;001;002;036;11;440;234;206
022;001;002;036;12;440;256;184
022;001;002;037;01;424;214;210
022;001;002;037;02;424;238;186
022;001;002;037;03;424;222;202
022;001;002;037;04;417;216;201
022;001;002;037;05;416;224;192
022;001;002;037;06;416;223;193
022;001;002;037;07;416;206;210
022;001;002;038;01;392;212;180
022;001;002;038;02;392;242;150
022;001;002;038;03;385;202;183
022;001;002;038;04;384;200;184
022;001;002;038;05;384;217;167
022;001;002;038;06;384;215;169
022;001;002;039;01;448;277;171
022;001;002;039;02;446;291;155
022;001;002;039;03;440;327;113
022;001;002;039;04;440;288;152
022;001;002;039;05;440;294;146
022;001;002;040;01;424;215;209
022;001;002;040;02;424;232;192
022;001;002;040;03;424;224;200
022;001;002;040;04;424;228;196
022;001;002;040;05;416;212;204
022;001;002;040;06;416;233;183
022;001;002;040;07;416;253;163
022;001;002;041;01;416;237;179
022;001;002;041;02;416;231;185
022;001;002;041;03;410;218;192
022;001;002;041;04;408;231;177
022;001;002;041;05;408;245;163
022;001;002;041;06;408;206;202
022;001;002;041;07;408;246;162
022;001;002;041;08;408;232;176
022;001;002;042;01;432;201;231
022;001;002;042;02;432;238;194
022;001;002;042;03;432;239;193
022;001;002;042;04;432;233;199
022;001;002;042;05;432;244;188
022;001;002;042;06;427;245;182
022;001;002;042;07;424;238;186
022;001;002;042;08;424;244;180
022;001;002;042;09;424;229;195
022;001;002;042;10;424;247;177
022;001;002;043;01;440;232;208
022;001;002;043;02;440;226;214
022;001;002;043;03;440;257;183
022;001;002;043;04;440;223;217
022;001;002;043;05;440;220;220
022;001;002;043;06;432;217;215
022;001;002;044;01;440;228;212
022;001;002;044;02;440;218;222
022;001;002;044;03;440;251;189
022;001;002;044;04;440;225;215
022;001;002;044;05;435;228;207
022;001;002;044;06;432;235;197
022;001;002;044;07;432;234;198
022;001;002;045;01;416;203;213
022;001;002;045;02;416;204;212
022;001;003;001;01;432;205;227
022;001;003;001;02;432;202;230
022;001;003;001;03;426;204;222
022;001;003;001;04;424;175;249
022;001;003;001;05;424;202;222
022;001;003;001;06;424;223;201
022;001;003;001;07;424;209;215
022;001;003;002;01;408;200;208
022;001;003;002;02;408;192;216
022;001;003;002;03;408;207;201
022;001;003;002;04;408;203;205
022;001;003;002;05;408;189;219
022;001;003;002;06;408;185;223
022;001;003;002;07;407;195;212
022;001;003;003;01;416;194;222
022;001;003;003;02;416;207;209
022;001;003;003;03;416;209;207
022;001;003;003;04;416;178;238
022;001;003;003;05;409;211;198
022;001;003;003;06;408;203;205
022;001;003;004;01;409;190;219
022;001;003;004;02;408;230;178
022;001;003;004;03;408;208;200
022;001;003;004;04;408;201;207
022;001;003;004;05;408;204;204
022;001;003;004;06;408;202;206
022;001;003;005;01;408;212;196
022;001;003;005;02;408;196;212
022;001;003;005;03;408;189;219
022;001;003;005;04;401;203;198
022;001;003;006;01;384;183;201
022;001;003;006;02;384;180;204
022;001;003;006;03;383;186;197
022;001;003;006;04;376;198;178
022;001;003;006;05;376;176;200
022;001;003;006;06;376;206;170
022;001;003;007;01;416;205;211
022;001;003;007;02;411;204;207
022;001;003;007;03;408;212;196
022;001;003;007;04;408;206;202
022;001;003;007;05;408;203;205
022;001;003;008;01;424;247;177
022;001;003;008;02;424;246;178
022;001;003;008;03;424;242;182
022;001;003;008;04;424;228;196
022;001;003;008;05;422;226;196
022;001;003;008;06;416;245;171
022;001;003;008;07;416;231;185
022;001;003;009;01;400;189;211
022;001;003;009;02;400;205;195
022;001;003;009;03;400;201;199
022;001;003;009;04;397;198;199
022;001;003;010;01;442;211;231
022;001;003;010;02;440;227;213
022;001;003;010;03;440;211;229
022;001;003;010;04;440;206;234
022;001;003;010;05;440;211;229
022;001;003;011;01;440;211;229
022;001;003;011;02;440;212;228
022;001;003;011;03;439;218;221
022;001;003;011;04;432;216;216
022;001;003;012;01;439;223;216
022;001;003;012;02;432;215;217
022;001;003;012;03;432;220;212
022;001;003;012;04;432;198;234
022;001;003;012;05;432;229;203
022;001;003;013;01;416;190;226
022;001;003;013;02;416;206;210
022;001;003;013;03;416;202;214
022;001;003;013;04;416;226;190
022;001;003;013;05;415;210;205
022;001;003;013;06;408;199;209
022;001;003;014;01;384;162;222
022;001;003;014;02;384;177;207
022;001;003;014;03;384;175;209
022;001;003;014;04;376;153;223
022;001;003;014;05;376;146;230
022;001;003;014;06;376;174;202
022;001;003;015;01;400;230;170
022;001;003;015;02;397;213;184
022;001;003;015;03;392;187;205
022;001;003;015;04;392;197;195
022;001;003;015;05;392;192;200
022;001;003;016;01;432;241;191
022;001;003;016;02;432;212;220
022;001;003;016;03;427;210;217
022;001;003;016;04;424;211;213
022;001;003;016;05;424;185;239
022;001;003;016;06;424;222;202
022;001;003;016;07;424;230;194
022;001;003;016;08;424;233;191
022;001;003;017;01;416;213;203
022;001;003;017;02;416;201;215
022;001;003;017;03;410;225;185
022;001;003;017;04;408;199;209
022;001;003;017;05;408;208;200
022;001;003;017;06;408;213;195
022;001;003;017;07;408;180;228
022;001;003;017;08;408;200;208
022;001;003;017;09;408;216;192
022;001;003;017;10;408;215;193
022;001;003;017;11;408;208;200
022;001;003;018;01;446;235;211
022;001;003;018;02;440;238;202
022;001;003;018;03;440;200;240
022;001;003;018;04;440;219;221
022;001;003;018;05;440;227;213
022;001;003;018;06;440;219;221
022;001;003;019;01;432;225;207
022;001;003;019;02;432;222;210
022;001;003;019;03;432;229;203
022;001;003;019;04;432;223;209
022;001;003;019;05;432;216;216
022;001;003;019;06;432;224;208
022;001;003;019;07;429;231;198
022;001;003;019;08;424;230;194
022;001;003;020;01;392;189;203
022;001;003;020;02;392;199;193
022;001;003;020;03;392;168;224
022;001;003;020;04;385;196;189
022;001;003;020;05;384;182;202
022;001;003;021;01;416;208;208
022;001;003;021;02;416;233;183
022;001;003;021;03;416;236;180
022;001;003;021;04;416;213;203
022;001;003;021;05;416;232;184
022;001;003;021;06;416;229;187
022;001;003;021;07;416;225;191
022;001;003;021;08;412;245;167
022;001;003;021;09;408;207;201
022;001;003;022;01;412;213;199
022;001;003;022;02;408;217;191
022;001;003;023;01;432;211;221
022;001;003;023;02;432;190;242
022;001;003;023;03;432;220;212
022;001;003;023;04;432;220;212
022;001;003;023;05;432;224;208
022;001;003;023;06;432;229;203
022;001;003;023;07;425;196;229
022;001;003;023;08;424;236;188
022;001;003;023;09;424;220;204
022;001;003;024;01;392;196;196
022;001;003;024;02;384;187;197
022;001;003;024;03;384;179;205
022;001;003;024;04;384;189;195
022;001;003;024;05;384;205;179
022;001;003;025;01;400;198;202
022;001;003;025;02;397;210;187
022;001;003;025;03;392;196;196
022;001;003;025;04;392;196;196
022;001;003;025;05;392;206;186
022;001;003;025;06;392;208;184
022;001;003;026;01;448;213;235
022;001;003;026;02;448;242;206
022;001;003;026;03;448;219;229
022;001;003;026;04;443;218;225
022;001;003;026;05;440;223;217
022;001;003;027;01;420;243;177
022;001;003;027;02;416;213;203
022;001;003;027;03;416;227;189
022;001;003;027;04;416;223;193
022;001;003;028;01;424;210;214
022;001;003;028;02;424;241;183
022;001;003;028;03;421;210;211
022;001;003;028;04;416;215;201
022;001;003;028;05;416;241;175
022;001;003;029;01;408;196;212
022;001;003;029;02;408;197;211
022;001;003;029;03;408;195;213
022;001;003;029;04;408;194;214
022;001;003;029;05;408;194;214
022;001;003;029;06;408;189;219
022;001;003;029;07;408;213;195
022;001;003;029;08;401;171;230
022;001;003;030;01;400;189;211
022;001;003;030;02;400;210;190
022;001;003;030;03;400;202;198
022;001;003;030;04;400;203;197
022;001;003;030;05;400;216;184
022;001;003;030;06;398;207;191
022;001;003;030;07;392;218;174
022;001;003;031;01;408;198;210
022;001;003;031;02;408;216;192
022;001;003;031;03;408;225;183
022;001;003;031;04;408;206;202
022;001;003;031;05;408;230;178
022;001;003;031;06;408;193;215
022;001;003;031;07;408;197;211
022;001;003;031;08;405;206;199
022;001;003;031;09;400;228;172
022;001;003;032;01;450;226;224
022;001;003;032;02;450;214;236
022;001;003;032;03;450;217;233
022;001;003;032;04;450;227;223
022;001;003;032;05;450;210;240
022;001;003;032;06;450;200;250
022;001;003;032;07;449;259;190
022;001;003;032;08;448;223;225
022;001;003;033;01;424;237;187
022;001;003;033;02;424;203;221
022;001;003;033;03;421;238;183
022;001;003;034;01;416;227;189
022;001;003;034;02;416;220;196
022;001;003;034;03;414;230;184
022;001;003;035;01;445;278;167
022;001;003;035;02;440;266;174
022;001;003;035;03;440;253;187
022;001;003;035;04;440;258;182
022;001;003;035;05;440;262;178
022;001;003;035;06;440;250;190
022;001;003;035;07;440;257;183
022;001;003;036;01;416;217;199
022;001;003;036;02;416;213;203
022;001;003;036;03;416;227;189
022;001;003;036;04;416;235;181
022;001;003;036;05;416;198;218
022;001;003;036;06;412;227;185
022;001;003;036;07;408;215;193
022;001;003;037;01;384;209;175
022;001;003;037;02;377;188;189
022;001;003;037;03;376;182;194
022;001;003;037;04;376;184;192
022;001;003;037;05;376;207;169
022;001;003;038;01;416;205;211
022;001;003;038;02;416;227;189
022;001;003;038;03;416;215;201
022;001;003;038;04;411;200;211
022;001;003;038;05;408;235;173
022;001;003;040;01;380;208;172
022;001;003;040;02;376;187;189
022;001;003;040;03;376;178;198
022;001;003;040;04;376;171;205
022;001;003;040;05;376;194;182
022;001;003;040;06;376;193;183
022;001;003;041;01;450;209;241
022;001;003;041;02;450;220;230
022;001;003;041;03;450;237;213
022;001;003;041;04;448;214;234
022;001;003;041;05;448;231;217
022;001;003;041;06;448;219;229
022;001;003;042;01;368;188;180
022;001;003;042;02;368;202;166
022;001;003;042;03;368;203;165
022;001;003;042;04;365;179;186
022;001;003;042;05;360;182;178
022;001;003;043;01;436;241;195
022;001;003;043;02;432;257;175
022;001;003;043;03;432;255;177
022;001;003;043;04;432;226;206
022;001;003;043;05;432;249;183
022;001;004;001;01;416;227;189
022;001;004;001;02;416;237;179
022;001;004;001;03;416;224;192
022;001;004;001;04;416;240;176
022;001;004;001;05;415;228;187
022;001;004;001;06;408;232;176
022;001;004;001;07;408;231;177
022;001;004;001;08;408;239;169
022;001;004;001;09;408;220;188
022;001;004;002;01;368;206;162
022;001;004;002;02;368;202;166
022;001;004;002;03;368;161;207
022;001;004;002;04;368;182;186
022;001;004;002;05;366;191;175
022;001;004;003;01;416;307;109
022;001;004;003;02;416;300;116
022;001;004;003;03;416;306;110
022;001;004;003;04;416;298;118
022;001;004;003;05;411;280;131
022;001;004;003;06;408;315;93
022;001;004;003;07;408;290;118
022;001;004;004;01;376;250;126
022;001;004;004;02;370;272;98
022;001;004;004;03;368;253;115
022;001;004;004;04;368;257;111
022;001;004;004;05;368;244;124
022;001;004;005;01;425;221;204
022;001;004;005;02;424;225;199
022;001;004;005;03;424;231;193
022;001;004;005;04;424;213;211
022;001;004;005;05;424;192;232
022;001;004;005;06;424;209;215
022;001;004;005;07;424;201;223
022;001;004;005;08;424;227;197
022;001;004;005;09;424;223;201
022;001;004;006;01;448;217;231
022;001;004;006;02;448;221;227
022;001;004;006;03;448;221;227
022;001;004;006;04;448;215;233
022;001;004;006;05;448;208;240
022;001;004;006;06;448;242;206
022;001;004;006;07;444;224;220
022;001;004;007;01;365;170;195
022;001;004;007;02;360;197;163
022;001;004;007;03;360;187;173
022;001;004;007;04;360;189;171
022;001;004;008;01;424;185;239
022;001;004;008;02;424;198;226
022;001;004;008;03;424;183;241
022;001;004;008;04;424;214;210
022;001;004;008;05;424;212;212
022;001;004;008;06;424;214;210
022;001;004;008;07;424;210;214
022;001;004;008;08;424;189;235
022;001;004;008;09;424;196;228
022;001;004;008;10;424;226;198
022;001;004;008;11;424;210;214
022;001;004;008;12;424;211;213
022;001;004;008;13;424;218;206
022;001;004;008;14;424;213;211
022;001;004;008;15;424;224;200
022;001;004;008;16;424;211;213
022;001;004;008;17;424;218;206
022;001;004;009;01;448;202;246
022;001;004;009;02;448;199;249
022;001;004;009;03;448;206;242
022;001;004;009;04;448;203;245
022;001;004;009;05;448;231;217
022;001;004;009;06;448;212;236
022;001;004;009;07;448;187;261
022;001;004;009;08;442;219;223
022;001;004;009;09;440;212;228
022;001;004;009;10;440;224;216
022;001;004;009;11;440;243;197
022;001;004;009;12;440;222;218
022;001;004;010;01;376;186;190
022;001;004;010;02;376;186;190
022;001;004;010;03;376;197;179
022;001;004;010;04;376;205;171
022;001;004;010;05;376;194;182
022;001;004;010;06;372;207;165
022;001;004;011;01;440;252;188
022;001;004;011;02;440;253;187
022;001;004;011;03;440;256;184
022;001;004;011;04;435;256;179
022;001;004;011;05;432;252;180
022;001;004;011;06;432;278;154
022;001;004;012;01;416;196;220
022;001;004;012;02;416;203;213
022;001;004;012;03;416;206;210
022;001;004;012;04;416;224;192
022;001;004;012;05;412;197;215
022;001;004;012;06;408;154;254
022;001;004;012;07;408;220;188
022;001;004;012;08;408;221;187
022;001;004;012;09;408;228;180
022;001;004;012;10;408;212;196
022;001;004;013;01;448;210;238
022;001;004;013;02;448;184;264
022;001;004;013;03;440;207;233
022;001;004;013;04;440;219;221
022;001;004;013;05;440;192;248
022;001;004;013;06;440;188;252
022;001;004;013;07;440;195;245
022;001;004;013;08;440;206;234
022;001;004;013;09;440;207;233
022;001;004;014;01;434;216;218
022;001;004;014;02;432;202;230
022;001;004;014;03;432;199;233
022;001;004;014;04;432;196;236
022;001;004;014;05;432;196;236
022;001;004;014;06;432;190;242
022;001;004;014;07;432;185;247
022;001;004;014;08;432;202;230
022;001;004;014;09;432;182;250
022;001;004;014;10;432;199;233
022;001;004;014;11;432;210;222
022;001;004;014;12;432;213;219
022;001;004;015;01;400;193;207
022;001;004;015;02;400;196;204
022;001;004;015;03;400;226;174
022;001;004;015;04;400;196;204
022;001;004;015;05;400;201;199
022;001;004;015;06;400;204;196
022;001;004;015;07;392;206;186
022;001;004;016;01;416;203;213
022;001;004;016;02;416;217;199
022;001;004;016;03;416;214;202
022;001;004;016;04;416;210;206
022;001;004;016;05;416;213;203
022;001;004;016;06;416;203;213
022;001;004;016;07;415;216;199
022;001;004;016;08;408;251;157
022;001;004;016;09;408;207;201
022;001;004;017;01;445;232;213
022;001;004;017;02;440;233;207
022;001;004;017;03;440;224;216
022;001;004;017;04;440;229;211
022;001;004;017;05;440;220;220
022;001;004;017;06;440;229;211
022;001;004;017;07;440;196;244
022;001;004;017;08;440;221;219
022;001;004;017;09;440;190;250
022;001;004;017;10;440;218;222
022;001;004;017;11;440;214;226
022;001;004;017;12;440;213;227
022;001;004;017;13;440;223;217
022;001;004;018;01;424;184;240
022;001;004;018;02;416;201;215
022;001;004;018;03;416;198;218
022;001;004;018;04;416;193;223
022;001;004;018;05;416;208;208
022;001;004;018;06;416;178;238
022;001;004;018;07;416;223;193
022;001;004;018;08;416;207;209
022;001;004;019;01;432;206;226
022;001;004;019;02;424;209;215
022;001;004;019;03;424;197;227
022;001;004;019;04;424;199;225
022;001;004;019;05;424;194;230
022;001;004;019;06;424;179;245
022;001;004;019;07;424;216;208
022;001;004;019;08;424;193;231
022;001;004;019;09;424;209;215
022;001;004;019;10;424;204;220
022;001;004;020;01;424;184;240
022;001;004;020;02;424;220;204
022;001;004;020;03;424;209;215
022;001;004;020;04;419;216;203
022;001;004;020;05;416;204;212
022;001;004;020;06;416;197;219
022;001;004;020;07;416;197;219
022;001;004;020;08;416;196;220
022;001;004;020;09;416;242;174
022;001;004;020;10;416;207;209
022;001;004;021;01;440;198;242
022;001;004;021;02;438;213;225
022;001;004;021;03;432;226;206
022;001;004;021;04;432;186;246
022;001;004;021;05;432;200;232
022;001;004;021;06;432;206;226
022;001;004;021;07;432;223;209
022;001;004;022;01;440;207;233
022;001;004;022;02;440;186;254
022;001;004;022;03;440;213;227
022;001;004;022;04;440;213;227
022;001;004;022;05;440;216;224
022;001;004;022;06;440;177;263
022;001;004;022;07;440;193;247
022;001;004;022;08;440;212;228
022;001;004;022;09;436;195;241
022;001;004;022;10;432;206;226
022;001;004;022;11;432;235;197
022;001;004;022;12;432;210;222
022;001;004;023;01;416;195;221
022;001;004;023;02;416;192;224
022;001;004;023;03;411;224;187
022;001;004;023;04;408;218;190
022;001;004;023;05;408;199;209
022;001;004;023;06;408;195;213
022;001;004;023;07;408;201;207
022;001;004;023;08;408;207;201
022;001;004;023;09;408;216;192
022;001;004;024;01;392;201;191
022;001;004;024;02;388;195;193
022;001;004;024;03;384;185;199
022;001;004;024;04;384;188;196
022;001;004;024;05;384;196;188
022;001;004;024;06;384;205;179
022;001;004;025;01;392;190;202
022;001;004;025;02;392;188;204
022;001;004;025;03;384;193;191
022;001;004;025;04;384;178;206
022;001;004;025;05;384;202;182
022;001;004;026;01;424;189;235
022;001;004;026;02;424;206;218
022;001;004;026;03;424;206;218
022;001;004;026;04;424;190;234
022;001;004;026;05;424;206;218
022;001;004;026;06;424;173;251
022;001;004;026;07;419;202;217
022;001;004;027;01;424;231;193
022;001;004;027;02;424;230;194
022;001;004;027;03;424;232;192
022;001;004;027;04;416;256;160
022;001;004;027;05;416;226;190
022;001;004;027;06;416;238;178
022;001;004;027;07;416;255;161
022;001;004;027;08;416;237;179
022;001;004;027;09;416;220;196
022;001;004;027;10;416;243;173
022;001;004;027;11;416;233;183
022;001;004;028;01;450;235;215
022;001;004;028;02;450;234;216
022;001;004;028;03;450;215;235
022;001;004;028;04;450;246;204
022;001;004;028;05;450;229;221
022;001;004;028;06;450;232;218
022;001;004;028;07;450;237;213
022;001;004;028;08;450;216;234
022;001;004;028;09;449;221;228
022;001;004;028;10;448;183;265
022;001;004;028;11;448;246;202
022;001;004;028;12;448;221;227
022;001;004;028;13;448;235;213
022;001;004;028;14;448;223;225
022;001;004;028;15;448;241;207
022;001;004;028;16;448;220;228
022;001;004;029;01;432;221;211
022;001;004;029;02;432;234;198
022;001;004;029;03;432;214;218
022;001;004;029;04;432;236;196
022;001;004;029;05;425;204;221
022;001;004;029;06;424;226;198
022;001;004;029;07;424;242;182
022;001;004;029;08;424;208;216
022;001;004;029;09;424;229;195
022;001;004;029;10;424;233;191
022;001;004;030;01;416;204;212
022;001;004;030;02;416;206;210
022;001;004;030;03;416;208;208
022;001;004;030;04;416;199;217
022;001;004;030;05;416;203;213
022;001;004;030;06;416;205;211
022;001;004;030;07;408;193;215
022;001;004;030;08;408;227;181
022;001;004;030;09;408;196;212
022;001;004;030;10;408;201;207
022;001;004;030;11;408;210;198
022;001;004;031;01;432;225;207
022;001;004;031;02;432;205;227
022;001;004;031;03;432;232;200
022;001;004;031;04;432;211;221
022;001;004;031;05;432;234;198
022;001;004;031;06;432;192;240
022;001;004;031;07;432;202;230
022;001;004;031;08;432;227;205
022;001;004;031;09;425;232;193
022;001;004;031;10;424;208;216
022;001;004;031;11;424;218;206
022;001;004;031;12;424;215;209
022;001;004;033;01;450;241;209
022;001;004;033;02;450;222;228
022;001;004;033;03;450;205;245
022;001;004;033;04;450;225;225
022;001;004;033;05;450;238;212
022;001;004;033;06;450;230;220
022;001;004;033;07;449;208;241
022;001;004;033;08;448;225;223
022;001;004;033;09;448;206;242
022;001;004;033;10;448;215;233
022;001;004;033;11;448;190;258
022;001;004;033;12;448;221;227
022;001;004;033;13;448;209;239
022;001;004;033;14;448;207;241
022;001;004;033;15;448;216;232
022;001;004;033;16;448;228;220
022;001;004;033;17;448;227;221
022;001;004;033;18;448;230;218
022;001;004;034;01;448;182;266
022;001;004;034;02;448;207;241
022;001;004;034;03;448;197;251
022;001;004;034;04;448;175;273
022;001;004;034;05;448;198;250
022;001;004;034;06;446;200;246
022;001;004;034;07;440;200;240
022;001;004;035;01;450;234;216
022;001;004;035;02;450;222;228
022;001;004;035;03;450;223;227
022;001;004;035;04;450;259;191
022;001;004;035;05;450;193;257
022;001;004;035;06;450;222;228
022;001;004;035;07;450;206;244
022;001;004;035;08;449;233;216
022;001;004;035;09;448;227;221
022;001;004;036;01;440;213;227
022;001;004;036;02;440;211;229
022;001;004;036;03;432;192;240
022;001;004;036;04;432;184;248
022;001;004;036;05;432;180;252
022;001;004;036;06;432;193;239
022;001;004;036;07;432;185;247
022;001;004;036;08;432;187;245
022;001;004;037;01;450;217;233
022;001;004;037;02;450;231;219
022;001;004;037;03;449;222;227
022;001;004;037;04;448;215;233
022;001;004;037;05;448;223;225
022;001;004;037;06;448;191;257
022;001;004;037;07;448;220;228
022;001;004;037;08;448;222;226
022;001;004;037;09;448;238;210
022;001;004;037;10;448;204;244
022;001;004;038;01;402;156;246
022;001;004;038;02;400;158;242
022;001;004;038;03;400;170;230
022;001;004;038;04;400;125;275
022;001;004;038;05;400;133;267
022;001;004;038;06;400;143;257
022;001;004;038;07;400;153;247
022;001;004;039;01;416;189;227
022;001;004;039;02;416;209;207
022;001;004;039;03;416;197;219
022;001;004;039;04;416;205;211
022;001;004;039;05;416;195;221
022;001;004;039;06;416;197;219
022;001;004;039;07;416;176;240
022;001;004;039;08;415;210;205
022;001;004;039;09;408;219;189
022;001;004;039;10;408;207;201
022;001;004;040;01;400;199;201
022;001;004;040;02;400;207;193
022;001;004;040;03;393;197;196
022;001;004;040;04;392;196;196
022;001;004;040;05;392;182;210
022;001;004;040;06;392;179;213
022;001;004;040;07;392;209;183
022;001;004;041;01;398;194;204
022;001;004;041;02;392;199;193
022;001;004;041;03;392;200;192
022;001;004;041;04;392;166;226
022;001;004;041;05;392;178;214
022;001;004;041;06;392;193;199
022;001;004;041;07;392;205;187
022;001;004;042;01;440;265;175
022;001;004;042;02;440;283;157
022;001;004;042;03;440;269;171
022;001;004;042;04;440;326;114
022;001;004;042;05;437;283;154
022;001;004;042;06;432;286;146
022;001;004;042;07;432;298;134
022;001;004;043;01;424;244;180
022;001;004;043;02;424;250;174
022;001;004;043;03;424;258;166
022;001;004;043;04;424;289;135
022;001;004;043;05;422;259;163
022;001;004;043;06;416;263;153
022;001;004;043;07;416;271;145
022;001;004;044;01;400;217;183
022;001;004;044;02;400;240;160
022;001;004;044;03;400;237;163
022;001;004;044;04;400;252;148
022;001;004;044;05;392;240;152
022;001;004;044;06;392;227;165
022;001;004;044;07;392;237;155
022;001;004;045;01;440;251;189
022;001;004;045;02;440;263;177
022;001;004;045;03;440;260;180
022;001;004;045;04;439;248;191
022;001;004;045;05;432;209;223
022;001;004;045;06;432;239;193
022;001;004;045;07;432;280;152
022;001;004;045;08;432;259;173
022;001;004;046;01;440;209;231
022;001;004;046;02;432;193;239
022;001;004;046;03;432;208;224
022;001;004;046;04;432;220;212
022;001;004;046;05;432;195;237
022;001;004;046;06;432;181;251
022;001;004;046;07;432;213;219
022;001;004;047;01;431;206;225
022;001;004;047;02;424;229;195
022;001;004;047;03;424;212;212
022;001;004;047;04;424;199;225
022;001;004;047;05;424;190;234
022;001;004;048;01;440;287;153
022;001;004;048;02;440;272;168
022;001;004;048;03;440;296;144
022;001;004;048;04;440;272;168
022;001;004;048;05;440;285;155
022;001;004;048;06;434;269;165
022;001;004;048;07;432;284;148
022;001;004;049;01;408;209;199
022;001;004;049;02;408;202;206
022;001;004;049;03;408;214;194
022;001;004;049;04;408;220;188
022;001;004;049;05;408;211;197
022;001;004;049;06;408;214;194
022;001;004;049;07;408;214;194
022;001;004;049;08;408;214;194
022;001;004;049;09;404;209;195
022;001;004;050;01;383;173;210
022;001;004;050;02;376;181;195
022;001;004;050;03;376;174;202
022;001;004;050;04;376;184;192
022;001;004;050;05;376;180;196
022;001;004;051;01;408;204;204
022;001;004;051;02;408;202;206
022;001;004;051;03;408;197;211
022;001;004;051;04;401;200;201
022;001;004;051;05;400;223;177
022;001;004;052;01;448;221;227
022;001;004;052;02;445;217;228
022;001;004;052;03;440;222;218
022;001;004;052;04;440;204;236
022;001;004;052;05;440;229;211
022;001;004;052;06;440;187;253
022;001;004;052;07;440;214;226
022;001;004;052;08;440;199;241
022;001;004;053;01;445;197;248
022;001;004;053;02;440;215;225
022;001;004;053;03;440;212;228
022;001;004;053;04;440;194;246
022;001;004;053;05;440;190;250
022;001;004;053;06;440;213;227
022;001;004;054;01;416;242;174
022;001;004;054;02;411;238;173
022;001;004;054;03;408;257;151
022;001;004;054;04;408;230;178
022;001;004;054;05;408;254;154
022;001;004;054;06;408;232;176
022;001;004;055;01;432;206;226
022;001;004;055;02;432;208;224
022;001;004;055;03;424;212;212
022;001;004;055;04;424;195;229
022;001;004;055;05;424;192;232
022;001;004;055;06;424;202;222
022;001;004;056;01;448;227;221
022;001;004;056;02;444;239;205
022;001;004;056;03;440;227;213
022;001;004;056;04;440;218;222
022;001;004;056;05;440;220;220
022;001;004;057;01;432;233;199
022;001;004;057;02;431;238;193
022;001;004;058;01;314;174;140
022;001;004;058;02;312;180;132
022;001;004;059;01;424;202;222
022;001;004;059;02;424;196;228
022;001;004;059;03;424;223;201
022;001;004;059;04;419;218;201
022;001;004;059;05;416;191;225
022;001;004;059;06;416;220;196
022;001;004;059;07;416;226;190
022;001;004;059;08;416;208;208
022;001;004;059;09;416;213;203
022;001;004;059;10;416;203;213
022;001;004;059;11;416;209;207
022;001;004;060;01;400;225;175
022;001;004;060;02;400;255;145
022;001;004;060;03;400;243;157
022;001;004;060;04;396;236;160
022;001;004;060;05;392;225;167
022;001;004;060;06;392;224;168
022;001;004;061;01;392;199;193
022;001;004;061;02;392;211;181
022;001;004;061;03;385;195;190
022;001;004;061;04;384;210;174
022;001;004;062;01;432;183;249
022;001;004;062;02;432;215;217
022;001;004;062;03;432;206;226
022;001;004;062;04;432;201;231
022;001;004;062;05;428;173;255
022;001;004;062;06;424;214;210
022;001;004;062;07;424;184;240
022;001;004;062;08;424;222;202
022;001;004;062;09;424;177;247
022;001;004;063;01;416;179;237
022;001;004;063;02;416;207;209
022;001;004;063;03;416;201;215
022;001;004;063;04;408;201;207
022;001;004;063;05;408;186;222
022;001;004;063;06;408;172;236
022;001;004;063;07;408;184;224
022;001;004;063;08;408;200;208
022;001;004;063;09;408;200;208
022;001;004;063;10;408;172;236
022;001;004;064;01;367;192;175
022;001;004;065;01;312;159;153
022;001;004;065;02;304;148;156
022;001;004;066;01;432;179;253
022;001;004;066;02;432;210;222
022;001;004;066;03;432;203;229
022;001;004;066;04;432;200;232
022;001;004;066;05;432;203;229
022;001;004;066;06;432;199;233
022;001;004;066;07;425;201;224
022;001;004;066;08;424;190;234
022;001;004;067;01;400;177;223
022;001;004;067;02;400;180;220
022;001;004;067;03;399;169;230
022;001;004;067;04;392;199;193
022;001;004;067;05;392;201;191
022;001;004;067;06;392;199;193
022;001;004;068;01;438;185;253
022;001;004;068;02;432;214;218
022;001;004;068;03;432;225;207
022;001;004;068;04;432;231;201
022;001;004;068;05;432;187;245
022;001;004;068;06;432;198;234
022;001;004;068;07;432;225;207
022;001;004;068;08;432;207;225
022;001;004;068;09;432;209;223
022;001;004;068;10;432;212;220
022;001;004;069;01;440;199;241
022;001;004;069;02;434;196;238
022;001;004;069;03;432;211;221
022;001;004;069;04;432;197;235
022;001;004;069;05;432;191;241
022;001;004;069;06;432;205;227
022;001;004;070;01;432;201;231
022;001;004;070;02;432;208;224
022;001;004;070;03;432;223;209
022;001;004;070;04;432;197;235
022;001;004;070;05;432;221;211
022;001;004;070;06;432;199;233
022;001;004;070;07;432;233;199
022;001;004;070;08;429;244;185
022;001;004;071;01;416;205;211
022;001;004;071;02;416;196;220
022;001;004;071;03;416;212;204
022;001;004;071;04;416;198;218
022;001;004;071;05;413;182;231
022;001;004;071;06;408;213;195
022;001;004;072;01;368;171;197
022;001;004;072;02;368;192;176
022;001;004;072;03;366;156;210
022;001;004;072;04;360;158;202
022;001;004;072;05;360;179;181
022;001;004;073;01;416;166;250
022;001;004;073;02;416;201;215
022;001;004;073;03;416;196;220
022;001;004;073;04;416;205;211
022;001;004;073;05;414;195;219
022;001;004;073;06;408;199;209
022;001;004;073;07;408;159;249
022;001;004;073;08;408;194;214
022;001;004;073;09;408;214;194
022;001;004;074;01;431;210;221
022;001;004;074;02;424;220;204
022;001;004;074;03;424;235;189
022;001;004;074;04;424;200;224
022;001;004;074;05;424;224;200
022;001;004;074;06;424;214;210
022;001;004;074;07;424;217;207
022;001;004;074;08;424;230;194
022;001;004;074;09;424;210;214
022;001;004;074;10;424;230;194
022;001;004;074;11;424;236;188
022;001;004;074;12;424;215;209
022;001;004;075;01;432;225;207
022;001;004;075;02;432;216;216
022;001;004;075;03;432;217;215
022;001;004;075;04;432;188;244
022;001;004;075;05;432;192;240
022;001;004;075;06;429;198;231
022;001;004;075;07;424;174;250
022;001;004;075;08;424;186;238
022;001;004;075;09;424;199;225
022;001;004;075;10;424;205;219
022;001;004;075;11;424;187;237
022;001;004;075;12;424;210;214
022;001;004;076;01;408;191;217
022;001;004;076;02;408;198;210
022;001;004;076;03;408;199;209
022;001;004;076;04;408;206;202
022;001;004;076;05;407;180;227
022;001;004;076;06;400;170;230
022;001;004;076;07;400;217;183
022;001;004;076;08;400;181;219
022;001;004;077;01;393;173;220
022;001;004;077;02;392;172;220
022;001;004;077;03;392;205;187
022;001;004;077;04;392;163;229
022;001;004;077;05;392;179;213
022;001;004;077;06;392;189;203
022;001;004;077;07;392;186;206
022;001;004;078;01;408;175;233
022;001;004;078;02;408;188;220
022;001;004;078;03;408;195;213
022;001;004;078;04;408;194;214
022;001;004;078;05;404;184;220
022;001;004;078;06;400;193;207
022;001;004;078;07;400;164;236
022;001;004;078;08;400;186;214
022;001;004;078;09;400;179;221
022;001;004;079;01;408;173;235
022;001;004;079;02;408;193;215
022;001;004;079;03;406;182;224
022;001;004;079;04;400;165;235
022;001;004;079;05;400;181;219
022;001;004;079;06;400;160;240
022;001;004;080;01;436;200;236
022;001;004;080;02;432;220;212
022;001;004;080;03;432;196;236
022;001;004;080;04;432;203;229
022;001;004;080;05;432;204;228
022;001;004;081;01;432;200;232
022;001;004;081;02;432;203;229
022;001;004;081;03;432;217;215
022;001;004;081;04;432;187;245
022;001;004;081;05;432;203;229
022;001;004;081;06;432;180;252
022;001;004;081;07;429;216;213
022;001;004;082;01;432;193;239
022;001;004;082;02;432;216;216
022;001;004;082;03;432;211;221
022;001;004;082;04;432;211;221
022;001;004;082;05;432;179;253
022;001;004;082;06;424;200;224
022;001;004;082;07;424;213;211
022;001;004;082;08;424;180;244
022;001;004;082;09;424;213;211
022;001;004;082;10;424;227;197
022;001;004;083;01;392;173;219
022;001;004;083;02;392;171;221
022;001;004;083;03;392;165;227
022;001;004;083;04;392;170;222
022;001;004;083;05;389;166;223
022;001;004;083;06;384;180;204
022;001;004;083;07;384;184;200
022;001;004;084;01;400;212;188
022;001;004;084;02;400;211;189
022;001;004;084;03;393;187;206
022;001;004;084;04;392;204;188
022;001;004;084;05;392;192;200
022;001;004;084;06;392;217;175
022;001;004;085;01;408;202;206
022;001;004;085;02;408;197;211
022;001;004;085;03;408;205;203
022;001;004;085;04;408;225;183
022;001;004;085;05;408;203;205
022;001;004;085;06;408;204;204
022;001;004;085;07;408;217;191
022;001;004;085;08;405;210;195
022;001;004;085;09;400;204;196
022;001;004;086;01;408;216;192
022;001;004;087;01;221;119;102
022;001;005;001;01;424;201;223
022;001;005;001;02;419;211;208
022;001;005;001;03;416;218;198
022;001;005;001;04;416;190;226
022;001;005;001;05;416;214;202
022;001;005;002;01;360;188;172
022;001;005;002;02;360;182;178
022;001;005;002;03;358;169;189
022;001;005;002;04;352;181;171
022;001;005;003;01;440;228;212
022;001;005;003;02;436;231;205
022;001;005;003;03;432;219;213
022;001;005;003;04;432;243;189
022;001;005;003;05;432;242;190
022;001;005;004;01;408;197;211
022;001;005;004;02;408;200;208
022;001;005;004;03;408;188;220
022;001;005;004;04;403;203;200
022;001;005;004;05;400;202;198
022;001;005;005;01;376;168;208
022;001;005;005;02;376;195;181
022;001;005;005;03;376;164;212
022;001;005;005;04;376;177;199
022;001;005;005;05;369;180;189
022;001;005;006;01;360;167;193
022;001;005;006;02;360;194;166
022;001;005;006;03;360;166;194
022;001;005;006;04;358;167;191
022;001;005;007;01;384;199;185
022;001;005;007;02;384;199;185
022;001;005;007;03;382;201;181
022;001;005;007;04;376;183;193
022;001;005;007;05;376;184;192
022;001;005;008;01;384;195;189
022;001;005;008;02;384;185;199
022;001;005;008;03;384;191;193
022;001;005;008;04;384;182;202
022;001;005;008;05;384;180;204
022;001;005;009;01;424;202;222
022;001;005;009;02;424;231;193
022;001;005;009;03;424;204;220
022;001;005;009;04;418;214;204
022;001;005;009;05;416;208;208
022;001;005;010;01;408;211;197
022;001;005;010;02;408;204;204
022;001;005;010;03;408;200;208
022;001;005;010;04;401;197;204
022;001;005;010;05;400;212;188
022;001;005;011;01;400;223;177
022;001;005;011;02;400;216;184
022;001;005;011;03;400;221;179
022;001;005;011;04;399;212;187
022;001;005;011;05;392;215;177
022;001;005;011;06;392;185;207
022;001;005;011;07;392;213;179
022;001;005;011;08;392;212;180
022;001;005;012;01;432;237;195
022;001;005;012;02;432;247;185
022;001;005;012;03;432;229;203
022;001;005;012;04;432;240;192
022;001;005;012;05;430;225;205
022;001;005;012;06;424;234;190
022;001;005;012;07;424;246;178
022;001;005;013;01;373;205;168
022;001;005;013;02;368;176;192
022;001;005;013;03;368;183;185
022;001;005;013;04;368;189;179
022;001;005;014;01;432;221;211
022;001;005;014;02;432;208;224
022;001;005;014;03;426;207;219
022;001;005;015;01;440;202;238
022;001;005;015;02;440;218;222
022;001;005;015;03;440;223;217
022;001;005;015;04;438;206;232
022;001;005;016;01;437;207;230
022;001;005;016;02;432;213;219
022;001;005;016;03;432;229;203
022;001;005;016;04;432;227;205
022;001;005;017;01;440;216;224
022;001;005;017;02;440;229;211
022;001;005;017;03;440;215;225
022;001;005;017;04;435;217;218
022;001;005;017;05;432;211;221
022;001;005;017;06;432;233;199
022;001;005;018;01;240;129;111
022;001;005;018;02;236;134;102
022;001;005;019;01;392;213;179
022;001;005;019;02;389;193;196
022;001;005;019;03;384;192;192
022;001;005;019;04;384;174;210
022;001;005;019;05;384;198;186
022;001;005;019;06;384;209;175
022;001;005;020;01;395;188;207
022;001;005;020;02;392;193;199
022;001;005;020;03;392;174;218
022;001;005;020;04;392;187;205
022;001;005;021;01;424;223;201
022;001;005;021;02;424;234;190
022;001;005;021;03;424;232;192
022;001;005;021;04;424;216;208
022;001;005;021;05;418;192;226
022;001;005;021;06;416;216;200
022;001;005;021;07;416;221;195
022;001;005;022;01;384;209;175
022;001;005;022;02;383;194;189
022;001;005;022;03;376;202;174
022;001;005;022;04;376;205;171
022;001;005;022;05;376;195;181
022;001;005;022;06;376;200;176
022;001;005;023;01;424;215;209
022;001;005;023;02;424;230;194
022;001;005;023;03;424;249;175
022;001;005;023;04;422;259;163
022;001;005;023;05;416;240;176
022;001;005;023;06;416;224;192
022;001;005;023;07;416;225;191
022;001;005;023;08;416;227;189
022;001;005;023;09;416;215;201
022;001;005;023;10;416;235;181
022;001;005;023;11;416;274;142
022;001;005;023;12;416;240;176
022;001;005;024;01;408;213;195
022;001;005;024;02;408;214;194
022;001;005;024;03;408;212;196
022;001;005;024;04;408;186;222
022;001;005;024;05;408;209;199
022;001;005;024;06;408;200;208
022;001;005;024;07;408;198;210
022;001;005;024;08;408;198;210
022;001;005;024;09;400;206;194
022;001;005;025;01;424;208;216
022;001;005;025;02;424;215;209
022;001;005;025;03;424;202;222
022;001;005;025;04;424;217;207
022;001;005;025;05;424;191;233
022;001;005;025;06;424;210;214
022;001;005;025;07;424;211;213
022;001;005;025;08;421;198;223
022;001;005;025;09;416;193;223
022;001;005;026;01;432;206;226
022;001;005;026;02;432;232;200
022;001;005;026;03;432;239;193
022;001;005;026;04;430;224;206
022;001;005;026;05;424;242;182
022;001;005;026;06;424;229;195
022;001;005;027;01;448;225;223
022;001;005;027;02;444;242;202
022;001;005;027;03;440;229;211
022;001;005;027;04;440;234;206
022;001;005;027;05;440;221;219
022;001;005;027;06;440;241;199
022;001;005;027;07;440;249;191
022;001;005;027;08;440;235;205
022;001;005;028;01;440;199;241
022;001;005;028;02;440;195;245
022;001;005;028;03;440;215;225
022;001;005;028;04;440;232;208
022;001;005;028;05;434;204;230
022;001;005;028;06;432;218;214
022;001;005;028;07;432;225;207
022;001;005;028;08;432;209;223
022;001;005;029;01;432;198;234
022;001;005;029;02;429;239;190
022;001;005;029;03;424;206;218
022;001;005;029;04;424;195;229
022;001;005;029;05;424;205;219
022;001;005;029;06;424;200;224
022;001;005;029;07;424;224;200
022;001;005;029;08;424;205;219
022;001;005;030;01;408;196;212
022;001;005;030;02;408;192;216
022;001;005;030;03;408;173;235
022;001;005;030;04;408;194;214
022;001;005;030;05;408;184;224
022;001;005;030;06;408;204;204
022;001;005;030;07;407;206;201
022;001;005;030;08;400;194;206
022;001;005;031;01;424;245;179
022;001;005;031;02;424;204;220
022;001;005;031;03;424;224;200
022;001;005;031;04;424;216;208
022;001;005;031;05;424;217;207
022;001;005;031;06;424;227;197
022;001;005;031;07;424;232;192
022;001;005;031;08;424;218;206
022;001;005;031;09;422;224;198
022;001;005;031;10;416;237;179
022;001;005;031;11;416;229;187
022;001;005;032;01;368;159;209
022;001;005;032;02;368;172;196
022;001;005;032;03;363;161;202
022;001;005;032;04;360;165;195
022;001;005;032;05;360;156;204
022;001;005;033;01;376;161;215
022;001;005;033;02;376;152;224
022;001;005;033;03;376;162;214
022;001;005;033;04;369;157;212
022;001;005;033;05;368;151;217
022;001;005;034;01;408;186;222
022;001;005;034;02;408;196;212
022;001;005;034;03;408;192;216
022;001;005;034;04;406;207;199
022;001;005;034;05;400;173;227
022;001;005;034;06;400;172;228
022;001;005;034;07;400;188;212
022;001;005;034;08;400;204;196
022;001;005;034;09;400;203;197
022;001;005;035;01;424;211;213
022;001;005;035;02;424;208;216
022;001;005;035;03;424;215;209
022;001;005;035;04;424;205;219
022;001;005;035;05;424;209;215
022;001;005;035;06;424;212;212
022;001;005;035;07;424;191;233
022;001;005;035;08;424;190;234
022;001;005;035;09;424;212;212
022;001;005;035;10;417;223;194
022;001;005;035;11;416;232;184
022;001;005;035;12;416;194;222
022;001;005;036;01;424;227;197
022;001;005;036;02;424;223;201
022;001;005;036;03;424;215;209
022;001;005;036;04;424;196;228
022;001;005;036;05;416;215;201
022;001;005;036;06;416;222;194
022;001;005;037;01;439;205;234
022;001;005;037;02;432;199;233
022;001;005;037;03;432;196;236
022;001;005;037;04;432;227;205
022;001;005;038;01;450;227;223
022;001;005;038;02;450;231;219
022;001;005;038;03;450;211;239
022;001;005;038;04;449;240;209
022;001;005;039;01;416;203;213
022;001;005;039;02;416;199;217
022;001;005;039;03;416;209;207
022;001;005;039;04;409;191;218
022;001;005;039;05;408;198;210
022;001;005;039;06;408;203;205
022;001;005;039;07;408;211;197
022;001;005;039;08;408;194;214
022;001;005;040;01;440;204;236
022;001;005;040;02;440;183;257
022;001;005;040;03;440;224;216
022;001;005;040;04;438;194;244
022;001;005;040;05;432;177;255
022;001;005;040;06;432;231;201
022;001;005;040;07;432;220;212
022;001;005;040;08;432;201;231
022;001;005;041;01;424;202;222
022;001;005;041;02;424;186;238
022;001;005;041;03;424;198;226
022;001;005;041;04;424;190;234
022;001;005;041;05;424;181;243
022;001;005;041;06;421;203;218
022;001;005;041;07;416;186;230
022;001;005;042;01;432;198;234
022;001;005;042;02;432;205;227
022;001;005;042;03;427;189;238
022;001;005;042;04;424;203;221
022;001;005;042;05;424;209;215
022;001;005;043;01;450;219;231
022;001;005;043;02;450;218;232
022;001;005;043;03;450;236;214
022;001;005;043;04;448;241;207
022;001;005;043;05;448;228;220
022;001;005;043;06;448;255;193
022;001;005;044;01;416;215;201
022;001;005;044;02;412;220;192
022;001;005;044;03;408;180;228
022;001;005;044;04;408;210;198
022;001;005;045;01;408;194;214
022;001;005;045;02;404;195;209
022;001;005;045;03;400;181;219
022;001;005;045;04;400;182;218
022;001;005;045;05;400;184;216
022;001;005;045;06;400;205;195
022;001;005;045;07;400;208;192
022;001;005;046;01;415;231;184
022;001;005;046;02;408;213;195
022;001;005;046;03;408;191;217
022;001;005;046;04;408;188;220
022;001;005;046;05;408;197;211
022;001;005;046;06;408;214;194
022;001;005;046;07;408;192;216
022;001;005;047;01;376;183;193
022;001;005;047;02;368;196;172
022;001;005;047;03;368;192;176
022;001;005;047;04;368;189;179
022;001;005;047;05;368;196;172
022;001;005;048;01;384;204;180
022;001;005;048;02;383;196;187
022;001;005;048;03;376;183;193
022;001;005;048;04;376;184;192
022;001;005;048;05;376;173;203
022;001;005;049;01;440;211;229
022;001;005;049;02;436;227;209
022;001;005;049;03;432;198;234
022;001;005;049;04;432;181;251
022;001;005;049;05;432;178;254
022;001;005;049;06;432;196;236
022;001;005;050;01;440;207;233
022;001;005;050;02;436;212;224
022;001;005;050;03;432;209;223
022;001;005;050;04;432;219;213
022;001;005;050;05;432;203;229
022;001;005;050;06;432;228;204
022;001;005;051;01;440;221;219
022;001;005;051;02;440;238;202
022;001;005;051;03;440;222;218
022;001;005;051;04;440;231;209
022;001;005;051;05;440;210;230
022;001;005;051;06;440;221;219
022;001;005;051;07;439;212;227
022;001;005;051;08;432;204;228
022;001;005;051;09;432;187;245
022;001;005;051;10;432;217;215
022;001;005;051;11;432;234;198
022;001;005;051;12;432;218;214
022;001;005;052;01;408;199;209
022;001;005;052;02;408;216;192
022;001;005;052;03;408;175;233
022;001;005;052;04;406;215;191
022;001;005;052;05;400;198;202
022;001;005;052;06;400;174;226
022;001;005;052;07;400;174;226
022;001;005;052;08;400;218;182
022;001;005;052;09;400;198;202
022;001;005;053;01;410;201;209
022;001;005;053;02;408;186;222
022;001;005;053;03;408;232;176
022;001;005;053;04;408;206;202
022;001;005;053;05;408;199;209
022;001;005;053;06;408;200;208
022;001;005;053;07;408;185;223
022;001;005;053;08;408;190;218
022;001;005;053;09;408;214;194
022;001;005;053;10;408;194;214
022;001;005;054;01;416;204;212
022;001;005;054;02;416;217;199
022;001;005;054;03;416;215;201
022;001;005;054;04;416;215;201
022;001;005;054;05;411;202;209
022;001;005;054;06;408;221;187
022;001;005;054;07;408;224;184
022;001;005;055;01;424;205;219
022;001;005;055;02;424;233;191
022;001;005;055;03;424;197;227
022;001;005;055;04;424;226;198
022;001;005;055;05;417;199;218
022;001;005;055;06;416;239;177
022;001;005;056;01;448;227;221
022;001;005;056;02;447;229;218
022;001;005;056;03;440;231;209
022;001;005;056;04;440;252;188
022;001;005;056;05;440;232;208
022;001;005;056;06;440;222;218
022;001;005;057;01;422;213;209
022;001;005;057;02;416;190;226
022;001;005;057;03;416;195;221
022;001;005;057;04;416;212;204
022;001;005;057;05;416;205;211
022;001;005;057;06;416;210;206
022;001;005;057;07;416;211;205
022;001;005;058;01;440;215;225
022;001;005;058;02;440;238;202
022;001;005;058;03;440;214;226
022;001;005;058;04;440;202;238
022;001;005;058;05;440;229;211
022;001;005;058;06;433;214;219
022;001;005;058;07;432;214;218
022;001;005;059;01;392;181;211
022;001;005;059;02;392;208;184
022;001;005;059;03;392;188;204
022;001;005;059;04;392;183;209
022;001;005;059;05;392;208;184
022;001;005;059;06;392;196;196
022;001;005;059;07;387;202;185
022;001;005;060;01;384;181;203
022;001;005;060;02;384;181;203
022;001;005;060;03;384;193;191
022;001;005;060;04;383;198;185
022;001;005;061;01;448;254;194
022;001;005;061;02;448;262;186
022;001;005;061;03;448;250;198
022;001;005;061;04;448;263;185
022;001;005;061;05;448;261;187
022;001;005;061;06;448;233;215
022;001;005;061;07;448;255;193
022;001;005;061;08;445;246;199
022;001;005;061;09;440;266;174
022;001;005;061;10;440;267;173
022;001;005;062;01;392;197;195
022;001;005;062;02;392;199;193
022;001;005;062;03;392;166;226
022;001;005;062;04;392;179;213
022;001;005;062;05;392;173;219
022;001;005;062;06;388;198;190
022;001;005;063;01;424;204;220
022;001;005;063;02;424;229;195
022;001;005;063;03;424;232;192
022;001;005;063;04;424;210;214
022;001;005;063;05;424;224;200
022;001;005;063;06;424;213;211
022;001;005;063;07;424;237;187
022;001;005;063;08;424;215;209
022;001;005;063;09;424;206;218
022;001;005;063;10;424;202;222
022;001;005;063;11;424;231;193
022;001;005;063;12;424;212;212
022;001;005;063;13;415;211;204
022;001;005;064;01;450;217;233
022;001;005;064;02;450;228;222
022;001;005;064;03;450;189;261
022;001;005;064;04;450;246;204
022;001;005;064;05;450;214;236
022;001;005;064;06;450;197;253
022;001;005;064;07;450;222;228
022;001;005;064;08;450;243;207
022;001;005;064;09;448;245;203
022;001;005;065;01;368;161;207
022;001;005;065;02;368;169;199
022;001;005;065;03;368;159;209
022;001;005;065;04;363;167;196
022;001;005;066;01;352;182;170
022;001;005;066;02;352;166;186
022;001;005;066;03;350;173;177
022;001;005;067;01;338;155;183
022;001;005;067;02;336;176;160
022;001;005;068;01;232;109;123
022;001;006;001;01;408;212;196
022;001;006;001;02;408;219;189
022;001;006;001;03;408;250;158
022;001;006;001;04;408;215;193
022;001;006;001;05;402;218;184
022;001;006;001;06;400;218;182
022;001;006;001;07;400;220;180
022;001;006;002;01;384;191;193
022;001;006;002;02;384;186;198
022;001;006;002;03;384;203;181
022;001;006;002;04;384;159;225
022;001;006;002;05;384;197;187
022;001;006;002;06;377;192;185
022;001;006;003;01;381;228;153
022;001;006;003;02;376;195;181
022;001;006;003;03;376;190;186
022;001;006;003;04;376;205;171
022;001;006;003;05;376;220;156
022;001;006;004;01;400;215;185
022;001;006;004;02;400;235;165
022;001;006;004;03;398;234;164
022;001;006;004;04;392;222;170
022;001;006;004;05;392;205;187
022;001;006;004;06;392;194;198
022;001;006;004;07;392;212;180
022;001;006;004;08;392;224;168
022;001;006;005;01;416;288;128
022;001;006;005;02;416;301;115
022;001;006;005;03;416;304;112
022;001;006;005;04;416;304;112
022;001;006;005;05;409;288;121
022;001;006;005;06;408;284;124
022;001;006;006;01;400;214;186
022;001;006;006;02;400;223;177
022;001;006;006;03;400;212;188
022;001;006;006;04;395;220;175
022;001;006;006;05;392;232;160
022;001;006;006;06;392;214;178
022;001;006;006;07;392;234;158
022;001;006;006;08;392;204;188
022;001;006;007;01;448;249;199
022;001;006;007;02;448;272;176
022;001;006;007;03;447;272;175
022;001;006;007;04;440;248;192
022;001;006;007;05;440;252;188
022;001;006;007;06;440;248;192
022;001;006;007;07;440;270;170
022;001;006;008;01;400;190;210
022;001;006;008;02;393;194;199
022;001;006;008;03;392;203;189
022;001;006;008;04;392;190;202
022;001;006;008;05;392;209;183
022;001;006;008;06;392;210;182
022;001;006;009;01;424;238;186
022;001;006;009;02;424;242;182
022;001;006;009;03;419;241;178
022;001;006;009;04;416;230;186
022;001;006;009;05;416;188;228
022;001;006;009;06;416;218;198
022;001;006;009;07;416;226;190
022;001;006;009;08;416;229;187
022;001;006;010;01;450;209;241
022;001;006;010;02;450;229;221
022;001;006;010;03;449;225;224
022;001;006;010;04;448;246;202
022;001;006;010;05;448;217;231
022;001;006;010;06;448;224;224
022;001;006;010;07;448;230;218
022;001;006;010;08;448;226;222
022;001;006;011;01;432;228;204
022;001;006;011;02;432;263;169
022;001;006;011;03;432;238;194
022;001;006;011;04;432;246;186
022;001;006;011;05;432;235;197
022;001;006;011;06;429;230;199
022;001;006;012;01;424;199;225
022;001;006;012;02;424;227;197
022;001;006;012;03;424;240;184
022;001;006;012;04;423;224;199
022;001;006;012;05;416;215;201
022;001;006;012;06;416;207;209
022;001;006;012;07;416;229;187
022;001;006;013;01;376;220;156
022;001;006;013;02;368;202;166
022;001;006;013;03;368;176;192
022;001;006;013;04;368;204;164
022;001;006;014;01;432;212;220
022;001;006;014;02;432;221;211
022;001;006;014;03;432;198;234
022;001;006;014;04;432;229;203
022;001;006;014;05;432;230;202
022;001;006;014;06;427;210;217
022;001;006;014;07;424;208;216
022;001;006;014;08;424;228;196
022;001;006;014;09;424;244;180
022;001;006;014;10;424;251;173
022;001;006;014;11;424;239;185
022;001;006;015;01;408;206;202
022;001;006;015;02;408;221;187
022;001;006;015;03;403;202;201
022;001;006;015;04;400;207;193
022;001;006;015;05;400;194;206
022;001;006;015;06;400;207;193
022;001;006;015;07;400;208;192
022;001;006;015;08;400;211;189
022;001;006;016;01;400;212;188
022;001;006;016;02;400;222;178
022;001;006;016;03;395;219;176
022;001;006;016;04;392;196;196
022;001;006;016;05;392;191;201
022;001;006;016;06;392;193;199
022;001;006;016;07;392;217;175
022;001;006;016;08;392;215;177
022;001;006;017;01;408;203;205
022;001;006;017;02;408;203;205
022;001;006;017;03;408;194;214
022;001;006;017;04;408;194;214
022;001;006;017;05;408;184;224
022;001;006;017;06;408;178;230
022;001;006;017;07;408;175;233
022;001;006;017;08;408;202;206
022;001;006;017;09;401;199;202
022;001;006;018;01;440;208;232
022;001;006;018;02;440;209;231
022;001;006;018;03;440;222;218
022;001;006;018;04;440;204;236
022;001;006;018;05;440;193;247
022;001;006;018;06;440;217;223
022;001;006;018;07;440;196;244
022;001;006;018;08;440;198;242
022;001;006;018;09;432;213;219
022;001;006;018;10;432;210;222
022;001;006;019;01;432;209;223
022;001;006;019;02;432;215;217
022;001;006;019;03;425;194;231
022;001;006;019;04;424;191;233
022;001;006;019;05;424;213;211
022;001;006;019;06;424;203;221
022;001;006;019;07;424;184;240
022;001;006;019;08;424;206;218
022;001;006;019;09;424;211;213
022;001;006;020;01;432;194;238
022;001;006;020;02;432;204;228
022;001;006;020;03;432;192;240
022;001;006;020;04;432;188;244
022;001;006;020;05;431;194;237
022;001;006;020;06;424;199;225
022;001;006;020;07;424;197;227
022;001;006;021;01;440;214;226
022;001;006;021;02;440;225;215
022;001;006;021;03;440;223;217
022;001;006;021;04;440;229;211
022;001;006;021;05;440;229;211
022;001;006;021;06;440;233;207
022;001;006;021;07;440;236;204
022;001;006;022;01;432;197;235
022;001;006;022;02;429;199;230
022;001;006;022;03;424;213;211
022;001;006;022;04;424;225;199
022;001;006;022;05;424;198;226
022;001;006;022;06;424;215;209
022;001;006;022;07;424;191;233
022;001;006;022;08;424;185;239
022;001;006;022;09;424;227;197
022;001;006;022;10;424;202;222
022;001;006;023;01;438;195;243
022;001;006;023;02;432;207;225
022;001;006;023;03;432;219;213
022;001;006;023;04;432;194;238
022;001;006;023;05;432;220;212
022;001;006;023;06;432;208;224
022;001;006;023;07;432;231;201
022;001;006;023;08;432;233;199
022;001;006;024;01;448;213;235
022;001;006;024;02;448;230;218
022;001;006;024;03;447;251;196
022;001;006;024;04;440;235;205
022;001;006;024;05;440;247;193
022;001;006;024;06;440;205;235
022;001;006;024;07;440;252;188
022;001;006;024;08;440;196;244
022;001;006;024;09;440;208;232
022;001;006;024;10;440;242;198
022;001;006;024;11;440;247;193
022;001;006;024;12;440;226;214
022;001;006;025;01;448;211;237
022;001;006;025;02;448;230;218
022;001;006;025;03;448;214;234
022;001;006;025;04;448;210;238
022;001;006;025;05;448;223;225
022;001;006;025;06;447;216;231
022;001;006;025;07;440;200;240
022;001;006;025;08;440;199;241
022;001;006;025;09;440;211;229
022;001;006;025;10;440;223;217
022;001;006;025;11;440;221;219
022;001;006;025;12;440;221;219
022;001;006;026;01;431;225;206
022;001;006;026;02;424;243;181
022;001;006;026;03;424;247;177
022;001;006;026;04;424;224;200
022;001;006;026;05;424;233;191
022;001;006;026;06;424;242;182
022;001;006;026;07;424;240;184
022;001;006;027;01;448;206;242
022;001;006;027;02;448;227;221
022;001;006;027;03;445;223;222
022;001;006;027;04;440;204;236
022;001;006;027;05;440;223;217
022;001;006;027;06;440;195;245
022;001;006;027;07;440;234;206
022;001;006;027;08;440;203;237
022;001;006;027;09;440;197;243
022;001;006;027;10;440;208;232
022;001;006;027;11;440;220;220
022;001;006;027;12;440;230;210
022;001;006;027;13;440;188;252
022;001;006;027;14;440;228;212
022;001;006;028;01;392;233;159
022;001;006;028;02;391;237;154
022;001;006;028;03;384;210;174
022;001;006;028;04;384;210;174
022;001;006;028;05;384;240;144
022;001;006;028;06;384;228;156
022;001;006;029;01;440;265;175
022;001;006;029;02;440;285;155
022;001;006;029;03;440;267;173
022;001;006;029;04;436;249;187
022;001;006;029;05;432;273;159
022;001;006;030;01;416;272;144
022;001;006;030;02;412;269;143
022;001;006;030;03;408;254;154
022;001;006;030;04;408;270;138
022;001;006;030;05;408;275;133
022;001;006;031;01;408;213;195
022;001;006;031;02;408;217;191
022;001;006;031;03;408;220;188
022;001;006;031;04;408;199;209
022;001;006;031;05;408;204;204
022;001;006;031;06;406;194;212
022;001;006;031;07;400;210;190
022;001;006;031;08;400;219;181
022;001;006;032;01;440;207;233
022;001;006;032;02;440;196;244
022;001;006;032;03;435;194;241
022;001;006;032;04;432;177;255
022;001;006;032;05;432;203;229
022;001;006;032;06;432;208;224
022;001;006;032;07;432;199;233
022;001;006;033;01;415;276;139
022;001;006;033;02;408;276;132
022;001;006;033;03;408;281;127
022;001;006;033;04;408;301;107
022;001;006;034;01;440;266;174
022;001;006;034;02;440;221;219
022;001;006;034;03;440;250;190
022;001;006;034;04;440;243;197
022;001;006;034;05;440;287;153
022;001;006;034;06;440;242;198
022;001;006;034;07;440;260;180
022;001;006;034;08;440;234;206
022;001;006;034;09;440;236;204
022;001;006;034;10;440;240;200
022;001;006;034;11;440;249;191
022;001;006;034;12;437;225;212
022;001;006;034;13;432;254;178
022;001;006;034;14;432;307;125
022;001;006;035;01;350;178;172
022;001;006;036;01;304;160;144
022;001;006;036;02;296;165;131
022;001;006;037;01;272;163;109
022;001;006;037;02;267;173;94
022;001;006;038;01;336;165;171
022;001;007;001;01;440;243;197
022;001;007;001;02;440;255;185
022;001;007;001;03;440;257;183
022;001;007;001;04;440;258;182
022;001;007;001;05;440;237;203
022;001;007;001;06;440;279;161
022;001;007;001;07;439;254;185
022;001;007;001;08;432;248;184
022;001;007;001;09;432;258;174
022;001;007;001;10;432;250;182
022;001;007;001;11;432;272;160
022;001;007;001;12;432;224;208
022;001;007;001;13;432;277;155
022;001;007;001;14;432;222;210
022;001;007;001;15;432;265;167
022;001;007;001;16;432;244;188
022;001;007;001;17;432;230;202
022;001;007;001;18;432;252;180
022;001;007;001;19;432;242;190
022;001;007;001;20;432;254;178
022;001;007;001;21;432;247;185
022;001;007;001;22;432;241;191
022;001;007;001;23;432;269;163
022;001;007;001;24;432;267;165
022;001;007;002;01;448;248;200
022;001;007;002;02;448;246;202
022;001;007;002;03;444;228;216
022;001;007;002;04;440;250;190
022;001;007;002;05;440;241;199
022;001;007;002;06;440;249;191
022;001;007;002;07;440;239;201
022;001;007;002;08;440;248;192
022;001;007;002;09;440;225;215
022;001;007;002;10;440;268;172
022;001;007;002;11;440;222;218
022;001;007;002;12;440;245;195
022;001;007;002;13;440;239;201
022;001;007;002;14;440;225;215
022;001;007;002;15;440;272;168
022;001;007;002;16;440;265;175
022;001;007;002;17;440;257;183
022;001;007;002;18;440;251;189
022;001;007;002;19;440;281;159
022;001;007;003;01;440;246;194
022;001;007;003;02;440;226;214
022;001;007;003;03;432;252;180
022;001;007;003;04;432;233;199
022;001;007;003;05;432;227;205
022;001;007;003;06;432;229;203
022;001;007;003;07;432;230;202
022;001;007;003;08;432;249;183
022;001;007;003;09;432;244;188
022;001;007;003;10;432;218;214
022;001;007;003;11;432;204;228
022;001;007;003;12;432;224;208
022;001;007;003;13;432;239;193
022;001;007;003;14;432;238;194
022;001;007;003;15;432;236;196
022;001;007;003;16;432;237;195
022;001;007;003;17;432;244;188
022;001;007;003;18;432;226;206
022;001;007;003;19;432;241;191
022;001;007;003;20;432;212;220
022;001;007;003;21;432;244;188
022;001;007;004;01;440;229;211
022;001;007;004;02;436;257;179
022;001;007;004;03;432;242;190
022;001;007;004;04;432;252;180
022;001;007;004;05;432;248;184
022;001;007;004;06;432;231;201
022;001;007;004;07;432;236;196
022;001;007;004;08;432;246;186
022;001;007;004;09;432;246;186
022;001;007;004;10;432;236;196
022;001;007;004;11;432;245;187
022;001;007;004;12;432;228;204
022;001;007;004;13;432;236;196
022;001;007;004;14;432;219;213
022;001;007;004;15;432;244;188
022;001;007;004;16;432;255;177
022;001;007;004;17;432;249;183
022;001;007;004;18;432;236;196
022;001;007;004;19;432;239;193
022;001;007;004;20;432;242;190
022;001;007;004;21;432;229;203
022;001;007;004;22;432;236;196
022;001;007;004;23;432;250;182
022;001;007;004;24;432;242;190
022;001;007;004;25;432;238;194
022;001;007;005;01;440;242;198
022;001;007;005;02;440;248;192
022;001;007;005;03;440;255;185
022;001;007;005;04;440;258;182
022;001;007;005;05;440;282;158
022;001;007;005;06;440;243;197
022;001;007;005;07;440;236;204
022;001;007;005;08;440;259;181
022;001;007;005;09;438;224;214
022;001;007;005;10;432;247;185
022;001;007;005;11;432;233;199
022;001;007;005;12;432;240;192
022;001;007;005;13;432;235;197
022;001;007;005;14;432;238;194
022;001;007;005;15;432;235;197
022;001;007;005;16;432;238;194
022;001;007;005;17;432;240;192
022;001;007;005;18;432;255;177
022;001;007;005;19;432;225;207
022;001;007;005;20;432;250;182
022;001;007;006;01;432;239;193
022;001;007;006;02;432;229;203
022;001;007;006;03;432;248;184
022;001;007;006;04;432;243;189
022;001;007;006;05;432;253;179
022;001;007;006;06;432;240;192
022;001;007;006;07;432;243;189
022;001;007;006;08;432;240;192
022;001;007;006;09;432;246;186
022;001;007;006;10;432;246;186
022;001;007;006;11;432;202;230
022;001;007;006;12;432;243;189
022;001;007;006;13;432;261;171
022;001;007;006;14;432;270;162
022;001;007;006;15;432;241;191
022;001;007;006;16;432;250;182
022;001;007;006;17;432;242;190
022;001;007;006;18;432;245;187
022;001;007;006;19;425;248;177
022;001;007;006;20;424;242;182
022;001;007;006;21;424;234;190
022;001;007;006;22;424;253;171
022;001;007;007;01;440;212;228
022;001;007;007;02;440;241;199
022;001;007;007;03;440;232;208
022;001;007;007;04;440;236;204
022;001;007;007;05;440;259;181
022;001;007;007;06;440;241;199
022;001;007;007;07;440;233;207
022;001;007;007;08;435;236;199
022;001;007;007;09;432;250;182
022;001;007;007;10;432;242;190
022;001;007;007;11;432;235;197
022;001;007;007;12;432;220;212
022;001;007;007;13;432;216;216
022;001;007;007;14;432;213;219
022;001;007;007;15;432;266;166
022;001;007;007;16;432;217;215
022;001;007;007;17;432;223;209
022;001;007;007;18;432;243;189
022;001;007;007;19;432;233;199
022;001;007;007;20;432;248;184
022;001;007;007;21;432;253;179
022;001;007;007;22;432;237;195
022;001;007;007;23;432;246;186
022;001;007;008;01;450;274;176
022;001;007;008;02;450;254;196
022;001;007;008;03;450;245;205
022;001;007;008;04;450;249;201
022;001;007;008;05;450;249;201
022;001;007;008;06;450;212;238
022;001;007;008;07;450;242;208
022;001;007;008;08;450;236;214
022;001;007;008;09;450;253;197
022;001;007;008;10;450;245;205
022;001;007;008;11;450;229;221
022;001;007;008;12;450;249;201
022;001;007;008;13;450;253;197
022;001;007;008;14;450;236;214
022;001;007;008;15;450;265;185
022;001;007;008;16;450;260;190
022;001;007;008;17;450;260;190
022;001;007;008;18;448;246;202
022;001;007;008;19;448;236;212
022;001;007;008;20;448;265;183
022;001;007;008;21;448;252;196
022;001;007;008;22;448;252;196
022;001;007;008;23;448;238;210
022;001;007;009;01;450;224;226
022;001;007;009;02;450;231;219
022;001;007;009;03;450;220;230
022;001;007;009;04;450;237;213
022;001;007;009;05;450;249;201
022;001;007;009;06;450;232;218
022;001;007;009;07;450;229;221
022;001;007;010;01;392;207;185
022;001;007;010;02;392;218;174
022;001;007;010;03;391;195;196
022;001;007;010;04;384;190;194
022;001;007;010;05;384;192;192
022;001;007;010;06;384;189;195
022;001;007;010;07;384;215;169
022;001;007;011;01;416;223;193
022;001;007;011;02;409;235;174
022;001;007;011;03;408;239;169
022;001;007;011;04;408;243;165
022;001;007;011;05;408;234;174
022;001;007;011;06;408;211;197
022;001;007;011;07;408;235;173
022;001;007;012;01;408;218;190
022;001;007;012;02;408;232;176
022;001;007;012;03;404;236;168
022;001;007;012;04;400;223;177
022;001;007;012;05;400;240;160
022;001;007;012;06;400;232;168
022;001;007;012;07;400;236;164
022;001;007;013;01;440;263;177
022;001;007;013;02;439;256;183
022;001;007;013;03;432;258;174
022;001;007;014;01;376;257;119
022;001;007;014;02;374;220;154
022;001;007;014;03;368;251;117
022;001;007;014;04;368;222;146
022;001;007;015;01;384;214;170
022;001;007;015;02;384;197;187
022;001;007;015;03;384;200;184
022;001;007;015;04;381;204;177
022;001;007;016;01;399;216;183
022;001;007;016;02;392;199;193
022;001;007;017;01;352;207;145
022;001;007;017;02;352;199;153
022;001;007;017;03;352;196;156
022;001;007;018;01;401;211;190
022;001;007;018;02;400;219;181
022;001;007;018;03;400;225;175
022;001;007;019;01;448;228;220
090;001;001;008;03;328;141;187
090;001;001;009;01;434;233;201
090;001;001;010;01;367;202;165
090;001;001;010;02;360;190;170
090;001;001;010;03;360;165;195
090;001;001;011;01;415;194;221
090;001;001;011;02;408;203;205
090;001;001;012;01;397;199;198
090;001;001;012;02;392;218;174
090;001;001;012;03;392;192;200
090;001;001;013;01;288;156;132
090;001;001;013;02;285;119;166
090;001;001;014;01;192;112;80
090;001;001;015;01;324;126;198
090;001;001;015;02;320;204;116
090;001;001;016;01;395;186;209
090;001;001;016;02;392;181;211
090;001;001;017;01;344;157;187
090;001;001;017;02;340;151;189
090;001;001;017;03;336;169;167
090;001;001;019;01;312;163;149
090;001;001;019;02;311;151;160
090;001;001;020;01;400;212;188
090;001;001;020;02;400;231;169
090;001;001;020;03;392;236;156
090;001;098;001;01;440;197;243
090;001;098;001;02;440;178;262
090;001;098;002;01;382;182;200
090;001;098;003;01;341;178;163
090;001;098;003;02;336;143;193
090;001;098;004;01;375;193;182
090;001;098;004;02;368;208;160
090;001;098;004;03;368;179;189
090;001;098;005;01;282;145;137
090;001;098;005;02;280;150;130
090;001;098;006;01;269;164;105
090;001;098;007;01;374;171;203
090;001;098;008;01;449;227;222
090;001;098;009;01;240;129;111
090;001;098;009;02;239;149;90
090;001;098;010;01;264;136;128
090;001;098;011;01;335;178;157
090;001;098;012;01;343;189;154
090;001;098;013;01;134;81;53
090;001;098;014;01;183;98;85
090;002;001;001;01;372;185;187
090;002;001;001;02;368;170;198
090;002;001;002;01;344;181;163
090;002;001;002;02;344;159;185
090;002;001;002;03;341;141;200
090;002;001;003;01;396;211;185
090;002;001;004;01;374;208;166
090;002;001;005;01;361;166;195
090;002;001;006;01;335;170;165
090;002;001;007;01;272;145;127
090;002;001;007;02;265;147;118
090;002;001;008;01;327;190;137
090;002;001;009;01;211;125;86
090;002;001;010;01;132;73;59
090;002;001;011;01;265;133;132
090;002;001;011;02;264;115;149
090;002;001;012;01;173;92;81
090;002;001;013;01;103;57;46
090;002;098;001;01;131;63;68
090;002;098;002;01;236;116;120
090;002;098;002;02;232;159;73
090;002;098;003;01;211;129;82
090;002;098;004;01;414;211;203
090;002;098;004;02;408;249;159
090;002;098;005;01;133;73;60
090;002;098;006;01;246;130;116
090;002;098;006;02;240;155;85
090;002;098;007;01;415;233;182
090;002;098;007;02;408;250;158
090;002;098;008;01;232;137;95
090;002;098;009;01;239;107;132
090;002;098;010;01;284;139;145
090;002;098;011;01;93;44;49
090;002;098;012;01;160;89;71
090;002;098;013;01;118;74;44
090;002;098;015;01;110;60;50
090;002;098;016;01;80;56;24
090;002;098;017;01;84;56;28
090;004;098;001;01;447;290;157
090;004;098;002;01;209;125;84
090;004;098;003;01;402;240;162
090;004;098;003;02;400;249;151
090;004;098;004;01;432;258;174
090;004;098;004;02;428;239;189
090;004;098;004;03;424;271;153
090;004;098;004;04;424;235;189
090;004;098;004;05;424;240;184
090;004;098;005;01;401;207;194
090;004;098;005;02;400;206;194
090;004;098;006;01;349;212;137
090;004;098;007;01;422;248;174
090;004;098;008;01;147;61;86
090;004;098;009;01;128;90;38
090;005;098;001;01;132;71;61
090;005;098;002;01;111;56;55
090;005;098;003;01;296;134;162
090;005;098;003;02;288;163;125
090;005;098;004;01;328;162;166
090;005;098;004;02;324;184;140
090;005;098;005;01;328;148;180
090;005;098;005;02;323;188;135
090;006;098;001;01;211;111;100
090;006;098;002;01;424;233;191
090;006;098;002;02;417;288;129
090;006;098;003;01;223;161;62
090;006;098;004;01;176;102;74
090;006;098;005;01;280;156;124
090;006;098;005;02;279;191;88
090;006;098;006;01;158;95;63
090;006;098;007;01;38;22;16
090;006;098;009;01;360;197;163
090;006;098;009;02;354;188;166
090;006;098;010;01;98;80;18
090;006;098;011;01;92;51;41
090;006;098;012;01;140;76;64
090;007;098;001;01;82;41;41
090;007;098;002;01;187;92;95
090;007;098;003;01;232;98;134
090;007;098;004;01;259;124;135
090;007;098;005;01;355;162;193
090;007;098;006;01;327;144;183
090;007;098;007;01;296;99;197
090;007;098;007;02;288;170;118
090;007;098;008;01;282;147;135
090;007;098;009;01;273;124;149
090;007;098;010;01;119;62;57
090;007;098;011;01;87;48;39
090;008;098;001;01;283;173;110
090;008;098;001;02;280;182;98
090;008;098;002;01;376;235;141
090;008;098;002;02;374;210;164
090;008;098;003;01;304;208;96
090;008;098;003;02;296;202;94
090;008;098;004;01;256;171;85
090;008;098;004;02;249;152;97
090;008;098;005;01;212;127;85
090;008;098;006;01;347;221;126
090;008;098;006;02;344;204;140
090;008;098;007;01;430;271;159
090;008;098;008;01;320;204;116
090;008;098;008;02;320;215;105
090;008;098;008;03;317;206;111
090;008;098;009;01;424;272;152
090;008;098;009;02;424;247;177
090;008;098;009;03;422;267;155
090;008;098;009;04;416;222;194
090;008;098;010;01;314;218;96
090;008;098;011;01;105;76;29
090;008;098;013;01;64;49;15
091;002;001;001;01;435;242;193
091;002;001;001;02;432;235;197
091;002;001;001;03;432;236;196
091;002;001;001;04;432;229;203
091;002;001;001;05;432;239;193
091;002;001;002;01;245;139;106
091;002;001;002;02;240;147;93
091;002;001;003;01;368;186;182
091;002;001;003;02;365;181;184
091;002;001;003;03;360;174;186
091;002;001;003;04;360;185;175
091;002;001;004;01;448;261;187
091;002;001;004;02;448;238;210
091;002;001;004;03;444;254;190
091;002;001;005;01;357;180;177
091;002;001;005;02;352;191;161
091;002;001;005;03;352;180;172
091;002;001;006;01;352;211;141
091;002;001;006;02;347;204;143
091;002;001;006;03;344;196;148
091;002;001;007;01;344;192;152
091;002;001;007;02;344;186;158
091;002;001;007;03;344;183;161
091;002;001;007;04;338;176;162
091;002;001;008;01;435;242;193
091;002;001;008;02;432;246;186
091;002;001;008;03;432;246;186
091;002;001;009;01;368;193;175
091;002;001;009;02;367;188;179
091;002;001;009;03;360;176;184
091;002;001;009;04;360;180;180
091;002;001;009;05;360;191;169
091;002;001;010;01;384;205;179
091;002;001;010;02;384;183;201
091;002;001;010;03;381;178;203
091;002;001;010;04;376;197;179
091;002;001;010;05;376;194;182
091;002;001;010;06;376;181;195
091;002;001;011;01;400;188;212
091;002;001;011;02;400;159;241
091;002;001;011;03;398;176;222
091;002;001;011;04;392;185;207
091;002;001;012;01;408;209;199
091;002;001;012;02;408;185;223
091;002;001;012;03;408;191;217
091;002;001;012;04;408;185;223
091;002;001;012;05;403;215;188
091;002;001;013;01;424;169;255
091;002;001;013;02;421;172;249
091;002;001;013;03;416;158;258
091;002;001;013;04;416;159;257
091;002;001;013;05;416;194;222
091;002;001;014;01;317;146;171
091;002;001;015;01;186;98;88
091;002;001;016;01;220;119;101
091;002;001;017;01;320;184;136
091;002;001;017;02;318;169;149
091;002;001;018;01;190;96;94
091;002;001;019;01;254;125;129
091;002;001;020;01;233;130;103
091;002;001;021;01;377;185;192
091;002;001;022;01;319;178;141
091;002;001;023;01;255;147;108
091;002;001;024;01;169;95;74
091;002;001;025;01;235;130;105
091;002;001;025;02;232;130;102
091;002;001;026;01;408;217;191
091;002;001;026;02;404;225;179
091;002;001;027;01;296;153;143
091;002;001;027;02;292;148;144
091;002;001;028;01;285;148;137
091;002;001;029;01;124;63;61
091;002;001;030;01;325;177;148
091;002;001;031;01;224;114;110
091;002;001;032;01;285;154;131
091;002;001;033;01;153;87;66
091;002;001;034;01;340;157;183
091;002;001;035;01;335;171;164
091;002;001;036;01;108;54;54
091;002;001;037;01;192;115;77
091;002;001;038;01;289;169;120
091;002;001;038;02;288;134;154
091;002;001;039;01;344;155;189
091;002;001;039;02;344;175;169
091;002;001;039;03;339;165;174
091;002;001;040;01;419;268;151
091;002;001;041;01;309;157;152
091;002;001;042;01;352;209;143
091;002;001;042;02;351;215;136
091;002;001;043;01;130;70;60
091;002;001;046;01;134;66;68
091;002;001;047;01;180;101;79
091;002;001;048;01;95;46;49
091;002;001;049;01;166;78;88
091;002;001;050;01;22;12;10
091;002;098;001;01;79;40;39
091;002;098;002;01;164;92;72
091;002;098;003;01;369;192;177
091;002;098;004;01;170;87;83
091;002;098;005;01;288;149;139
091;002;098;005;02;287;154;133
091;002;098;006;01;36;19;17
091;002;098;007;01;313;148;165
091;002;098;008;01;188;97;91
091;002;098;009;01;194;101;93
091;002;098;010;01;168;86;82
091;002;098;011;01;147;73;74
091;002;098;012;01;320;171;149
091;002;098;012;02;313;171;142
091;002;098;013;01;236;119;117
091;002;098;014;01;311;157;154
091;002;098;015;01;130;67;63
091;002;098;016;01;97;44;53
091;002;098;017;01;309;172;137
091;002;098;018;01;304;161;143
091;002;098;019;01;154;88;66
091;002;098;020;01;171;96;75
091;002;098;021;01;235;124;111
091;002;098;022;01;93;55;38
091;002;098;023;01;177;95;82
091;002;098;024;01;113;60;53
091;002;098;025;01;53;47;6
091;002;098;026;01;68;42;26
091;003;098;001;01;371;289;82
091;003;098;002;01;312;217;95
091;003;098;003;01;344;171;173
091;003;098;003;02;344;207;137
091;003;098;003;03;339;193;146
091;003;098;004;01;352;182;170
091;003;098;004;02;348;196;152
091;003;098;004;03;344;173;171
091;003;098;005;01;179;110;69
091;003;098;006;01;129;81;48
091;003;098;007;01;371;189;182
091;003;098;008;01;210;115;95
091;003;098;009;01;207;106;101
091;003;098;010;01;300;155;145
091;003;098;011;01;333;164;169
091;003;098;013;01;362;189;173
091;003;098;014;01;229;95;134
091;003;098;014;02;224;120;104
091;003;098;015;01;376;192;184
091;003;098;015;02;376;202;174
091;003;098;015;03;376;227;149
091;003;098;015;04;369;190;179
091;003;098;015;05;368;188;180
091;003;098;016;01;312;181;131
091;003;098;016;02;312;175;137
091;003;098;016;03;310;159;151
091;003;098;017;01;297;160;137
091;003;098;018;01;318;159;159
091;003;098;019;01;304;147;157
091;003;098;019;02;304;160;144
091;003;098;019;03;304;167;137
091;003;098;020;01;192;105;87
091;003;098;021;01;360;172;188
091;003;098;021;02;360;174;186
091;003;098;021;03;354;174;180
091;003;098;022;01;264;134;130
091;003;098;022;02;263;148;115
091;003;098;023;01;448;230;218
091;003;098;023;02;448;195;253
091;003;098;023;03;448;229;219
091;003;098;023;04;448;210;238
091;003;098;023;05;440;223;217
091;003;098;024;01;69;34;35
091;003;098;025;01;136;78;58
091;003;098;026;01;259;144;115
091;003;098;027;01;182;140;42
091;003;098;028;01;76;64;12
091;003;098;029;01;43;35;8
091;003;098;030;01;141;84;57
091;003;098;031;01;255;151;104
091;003;098;032;01;69;44;25
091;003;098;033;01;111;72;39
091;003;098;034;01;81;50;31
091;004;098;001;01;316;176;140
091;004;098;002;01;160;96;64
091;004;098;003;01;326;185;141
091;004;098;004;01;272;172;100
091;004;098;004;02;269;175;94
091;004;098;005;01;141;106;35
091;004;098;006;01;360;215;145
091;004;098;006;02;352;209;143
091;004;098;007;01;415;278;137
091;004;098;008;01;183;135;48
091;004;098;009;01;384;207;177
091;004;098;009;02;377;187;190
091;004;098;010;01;312;164;148
091;004;098;010;02;306;183;123
091;004;098;010;03;304;162;142
091;004;098;011;01;288;181;107
091;004;098;012;01;352;208;144
091;004;098;012;02;345;183;162
091;004;098;013;01;232;123;109
091;004;098;013;02;230;135;95
091;004;098;014;01;347;216;131
091;004;098;014;02;344;206;138
091;004;098;015;01;236;137;99
091;004;098;015;02;232;133;99
091;004;098;016;01;256;124;132
091;004;098;016;02;256;152;104
091;004;098;017;01;305;190;115
091;004;098;017;02;304;196;108
091;004;098;018;01;363;230;133
091;004;098;019;01;240;157;83
091;004;098;019;02;235;146;89
091;004;098;020;01;76;42;34
091;004;098;021;01;122;79;43
091;004;098;022;01;117;77;40
091;004;098;023;01;75;61;14
091;004;098;024;01;84;64;20
091;004;098;025;01;301;166;135
091;005;098;001;01;328;164;164
091;005;098;001;02;322;157;165
091;005;098;002;01;301;147;154
091;005;098;003;01;202;125;77
091;005;098;004;01;144;73;71
091;005;098;005;01;293;145;148
091;005;098;005;02;288;155;133
091;005;098;006;01;48;24;24
091;005;098;007;01;241;116;125
091;005;098;008;01;220;109;111
091;005;098;009;01;339;196;143
091;005;098;010;01;235;116;119
091;005;098;011;01;256;126;130
091;005;098;011;02;253;136;117
091;005;098;012;01;271;152;119
091;005;098;013;01;195;100;95
091;005;098;014;01;98;56;42
091;005;098;015;01;329;165;164
091;005;098;016;01;129;72;57
091;006;098;001;01;158;75;83
091;006;098;002;01;167;89;78
091;006;098;003;01;152;78;74
091;006;098;004;01;116;61;55
091;006;098;005;01;153;88;65
091;006;098;006;01;114;61;53
091;006;098;007;01;239;127;112
091;006;098;007;02;232;110;122
091;006;098;008;01;137;74;63
091;006;098;009;01;145;77;68
091;006;098;010;01;205;112;93
091;006;098;011;01;179;90;89
091;006;098;012;01;304;211;93
091;006;098;013;01;220;139;81
091;006;098;014;01;321;195;126
091;006;098;015;01;256;134;122
091;006;098;016;01;410;201;209
091;006;098;016;02;408;212;196
091;006;098;017;01;65;33;32
091;006;098;018;01;352;174;178
091;006;098;018;02;352;171;181
091;006;098;018;03;345;178;167
091;006;098;018;04;344;182;162
091;006;098;019;01;178;92;86
091;006;098;020;01;194;95;99
091;006;098;021;01;82;42;40
091;006;098;022;01;252;145;107
091;006;098;023;01;335;188;147
091;006;098;025;01;120;71;49
091;006;098;026;01;66;36;30
091;006;098;027;01;104;59;45
091;006;098;028;01;100;66;34
091;006;098;029;01;56;34;22
091;007;098;001;01;447;214;233
091;007;098;002;01;352;192;160
091;007;098;002;02;348;169;179
091;007;098;003;01;351;193;158
091;007;098;004;01;321;160;161
091;007;098;004;02;320;169;151
091;007;098;005;01;240;119;121
091;007;098;006;01;358;183;175
091;007;098;006;02;352;193;159
091;007;098;006;03;352;152;200
091;007;098;007;01;162;81;81
091;007;098;008;01;167;82;85
091;007;098;009;01;276;158;118
091;007;098;010;01;194;106;88
091;007;098;011;01;130;75;55
091;007;098;012;01;156;81;75
091;007;098;013;01;212;110;102
091;007;098;014;01;94;50;44
091;007;098;015;01;110;49;61
091;007;098;016;01;101;57;44
091;007;098;017;01;101;58;43
091;007;098;018;01;406;215;191
091;007;098;019;01;151;78;73
091;007;098;020;01;220;115;105
091;007;098;021;01;320;169;151
091;007;098;021;02;318;172;146
091;007;098;022;01;158;81;77
091;007;098;023;01;67;38;29
091;008;098;001;01;369;183;186
091;008;098;002;01;383;189;194
091;008;098;003;01;355;144;211
091;008;098;003;02;352;193;159
091;008;098;004;01;341;179;162
091;008;098;005;01;250;114;136
091;008;098;005;02;248;134;114
091;008;098;006;01;372;179;193
091;008;098;006;02;368;183;185
091;008;098;006;03;368;153;215
091;008;098;007;01;266;149;117
091;008;098;007;02;264;154;110
091;008;098;008;01;369;173;196
091;008;098;009;01;132;71;61
091;008;098;010;01;206;111;95
091;008;098;011;01;109;63;46
091;008;098;012;01;232;116;116
091;008;098;012;02;226;99;127
091;008;098;013;01;316;146;170
091;008;098;013;02;312;152;160
091;008;098;014;01;281;144;137
091;008;098;014;02;280;136;144
091;008;098;015;01;271;132;139
091;008;098;015;02;264;143;121
091;008;098;016;01;133;72;61
091;008;098;017;01;188;116;72
091;008;098;019;01;66;34;32
092;003;001;001;01;424;215;209
092;003;001;001;02;418;205;213
092;003;001;002;01;419;222;197
092;003;001;002;02;416;221;195
092;003;001;002;03;416;229;187
092;003;001;003;01;368;203;165
092;003;001;003;02;368;187;181
092;003;001;003;03;368;215;153
092;003;001;003;04;368;181;187
092;003;001;003;05;361;197;164
092;003;001;004;01;350;178;172
092;003;001;005;01;278;159;119
092;003;001;006;01;360;207;153
092;003;001;006;02;355;191;164
092;003;001;006;03;352;194;158
092;003;001;007;01;347;186;161
092;003;001;008;01;410;218;192
092;003;001;008;02;408;214;194
092;003;001;009;01;219;121;98
092;003;001;010;01;403;228;175
092;003;001;011;01;231;133;98
092;003;001;012;01;344;205;139
092;003;001;012;02;336;206;130
092;003;001;013;01;296;149;147
092;003;001;013;02;293;148;145
092;003;001;014;01;73;44;29
092;003;001;015;01;132;73;59
092;003;001;016;01;99;53;46
092;003;098;001;01;190;101;89
092;003;098;002;01;336;202;134
092;003;098;002;02;332;160;172
092;003;098;003;01;401;228;173
092;004;001;001;01;392;187;205
092;004;001;001;02;389;180;209
092;004;001;001;03;384;178;206
092;004;001;001;04;384;185;199
092;004;001;002;01;256;86;170
092;004;001;002;02;253;98;155
092;004;001;003;01;416;206;210
092;004;001;003;02;416;202;214
092;004;001;003;03;416;184;232
092;004;001;003;04;409;202;207
092;004;001;003;05;408;163;245
092;004;001;003;06;408;209;199
092;004;001;003;07;408;206;202
092;004;001;004;01;408;232;176
092;004;001;004;02;408;206;202
092;004;001;004;03;408;183;225
092;004;001;004;04;408;214;194
092;004;001;004;05;408;171;237
092;004;001;004;06;408;206;202
092;004;001;005;01;392;233;159
092;004;001;005;02;392;208;184
092;004;001;005;03;392;174;218
092;004;001;005;04;388;177;211
092;004;001;005;05;384;213;171
092;004;001;006;01;383;189;194
092;004;001;006;02;376;174;202
092;004;001;006;03;376;180;196
092;004;001;006;04;376;200;176
092;004;001;006;05;376;172;204
092;004;001;006;06;376;214;162
092;004;001;007;01;432;226;206
092;004;001;007;02;432;203;229
092;004;001;007;03;426;184;242
092;004;001;007;04;424;223;201
092;004;001;007;05;424;186;238
092;004;001;007;06;424;232;192
092;004;001;008;01;424;224;200
092;004;001;008;02;424;197;227
092;004;001;008;03;424;209;215
092;004;001;008;04;424;201;223
092;004;001;008;05;422;210;212
092;004;001;010;01;432;206;226
092;004;001;010;02;432;214;218
092;004;001;010;03;432;231;201
092;004;001;010;04;432;169;263
092;004;001;010;05;425;223;202
092;004;001;011;01;440;205;235
092;004;001;011;02;440;228;212
092;004;001;011;03;440;228;212
092;004;001;011;04;440;171;269
092;004;001;011;05;440;214;226
092;004;001;011;06;440;231;209
092;004;001;011;07;440;170;270
092;004;001;011;08;436;225;211
092;004;001;011;09;432;205;227
092;004;001;012;01;432;253;179
092;004;001;012;02;432;264;168
092;004;001;012;03;432;232;200
092;004;001;012;04;432;254;178
092;004;001;012;05;428;258;170
092;004;001;012;06;424;267;157
092;004;001;012;07;424;261;163
092;004;001;014;01;392;228;164
092;004;001;014;02;392;214;178
092;004;001;014;03;392;207;185
092;004;001;014;04;389;212;177
092;004;001;015;01;361;194;167
092;004;001;015;02;360;183;177
092;004;001;015;03;360;186;174
092;004;001;015;04;360;198;162
092;004;001;016;01;432;230;202
092;004;001;016;02;432;234;198
092;004;001;016;03;432;209;223
092;004;001;016;04;432;235;197
092;004;001;016;05;432;181;251
092;004;001;016;06;432;221;211
092;004;001;016;07;427;230;197
092;004;001;017;01;392;202;190
092;004;001;017;02;392;195;197
092;004;001;017;03;392;210;182
092;004;001;017;04;392;199;193
092;004;001;017;05;388;173;215
092;004;001;017;06;384;201;183
092;004;001;017;07;384;218;166
092;004;001;018;01;392;201;191
092;004;001;018;02;392;214;178
092;004;001;018;03;392;196;196
092;004;001;018;04;387;196;191
092;004;001;018;05;384;186;198
092;004;001;018;06;384;186;198
092;004;001;018;07;384;196;188
092;004;001;019;01;280;150;130
092;004;001;019;02;275;147;128
092;004;001;020;01;416;244;172
092;004;001;020;02;416;239;177
092;004;001;020;03;416;206;210
092;004;001;020;04;410;229;181
092;004;001;020;05;408;226;182
092;004;001;020;06;408;214;194
092;004;001;020;07;408;239;169
092;004;001;021;01;304;162;142
092;004;001;021;02;303;173;130
092;004;001;022;01;248;140;108
092;004;001;022;02;243;126;117
092;004;001;023;01;376;209;167
092;004;001;023;02;371;192;179
092;004;001;023;03;368;191;177
092;004;001;024;01;378;206;172
092;004;001;024;02;376;213;163
092;004;001;024;03;376;185;191
092;004;001;024;04;376;207;169
092;004;001;025;01;384;219;165
092;004;001;025;02;384;186;198
092;004;001;025;03;380;195;185
092;004;001;025;04;376;207;169
092;004;001;026;01;449;248;201
092;004;001;026;02;448;229;219
092;004;001;026;03;448;257;191
092;004;001;026;04;448;272;176
092;004;001;027;01;212;134;78
092;004;001;028;01;368;207;161
092;004;001;028;02;366;214;152
092;004;001;028;03;360;203;157
092;004;001;029;01;415;226;189
092;004;001;030;01;312;159;153
092;004;001;030;02;312;164;148
092;004;001;030;03;310;157;153
092;004;001;031;01;327;178;149
092;004;001;031;02;320;150;170
092;004;001;032;01;352;184;168
092;004;001;032;02;352;194;158
092;004;001;032;03;346;187;159
092;004;001;033;01;313;136;177
092;004;001;033;02;312;149;163
092;004;001;034;01;336;183;153
092;004;001;034;02;328;188;140
092;004;001;035;01;241;132;109
092;004;001;035;02;240;129;111
092;004;001;036;01;382;226;156
092;004;001;036;02;376;208;168
092;004;001;037;01;408;246;162
092;004;001;037;02;408;241;167
092;004;001;037;03;408;229;179
092;004;001;037;04;407;217;190
092;004;001;037;05;400;221;179
092;004;001;038;01;288;162;126
092;004;001;038;02;286;164;122
092;004;001;039;01;328;154;174
092;004;001;039;02;322;170;152
092;004;001;040;01;384;203;181
092;004;001;040;02;384;202;182
092;004;001;040;03;384;185;199
092;004;001;040;04;384;209;175
092;004;001;040;05;380;183;197
092;004;001;040;06;376;191;185
092;004;001;041;01;366;171;195
092;004;001;041;02;360;149;211
092;004;001;041;03;360;183;177
092;004;001;042;01;440;230;210
092;004;001;042;02;437;233;204
092;004;001;043;01;369;192;177
092;004;001;044;01;352;170;182
092;004;001;045;01;143;58;85
092;004;001;046;01;148;58;90
092;004;001;047;01;336;144;192
092;004;001;048;01;240;129;111
092;004;001;049;01;217;96;121
092;004;001;050;01;128;80;48
092;004;001;051;01;90;47;43
092;004;001;052;01;110;55;55
092;004;001;053;01;136;72;64
092;004;001;054;01;429;209;220
092;004;098;001;01;280;139;141
092;004;098;001;02;276;119;157
092;004;098;002;01;228;108;120
092;004;098;003;01;368;188;180
092;004;098;003;02;364;228;136
092;004;098;003;03;360;213;147
092;004;098;004;01;258;145;113
092;004;098;005;01;77;39;38
092;004;098;006;01;336;168;168
092;004;098;006;02;336;175;161
092;004;098;006;03;334;156;178
092;004;098;007;01;333;193;140
092;004;098;008;01;328;172;156
092;004;098;008;02;322;168;154
092;004;098;009;01;225;122;103
092;004;098;010;01;352;199;153
092;004;098;010;02;344;195;149
092;004;098;011;01;368;167;201
092;004;098;011;02;368;182;186
092;004;098;011;03;360;167;193
092;004;098;012;01;424;209;215
092;004;098;012;02;416;213;203
092;004;098;012;03;416;217;199
092;004;098;013;01;114;87;27
092;004;098;014;01;337;156;181
092;004;098;015;01;104;53;51
092;006;001;001;01;416;209;207
092;006;001;001;02;416;226;190
092;006;001;001;03;410;203;207
092;006;001;001;04;408;233;175
092;006;001;001;05;408;231;177
092;006;001;001;06;408;200;208
092;006;001;001;07;408;258;150
092;006;001;001;08;408;211;197
092;006;001;001;09;408;212;196
092;006;001;002;01;151;86;65
092;006;001;003;01;289;188;101
092;006;001;003;02;288;180;108
092;006;001;004;01;432;251;181
092;006;001;004;02;425;259;166
092;006;001;005;01;352;180;172
092;006;001;005;02;352;220;132
092;006;001;005;03;350;222;128
092;006;001;006;01;380;229;151
092;006;001;007;01;237;155;82
092;006;001;008;01;256;158;98
092;006;001;008;02;250;160;90
092;006;001;009;01;264;160;104
092;006;001;009;02;260;163;97
092;006;001;010;01;276;161;115
092;006;001;011;01;392;216;176
092;006;001;012;01;284;140;144
092;006;001;012;02;280;151;129
092;006;001;013;01;371;202;169
092;006;001;013;02;368;184;184
092;006;001;014;01;238;146;92
092;006;001;015;01;174;91;83
092;006;001;016;01;319;174;145
092;006;001;018;01;370;212;158
092;006;001;019;01;304;162;142
092;006;001;020;01;90;63;27
092;006;001;021;01;427;177;250
092;006;098;001;01;389;254;135
092;006;098;002;01;238;164;74
092;006;098;003;01;359;244;115
092;006;098;004;01;285;212;73
092;006;098;005;01;132;85;47
092;007;098;001;01;179;104;75
092;007;098;002;01;424;227;197
092;007;098;002;02;416;229;187
092;007;098;003;01;264;145;119
092;007;098;003;02;258;147;111
092;007;098;004;01;308;193;115
092;007;098;005;01;431;239;192
092;007;098;006;01;285;162;123
092;007;098;007;01;384;202;182
092;007;098;007;02;384;170;214
092;007;098;007;03;383;219;164
092;007;098;008;01;206;122;84
092;007;098;009;01;226;132;94
092;007;098;010;01;427;230;197
092;007;098;011;01;229;160;69
092;007;098;013;01;61;38;23
092;007;098;014;01;78;54;24
092;008;098;001;01;129;80;49
092;008;098;002;01;380;195;185
092;008;098;002;02;376;182;194
092;008;098;003;01;290;118;172
092;008;098;004;01;189;86;103
092;009;098;001;01;260;134;126
092;009;098;001;02;256;153;103
092;009;098;002;01;266;146;120
092;009;098;003;01;344;173;171
092;009;098;003;02;342;190;152
092;009;098;003;03;336;188;148
092;009;098;004;01;243;133;110
092;009;098;005;01;240;135;105
092;009;098;005;02;232;147;85
092;009;098;006;01;227;122;105
092;009;098;007;01;285;154;131
092;009;098;008;01;231;122;109
092;009;098;009;01;211;125;86
092;009;098;010;01;182;110;72
092;009;098;011;01;389;221;168
092;009;098;011;02;384;227;157
092;009;098;012;01;312;147;165
092;009;098;012;02;304;164;140
092;009;098;013;01;240;133;107
092;009;098;013;02;237;144;93
092;009;098;014;01;157;86;71
092;010;098;001;01;435;239;196
092;010;098;002;01;316;178;138
092;010;098;002;02;312;167;145
092;010;098;003;01;328;158;170
092;010;098;003;02;328;164;164
092;010;098;003;03;321;165;156
092;010;098;004;01;329;194;135
092;010;098;005;01;306;171;135
092;010;098;006;01;167;107;60
092;010;098;007;01;352;196;156
092;010;098;007;02;352;187;165
092;010;098;007;03;347;173;174
092;010;098;008;01;174;102;72
092;010;098;009;01;124;60;64
092;010;098;010;01;360;193;167
092;010;098;010;02;355;189;166
092;010;098;010;03;352;182;170
092;010;098;011;01;224;123;101
092;010;098;012;01;290;155;135
092;010;098;013;01;115;78;37
092;010;098;014;01;145;94;51
092;011;098;001;01;251;130;121
092;011;098;002;01;312;159;153
092;011;098;002;02;305;158;147
092;011;098;003;01;405;212;193
092;011;098;004;01;350;192;158
092;011;098;005;01;363;191;172
092;011;098;006;01;360;178;182
092;011;098;006;02;356;186;170
092;011;098;007;01;211;112;99
092;011;098;008;01;85;47;38
092;012;098;001;01;392;219;173
092;012;098;001;02;392;233;159
092;012;098;001;03;391;212;179
092;012;098;001;04;384;210;174
092;012;098;002;01;288;167;121
092;012;098;003;01;68;42;26
092;012;098;004;01;60;40;20
092;012;098;005;01;57;37;20
092;013;098;001;01;253;112;141
092;013;098;001;02;248;123;125
092;013;098;002;01;268;119;149
092;013;098;002;02;264;130;134
092;013;098;003;01;304;151;153
092;013;098;004;01;352;172;180
092;013;098;004;02;346;159;187
092;013;098;005;01;252;138;114
092;014;098;001;01;230;128;102
092;014;098;002;01;438;269;169
092;014;098;003;01;303;166;137
092;014;098;004;01;368;220;148
092;014;098;004;02;368;209;159
092;014;098;004;03;360;210;150
092;014;098;005;01;104;59;45
092;014;098;006;01;245;141;104
092;014;098;006;02;240;130;110
093;001;001;001;01;247;122;125
093;001;001;001;02;240;126;114
093;001;001;002;01;349;175;174
093;001;001;002;02;344;167;177
093;001;001;002;03;344;172;172
093;001;001;002;04;344;163;181
093;001;001;003;01;315;161;154
093;001;001;003;02;312;152;160
093;001;001;004;01;328;153;175
093;001;001;004;02;326;154;172
093;001;001;004;03;320;150;170
093;001;001;005;01;324;152;172
093;001;001;006;01;168;91;77
093;001;001;007;01;181;83;98
093;001;001;008;01;273;140;133
093;001;001;009;01;417;207;210
093;001;001;010;01;237;125;112
093;001;001;010;02;232;128;104
093;001;001;011;01;443;221;222
093;001;001;012;01;158;91;67
093;001;001;013;01;278;154;124
093;001;001;014;01;338;174;164
093;001;001;015;01;352;183;169
093;001;001;015;02;349;172;177
093;001;001;016;01;294;165;129
093;001;001;017;01;132;69;63
093;001;001;018;01;292;148;144
093;001;001;019;01;315;153;162
093;001;001;020;01;425;221;204
093;001;001;021;01;221;110;111
093;001;001;022;01;218;95;123
093;001;001;023;01;89;44;45
093;004;001;001;01;352;189;163
093;004;001;001;02;348;194;154
093;004;001;002;01;450;211;239
093;004;001;002;02;450;211;239
093;004;001;002;03;450;207;243
093;004;001;002;04;450;223;227
093;004;001;002;05;450;229;221
093;004;001;002;06;450;217;233
093;004;001;002;07;450;221;229
093;004;001;002;08;450;224;226
093;004;001;002;09;448;232;216
093;004;001;003;01;416;228;188
093;004;001;003;02;416;215;201
093;004;001;003;03;411;233;178
093;004;001;004;01;432;218;214
093;004;001;004;02;432;231;201
093;004;001;004;03;424;225;199
093;004;001;004;04;424;213;211
093;004;001;005;01;150;94;56
093;004;001;006;01;284;149;135
093;004;001;007;01;340;168;172
093;004;001;008;01;250;126;124
093;004;001;008;02;248;133;115
093;004;001;009;01;315;157;158
093;004;001;010;01;437;233;204
093;004;001;010;02;432;219;213
093;004;001;010;03;432;213;219
093;004;001;011;01;356;189;167
093;004;001;011;02;352;177;175
093;004;001;012;01;388;199;189
093;004;001;012;02;384;205;179
093;004;001;012;03;384;218;166
093;004;001;012;04;384;208;176
093;004;001;013;01;213;104;109
093;004;001;014;01;189;102;87
093;004;001;015;01;418;232;186
093;004;001;016;01;316;167;149
093;004;001;017;01;404;211;193
093;004;001;017;02;400;205;195
093;004;001;018;01;259;142;117
093;004;001;019;01;415;205;210
093;004;001;019;02;408;194;214
093;004;001;020;01;440;218;222
093;004;001;020;02;440;203;237
093;004;001;021;01;338;186;152
093;004;001;021;02;336;183;153
093;004;001;022;01;347;164;183
093;004;001;023;01;124;58;66
093;004;001;024;01;377;199;178
093;004;001;025;01;352;197;155
093;004;001;025;02;352;177;175
093;004;001;026;01;403;218;185
093;004;001;026;02;400;196;204
093;004;001;028;01;256;147;109
093;004;001;029;01;148;81;67
093;004;001;030;01;123;58;65
093;004;001;031;01;184;109;75
093;004;001;032;01;153;81;72
093;004;001;033;01;122;57;65
093;004;001;035;01;84;48;36
093;004;098;001;01;264;151;113
093;004;098;002;01;408;213;195
093;004;098;002;02;402;204;198
093;004;098;003;01;401;233;168
093;004;098;003;02;400;217;183
093;004;098;003;03;400;201;199
093;004;098;004;01;288;164;124
093;004;098;004;02;284;151;133
093;004;098;005;01;336;154;182
093;004;098;005;02;336;177;159
093;004;098;006;01;172;92;80
093;004;098;007;01;118;70;48
093;004;098;008;01;312;167;145
093;004;098;009;01;91;52;39
093;004;098;010;01;76;38;38
093;004;098;011;01;119;65;54
093;004;098;012;01;218;117;101
093;004;098;013;01;296;146;150
093;004;098;014;01;158;68;90
093;004;098;015;01;445;246;199
093;004;098;016;01;338;203;135
093;004;098;017;01;96;54;42
093;004;098;018;01;108;69;39
093;004;098;019;01;80;40;40
093;005;098;001;01;296;153;143
093;005;098;001;02;294;145;149
093;005;098;002;01;437;212;225
093;005;098;003;01;264;125;139
093;005;098;003;02;261;139;122
093;005;098;004;01;349;188;161
093;005;098;005;01;312;143;169
093;005;098;005;02;308;150;158
093;005;098;006;01;345;177;168
093;005;098;007;01;416;217;199
093;005;098;007;02;412;203;209
093;005;098;007;03;408;216;192
093;005;098;008;01;291;148;143
093;005;098;008;02;288;129;159
093;005;098;009;01;383;207;176
093;005;098;010;01;165;91;74
093;005;098;011;01;168;96;72
093;005;098;012;01;124;58;66
093;005;098;013;01;19;12;7
093;006;098;001;01;250;115;135
093;006;098;002;01;212;94;118
093;006;098;003;01;360;187;173
093;006;098;003;02;357;183;174
093;006;098;004;01;146;68;78
093;006;098;005;01;414;207;207
093;006;098;006;01;242;115;127
093;006;098;007;01;254;132;122
093;006;098;008;01;114;60;54
093;006;098;009;01;332;152;180
093;006;098;010;01;258;136;122
093;006;098;011;01;221;119;102
093;006;098;012;01;406;213;193
093;006;098;012;02;400;201;199
093;006;098;013;01;176;79;97
093;006;098;014;01;410;207;203
093;006;098;015;01;224;118;106
093;006;098;016;01;130;74;56
093;006;098;017;01;349;179;170
093;006;098;018;01;87;41;46
093;006;098;019;01;61;30;31
093;006;098;020;01;147;75;72
093;006;098;021;01;47;24;23
093;006;098;022;01;118;54;64
093;006;098;023;01;67;37;30
093;006;098;024;01;289;145;144
093;006;098;025;01;165;80;85
093;007;098;001;01;256;130;126
093;007;098;001;02;248;140;108
093;007;098;002;01;258;136;122
093;007;098;003;01;250;116;134
093;007;098;003;02;248;125;123
093;007;098;004;01;306;144;162
093;007;098;005;01;288;140;148
093;007;098;006;01;291;124;167
093;007;098;006;02;288;137;151
093;007;098;007;01;279;142;137
093;007;098;008;01;228;121;107
093;007;098;008;02;224;96;128
093;007;098;009;01;320;159;161
093;007;098;009;02;320;154;166
093;007;098;009;03;320;155;165
093;007;098;010;01;440;246;194
093;007;098;010;02;434;238;196
093;007;098;011;01;398;227;171
093;007;098;012;01;283;141;142
093;007;098;013;01;272;140;132
093;007;098;013;02;265;147;118
093;007;098;014;01;325;157;168
093;007;098;014;02;320;163;157
093;007;098;015;01;253;130;123
093;007;098;015;02;248;129;119
093;007;098;016;01;239;121;118
093;007;098;017;01;222;111;111
093;007;098;018;01;264;137;127
093;007;098;018;02;256;135;121
093;007;098;019;01;298;154;144
093;007;098;019;02;296;152;144
093;007;098;020;01;432;209;223
093;007;098;020;02;432;221;211
093;007;098;021;01;177;88;89
093;007;098;022;01;121;58;63
093;007;098;023;01;424;219;205
093;007;098;023;02;420;190;230
093;007;098;023;03;416;208;208
093;007;098;023;04;416;182;234
093;007;098;023;05;416;237;179
093;007;098;026;01;116;63;53
093;007;098;027;01;179;120;59
093;007;098;028;01;62;38;24
093;007;098;029;01;73;41;32
093;007;098;030;01;127;66;61
093;008;098;001;01;299;145;154
093;008;098;002;01;362;200;162
093;008;098;003;01;400;217;183
093;008;098;003;02;400;193;207
093;008;098;003;03;400;186;214
093;008;098;004;01;301;156;145
093;008;098;004;02;296;163;133
093;008;098;005;01;222;120;102
093;008;098;006;01;140;71;69
093;008;098;007;01;341;178;163
093;008;098;008;01;404;203;201
093;008;098;009;01;141;80;61
094;001;001;001;01;408;195;213
094;001;001;001;02;408;206;202
094;001;001;001;03;400;195;205
094;001;001;002;01;400;196;204
094;001;001;002;02;393;206;187
094;001;001;002;03;392;199;193
094;001;001;003;01;378;179;199
094;001;001;004;01;237;129;108
094;001;001;004;02;232;133;99
094;001;001;005;01;228;121;107
094;001;001;005;02;224;121;103
094;001;001;006;01;282;153;129
094;001;001;006;02;280;162;118
094;001;001;007;01;237;115;122
094;001;001;007;02;232;130;102
094;001;001;008;01;101;65;36
094;001;098;001;01;246;122;124
094;001;098;002;01;233;136;97
094;001;098;003;01;250;133;117
094;001;098;003;02;248;128;120
094;001;098;004;01;99;45;54
094;001;098;005;01;254;154;100
094;001;098;005;02;248;157;91
094;001;098;006;01;297;151;146
094;001;098;007;01;294;160;134
094;001;098;007;02;288;139;149
094;003;001;001;01;424;238;186
094;003;001;001;02;424;233;191
094;003;001;001;03;419;198;221
094;003;001;002;01;411;211;200
094;003;001;002;02;408;193;215
094;003;001;002;03;408;187;221
094;003;001;003;01;410;204;206
094;003;001;004;01;412;212;200
094;003;001;005;01;240;134;106
094;003;001;005;02;237;110;127
094;003;001;006;01;232;118;114
094;003;001;006;02;232;136;96
094;003;001;007;01;448;236;212
094;003;001;007;02;442;202;240
094;003;001;008;01;355;175;180
094;003;001;009;01;296;174;122
094;003;001;010;01;346;184;162
094;003;001;011;01;332;213;119
094;003;001;012;01;312;171;141
094;003;001;012;02;308;153;155
094;003;001;012;03;304;174;130
094;003;001;013;01;356;182;174
094;003;001;014;01;95;60;35
094;003;098;001;01;333;167;166
094;003;098;001;02;328;187;141
094;003;098;001;03;328;187;141
094;003;098;002;01;248;122;126
094;003;098;002;02;247;133;114
094;003;098;003;01;240;121;119
094;003;098;003;02;236;113;123
094;003;098;004;01;368;188;180
094;003;098;004;02;364;208;156
094;003;098;005;01;384;202;182
094;003;098;005;02;384;186;198
094;003;098;005;03;381;214;167
094;003;098;006;01;247;133;114
094;003;098;007;01;276;160;116
094;003;098;007;02;272;146;126
094;003;098;008;01;175;103;72
094;003;098;009;01;205;127;78
094;003;098;010;01;276;165;111
094;005;001;001;01;424;219;205
094;005;001;001;02;424;203;221
094;005;001;001;03;418;190;228
094;005;001;001;04;416;239;177
094;005;001;003;01;288;152;136
094;005;001;003;02;284;147;137
094;005;001;004;01;276;133;143
094;005;001;004;02;272;146;126
094;005;001;005;01;265;129;136
094;005;001;006;01;102;57;45
094;005;001;007;01;344;183;161
094;005;001;007;02;336;171;165
094;005;098;001;01;304;142;162
094;005;098;001;02;303;160;143
094;005;098;002;01;346;194;152
094;005;098;003;01;346;160;186
094;005;098;003;02;344;152;192
094;005;098;004;01;347;187;160
094;005;098;005;01;307;141;166
094;005;098;005;02;304;155;149
094;005;098;005;03;304;135;169
094;006;098;001;01;227;138;89
094;006;098;002;01;428;278;150
094;006;098;003;01;291;160;131
094;006;098;004;01;406;230;176
094;006;098;004;02;400;190;210
094;006;098;005;01;382;204;178
094;006;098;006;01;417;249;168
094;006;098;006;02;416;235;181
094;006;098;007;01;360;171;189
094;006;098;007;02;360;160;200
094;006;098;007;03;360;216;144
094;006;098;008;01;294;162;132
094;006;098;008;02;288;166;122
094;006;098;009;01;240;130;110
094;006;098;009;02;238;132;106
094;006;098;010;01;274;156;118
094;006;098;011;01;408;191;217
094;006;098;011;02;408;205;203
094;006;098;012;01;140;94;46
095;002;001;001;01;449;210;239
095;002;001;001;02;448;204;244
095;002;001;001;03;448;257;191
095;002;001;001;04;448;232;216
095;002;001;003;01;248;131;117
095;002;001;004;01;228;109;119
095;002;001;004;02;224;112;112
095;002;001;005;01;246;129;117
095;002;001;006;01;301;160;141
095;002;001;007;01;135;60;75
095;002;001;008;01;299;150;149
095;002;098;001;01;64;26;38
095;002;098;002;01;378;190;188
095;002;098;004;01;118;66;52
095;004;001;001;01;360;141;219
095;004;001;001;02;355;172;183
095;004;001;001;03;352;180;172
095;004;001;001;04;352;187;165
095;004;001;002;01;160;87;73
095;004;001;003;01;439;209;230
095;004;001;004;01;354;181;173
095;004;001;005;01;336;175;161
095;004;001;006;01;211;123;88
095;004;001;007;01;233;117;116
095;004;001;008;01;178;89;89
095;004;001;009;01;101;59;42
095;004;001;010;01;57;34;23
095;004;098;001;01;190;105;85
095;004;098;002;01;312;159;153
095;004;098;002;02;307;157;150
095;004;098;003;01;296;145;151
095;004;098;003;02;288;136;152
095;004;098;004;01;327;155;172
095;004;098;005;01;268;145;123
095;004;098;005;02;264;111;153
095;004;098;006;01;204;105;99
095;004;098;007;01;242;124;118
095;004;098;008;01;232;102;130
095;004;098;008;02;224;131;93
095;004;098;009;01;190;97;93
095;004;098;010;01;413;193;220
095;004;098;011;01;354;181;173
095;004;098;012;01;275;122;153
095;004;098;013;01;190;85;105
095;004;098;014;01;131;63;68
095;004;098;015;01;341;173;168
095;004;098;016;01;259;147;112
095;004;098;017;01;47;33;14
095;006;001;001;01;355;192;163
095;006;001;001;02;352;200;152
095;006;001;001;03;352;212;140
095;006;001;001;04;352;208;144
095;006;001;002;01;377;224;153
095;006;001;002;02;376;204;172
095;006;001;002;03;376;216;160
095;006;001;002;04;376;218;158
095;006;001;003;01;389;216;173
095;006;001;003;02;384;202;182
095;006;001;003;03;384;204;180
095;006;001;003;04;384;207;177
095;006;001;004;01;328;176;152
095;006;001;004;02;328;183;145
095;006;001;004;03;328;190;138
095;006;001;005;01;411;240;171
095;006;001;005;02;408;189;219
095;006;001;005;03;408;205;203
095;006;001;006;01;344;184;160
095;006;001;006;02;344;176;168
095;006;001;006;03;341;148;193
095;006;001;006;04;336;147;189
095;006;001;007;01;376;171;205
095;006;001;007;02;376;163;213
095;006;001;007;03;376;152;224
095;006;001;007;04;368;184;184
095;006;001;008;01;408;199;209
095;006;001;008;02;408;233;175
095;006;001;008;03;408;199;209
095;006;001;008;04;403;233;170
095;006;001;008;05;400;202;198
095;006;001;008;06;400;191;209
095;006;001;008;07;400;218;182
095;006;001;009;01;392;198;194
095;006;001;009;02;392;186;206
095;006;001;009;03;392;182;210
095;006;001;009;04;386;192;194
095;006;001;009;05;384;190;194
095;006;001;010;01;432;216;216
095;006;001;010;02;430;222;208
095;006;001;010;03;424;220;204
095;006;001;010;04;424;211;213
095;006;001;010;05;424;219;205
095;006;001;010;06;424;233;191
095;006;001;011;01;424;250;174
095;006;001;012;01;328;183;145
095;006;001;012;02;324;180;144
095;006;001;013;01;352;197;155
095;006;001;013;02;349;176;173
095;006;001;013;03;344;178;166
095;006;001;013;04;344;149;195
095;006;001;014;01;232;121;111
095;006;001;014;02;225;111;114
095;006;001;015;01;211;119;92
095;006;001;016;01;155;78;77
095;006;098;001;01;158;78;80
095;006;098;002;01;185;84;101
095;006;098;003;01;212;105;107
095;006;098;004;01;433;188;245
095;006;098;005;01;276;121;155
095;006;098;006;01;327;161;166
095;006;098;007;01;368;180;188
095;006;098;007;02;368;178;190
095;006;098;007;03;368;163;205
095;006;098;007;04;364;193;171
095;006;098;008;01;280;136;144
095;006;098;008;02;279;129;150
095;006;098;009;01;325;134;191
095;006;098;010;01;144;65;79
095;006;098;011;01;335;193;142
095;006;098;011;02;328;126;202
095;006;098;012;01;280;151;129
095;006;098;012;02;273;139;134
095;006;098;013;01;92;46;46
095;006;098;014;01;174;92;82
095;006;098;015;01;362;186;176
095;006;098;015;02;360;120;240
095;006;098;016;01;158;78;80
095;006;098;017;01;248;107;141
095;006;098;017;02;243;119;124
095;006;098;018;01;359;184;175
095;006;098;019;01;328;149;179
095;006;098;020;01;219;98;121
095;006;098;021;01;154;77;77
095;006;098;022;01;286;140;146
095;006;098;023;01;274;174;100
095;006;098;024;01;247;105;142
095;006;098;025;01;145;72;73
095;006;098;026;01;67;31;36
095;006;098;027;01;154;82;72
095;007;001;001;01;332;159;173
095;007;001;001;02;328;174;154
095;007;001;002;01;320;153;167
095;007;001;002;02;320;170;150
095;007;001;003;01;243;113;130
095;007;001;003;02;240;128;112
095;007;001;004;01;393;174;219
095;007;001;004;02;392;205;187
095;007;001;005;01;368;166;202
095;007;001;005;02;366;144;222
095;007;001;006;01;168;100;68
095;007;001;007;01;332;143;189
095;007;001;008;01;194;101;93
095;007;001;009;01;227;106;121
095;007;001;010;01;226;116;110
095;007;001;011;01;380;208;172
095;007;001;012;01;308;162;146
095;007;001;013;01;79;43;36
095;007;001;014;01;295;160;135
095;007;001;015;01;110;67;43
095;007;001;017;01;185;88;97
095;007;001;018;01;155;96;59
095;007;001;019;01;69;46;23
095;007;098;002;01;83;39;44
095;007;098;003;01;127;74;53
095;007;098;004;01;247;138;109
095;007;098;005;01;85;57;28
095;008;001;001;01;421;232;189
095;008;001;001;02;416;217;199
095;008;001;001;03;416;232;184
095;008;001;002;01;152;70;82
095;008;001;003;01;175;87;88
095;008;001;004;01;114;61;53
095;008;001;005;01;244;122;122
095;008;001;006;01;297;153;144
095;008;001;007;01;351;154;197
095;008;001;007;02;344;195;149
095;008;001;008;01;220;110;110
095;008;098;001;01;342;178;164
095;008;098;002;01;318;175;143
095;008;098;003;01;299;150;149
095;008;098;003;02;296;154;142
095;008;098;004;01;278;154;124
095;008;098;004;02;272;108;164
095;008;098;005;01;432;200;232
095;008;098;005;02;429;213;216
095;008;098;006;01;351;156;195
095;008;098;007;01;325;160;165
095;008;098;008;01;329;166;163
095;008;098;009;01;247;139;108
095;008;098;010;01;272;128;144
095;008;098;010;02;264;149;115
095;008;098;011;01;344;184;160
095;008;098;011;02;338;186;152
095;008;098;012;01;331;175;156
095;008;098;013;01;333;210;123
095;008;098;014;01;178;99;79
095;008;098;015;01;264;142;122
095;008;098;015;02;262;174;88
095;008;098;016;01;134;93;41
095;008;098;017;01;235;118;117
095;008;098;018;01;154;84;70
095;008;098;019;01;101;49;52
095;009;098;003;01;187;111;76
095;009;098;006;01;269;150;119
095;009;098;006;02;264;134;130
095;009;098;007;01;424;182;242
095;009;098;007;02;416;213;203
095;009;098;007;03;416;216;200
095;009;098;010;01;377;172;205
095;009;098;010;02;376;182;194
095;009;098;011;01;189;99;90
095;009;098;012;01;43;23;20
095;010;098;001;01;301;164;137
095;010;098;002;01;443;234;209
095;010;098;003;01;397;187;210
095;010;098;004;01;222;109;113
095;010;098;005;01;130;55;75
095;010;098;006;01;370;181;189
095;010;098;007;01;124;60;64
095;010;098;008;01;437;247;190
095;010;098;009;01;99;51;48
095;010;098;012;01;256;123;133
095;010;098;012;02;249;142;107
095;011;098;001;01;297;159;138
095;011;098;002;01;247;142;105
095;011;098;002;02;240;121;119
095;011;098;003;01;381;202;179
095;011;098;004;01;198;114;84
095;011;098;005;01;400;169;231
095;011;098;005;02;400;203;197
095;011;098;005;03;400;218;182
095;011;098;005;04;397;223;174
095;011;098;009;01;399;236;163
095;011;098;013;01;232;126;106
095;011;098;013;02;225;121;104
095;011;098;014;01;347;189;158
095;011;098;014;02;344;199;145
095;011;098;015;01;170;88;82
096;001;098;001;01;144;80;64
096;001;098;003;01;232;120;112
096;001;098;003;02;226;110;116
096;001;098;004;01;256;127;129
096;001;098;004;02;256;138;118
096;001;098;005;01;187;97;90
096;001;098;006;01;375;194;181
096;001;098;008;01;360;174;186
096;001;098;008;02;360;192;168
096;001;098;008;03;356;196;160
096;001;098;009;01;102;61;41
096;002;001;001;01;368;178;190
096;002;001;001;02;367;186;181
096;002;001;002;01;448;215;233
096;002;001;003;01;376;203;173
096;002;001;003;02;376;201;175
096;002;001;003;03;376;211;165
096;002;001;003;04;373;218;155
096;002;001;004;01;406;207;199
096;002;001;004;02;400;208;192
096;002;001;005;01;304;158;146
096;002;001;005;02;297;135;162
096;002;001;006;01;320;166;154
096;002;001;007;01;279;142;137
096;002;001;007;02;272;133;139
096;002;001;008;01;410;197;213
096;002;001;008;02;408;210;198
096;002;001;009;01;248;127;121
096;002;001;010;01;110;61;49
096;002;001;011;01;122;63;59
096;002;001;012;01;124;68;56
096;002;001;013;01;138;67;71
096;002;098;001;01;425;219;206
096;002;098;002;01;245;117;128
096;002;098;002;02;240;126;114
096;002;098;003;01;323;152;171
096;002;098;003;02;320;169;151
096;002;098;004;01;230;110;120
096;002;098;010;01;213;120;93
097;003;001;001;01;408;224;184
097;003;001;001;02;405;233;172
097;003;001;001;03;400;213;187
097;003;001;002;01;232;104;128
097;003;001;002;02;224;92;132
097;003;001;003;01;232;138;94
097;003;001;003;02;232;134;98
097;003;001;004;01;303;134;169
097;003;001;005;01;408;240;168
097;003;001;005;02;408;244;164
097;003;001;005;03;408;190;218
097;003;001;006;01;306;167;139
097;003;001;006;02;304;141;163
097;003;001;007;01;114;59;55
097;003;001;008;01;136;65;71
097;003;001;009;01;94;44;50
097;003;001;010;01;163;102;61
097;003;001;011;01;87;47;40
097;003;098;001;01;97;60;37
097;003;098;002;01;193;103;90
097;003;098;003;01;399;204;195
097;003;098;004;01;161;76;85
097;003;098;005;01;329;175;154
097;003;098;006;01;436;205;231
097;003;098;007;01;163;79;84
097;003;098;008;01;62;34;28
097;003;098;009;01;94;53;41
097;003;098;010;01;361;176;185
097;003;098;017;01;139;72;67
097;003;098;018;01;155;85;70
097;003;098;019;01;164;71;93
097;003;098;020;01;135;72;63
097;003;098;021;01;133;85;48
097;003;098;022;01;77;49;28
097;005;098;001;01;352;207;145
097;005;098;001;02;348;169;179
097;005;098;002;01;408;308;100
097;005;098;002;02;405;148;257
097;005;098;003;01;108;59;49
097;005;098;004;01;229;105;124
097;005;098;004;02;224;110;114
097;005;098;005;01;260;140;120
097;005;098;006;01;273;158;115
097;005;098;006;02;272;133;139
097;005;098;007;01;364;190;174
097;005;098;008;01;353;179;174
097;005;098;009;01;116;53;63
097;005;098;010;01;151;84;67
097;005;098;011;01;178;91;87
097;005;098;012;01;153;75;78
097;005;098;013;01;312;136;176
097;005;098;013;02;305;151;154
097;005;098;014;01;248;124;124
097;005;098;014;02;241;111;130
097;005;098;015;01;336;161;175
097;005;098;015;02;328;171;157
097;005;098;016;01;32;22;10
097;005;098;017;01;124;60;64
097;006;098;001;01;285;156;129
097;006;098;002;01;251;142;109
097;006;098;003;01;336;220;116
097;006;098;003;02;333;147;186
097;006;098;004;01;349;241;108
097;006;098;004;02;344;152;192
097;006;098;005;01;328;158;170
097;006;098;006;01;256;150;106
097;006;098;007;01;335;171;164
097;006;098;008;01;118;77;41
097;006;098;009;01;256;117;139
097;006;098;009;02;251;123;128
097;006;098;010;01;267;144;123
097;006;098;011;01;256;148;108
097;006;098;012;01;114;60;54
097;006;098;013;01;248;119;129
097;006;098;013;02;248;137;111
097;006;098;014;01;317;180;137
097;006;098;015;01;328;180;148
097;006;098;016;01;131;69;62
097;006;098;017;01;193;104;89
097;006;098;018;01;164;93;71
097;006;098;019;01;34;19;15
097;006;098;020;01;225;115;110
097;006;098;021;01;154;83;71
097;006;098;022;01;89;43;46
097;007;098;001;01;416;237;179
097;007;098;001;02;416;208;208
097;007;098;002;01;304;166;138
097;007;098;002;02;302;134;168
097;007;098;002;03;296;163;133
097;007;098;003;01;272;137;135
097;007;098;003;02;268;140;128
097;007;098;004;01;297;139;158
097;007;098;005;01;365;188;177
097;007;098;006;01;372;195;177
097;007;098;007;01;419;224;195
097;007;098;008;01;233;110;123
097;007;098;009;01;232;109;123
097;007;098;010;01;103;64;39
097;007;098;011;01;105;57;48
097;007;098;012;01;312;190;122
097;007;098;013;01;165;99;66
097;007;098;014;01;282;141;141
097;007;098;015;01;95;51;44
098;002;001;001;01;374;123;251
098;002;001;001;02;368;182;186
098;002;001;001;03;368;158;210
098;002;001;001;04;368;171;197
098;002;001;001;05;368;180;188
098;002;001;002;01;384;169;215
098;002;001;002;02;382;140;242
098;002;001;002;03;376;173;203
098;002;001;002;04;376;180;196
098;002;001;002;05;376;174;202
098;002;001;003;01;358;173;185
098;002;001;003;02;352;196;156
098;002;001;004;01;247;100;147
098;002;001;004;02;240;100;140
098;002;001;005;01;280;110;170
098;002;001;005;02;277;137;140
098;002;001;006;01;136;55;81
098;002;001;007;01;304;108;196
098;002;001;007;02;302;107;195
098;002;001;007;03;296;137;159
098;002;001;008;01;257;114;143
098;002;001;009;01;387;151;236
098;002;001;010;01;338;122;216
098;002;001;011;01;287;119;168
098;002;001;011;02;280;132;148
098;002;098;001;01;227;106;121
098;002;098;002;01;260;112;148
098;002;098;003;01;247;81;166
098;002;098;005;01;321;121;200
098;002;098;006;01;180;73;107
098;002;098;007;01;245;105;140
098;002;098;008;01;188;75;113
098;002;098;009;01;360;132;228
098;002;098;009;02;359;148;211
098;002;098;010;01;242;116;126
098;002;098;011;01;65;29;36
098;003;098;001;01;184;78;106
098;003;098;002;01;320;130;190
098;003;098;003;01;393;165;228
098;003;098;004;01;157;66;91
098;003;098;005;01;349;156;193
098;003;098;006;01;349;163;186
098;003;098;007;01;171;69;102
098;003;098;008;01;265;108;157
098;003;098;009;01;102;47;55
098;003;098;010;01;268;102;166
099;003;001;001;01;416;234;182
099;003;001;001;02;416;222;194
099;003;001;001;03;416;211;205
099;003;001;001;04;416;226;190
099;003;001;001;05;411;232;179
099;003;001;001;06;408;229;179
099;003;001;001;07;408;243;165
099;003;001;002;01;368;193;175
099;003;001;002;02;368;194;174
099;003;001;002;03;364;180;184
099;003;001;002;04;360;192;168
099;003;001;003;01;432;217;215
099;003;001;003;02;432;221;211
099;003;001;003;03;432;240;192
099;003;001;003;04;432;222;210
099;003;001;003;05;432;268;164
099;003;001;003;06;424;235;189
099;003;001;004;01;376;207;169
099;003;001;004;02;368;200;168
099;003;001;004;03;368;208;160
099;003;001;004;04;368;224;144
099;003;001;004;05;368;221;147
099;003;001;005;01;120;70;50
099;003;001;006;01;350;188;162
099;003;001;006;02;344;201;143
099;003;001;007;01;368;194;174
099;003;001;008;01;376;168;208
099;003;001;008;02;369;211;158
099;003;001;009;01;212;111;101
099;003;001;010;01;203;115;88
099;003;001;011;01;336;173;163
099;003;001;011;02;328;189;139
099;003;001;012;01;305;166;139
099;003;001;012;02;304;160;144
099;003;001;013;01;110;50;60
099;003;001;014;01;111;58;53
099;003;001;015;01;135;78;57
099;003;001;016;01;241;130;111
099;003;001;017;01;131;76;55
099;003;001;018;01;206;117;89
099;003;001;019;01;141;79;62
099;003;001;020;01;385;210;175
099;003;001;022;01;360;191;169
099;003;001;024;01;123;84;39
099;003;001;025;01;417;211;206
099;003;001;025;02;416;199;217
099;003;001;025;03;416;191;225
099;003;001;025;04;416;211;205
099;003;001;026;01;368;187;181
099;003;001;026;02;363;196;167
099;003;001;026;03;360;198;162
099;003;001;026;04;360;207;153
099;003;001;027;01;376;206;170
099;003;001;027;02;373;191;182
099;003;001;027;03;368;219;149
099;003;001;027;04;368;190;178
099;003;001;028;01;408;205;203
099;003;001;028;02;408;220;188
099;003;001;028;03;408;204;204
099;003;001;028;04;401;234;167
099;003;001;028;05;400;230;170
099;003;001;028;06;400;230;170
099;003;001;029;01;125;76;49
099;003;001;030;01;230;132;98
099;003;001;031;01;344;163;181
099;003;001;031;02;344;170;174
099;003;001;032;01;152;86;66
099;003;001;033;01;419;225;194
099;003;001;033;02;416;216;200
099;003;001;034;01;183;116;67
099;003;001;037;01;64;36;28
099;003;001;038;01;81;50;31
099;003;001;039;01;132;49;83
099;003;001;040;01;164;94;70
099;003;001;041;01;308;170;138
099;003;001;042;01;240;135;105
099;003;001;044;01;119;65;54
099;003;098;001;01;168;98;70
099;003;098;002;01;274;146;128
099;003;098;003;01;101;63;38
099;003;098;004;01;182;101;81
099;003;098;005;01;77;44;33
099;003;098;006;01;375;201;174
099;003;098;006;02;368;207;161
099;003;098;006;03;368;216;152
099;003;098;007;01;174;94;80
099;003;098;008;01;292;177;115
099;003;098;009;01;397;205;192
099;003;098;009;02;392;202;190
099;003;098;010;01;421;238;183
099;003;098;011;01;190;105;85
099;003;098;012;01;240;142;98
099;003;098;013;01;181;109;72
099;003;098;014;01;173;111;62
099;003;098;015;01;219;116;103
099;003;098;016;01;78;51;27
099;003;098;029;01;173;96;77
099;007;098;001;01;237;131;106
099;007;098;002;01;116;63;53
099;007;098;003;01;194;107;87
099;007;098;004;01;296;142;154
099;007;098;004;02;292;158;134
099;007;098;005;01;139;84;55
099;007;098;006;01;404;229;175
099;007;098;006;02;400;227;173
099;007;098;007;01;185;112;73
099;007;098;008;01;182;113;69
099;007;098;009;01;231;119;112
099;007;098;010;01;270;156;114
099;007;098;011;01;246;136;110
099;007;098;012;01;176;106;70
099;007;098;013;01;445;245;200
099;007;098;014;01;247;128;119
099;007;098;014;02;240;140;100
099;007;098;015;01;190;93;97
099;007;098;018;01;308;167;141
099;007;098;019;01;245;145;100
099;007;098;020;01;214;119;95
099;007;098;021;01;142;82;60
099;007;098;022;01;173;113;60
099;007;098;023;01;74;48;26
099;007;098;024;01;263;151;112
099;007;098;025;01;332;171;161
099;007;098;025;02;328;182;146
099;007;098;026;01;276;146;130
099;007;098;027;01;271;165;106
099;007;098;028;01;288;148;140
099;007;098;028;02;286;145;141
099;007;098;029;01;277;164;113
099;007;098;030;01;263;121;142
099;007;098;031;01;408;224;184
099;007;098;032;01;193;112;81
099;007;098;033;01;346;182;164
099;007;098;034;01;265;139;126
099;007;098;035;01;170;102;68
099;007;098;036;01;179;105;74
099;007;098;037;01;139;72;67
099;007;098;038;01;165;95;70
099;007;098;039;01;336;183;153
099;007;098;040;01;196;103;93
099;007;098;041;01;122;64;58
099;007;098;042;01;376;198;178
099;007;098;042;02;376;205;171
099;007;098;043;01;212;112;100
099;007;098;044;01;320;192;128
099;007;098;044;02;312;160;152
099;007;098;045;01;131;73;58
099;007;098;046;01;171;94;77
099;007;098;058;01;195;105;90
099;007;098;059;01;322;171;151
099;007;098;060;01;319;167;152
099;007;098;060;02;312;184;128
099;007;098;061;01;312;182;130
099;007;098;063;01;109;63;46
099;007;098;064;01;165;96;69
099;007;098;065;01;187;104;83
099;007;098;066;01;112;57;55
099;007;098;067;01;36;21;15
099;007;098;068;01;102;57;45
099;009;098;001;01;379;212;167
099;009;098;002;01;147;89;58
099;009;098;004;01;99;56;43
099;009;098;005;01;208;114;94
099;009;098;006;01;260;129;131
099;009;098;006;02;256;134;122
099;009;098;007;01;219;108;111
099;009;098;008;01;131;68;63
099;009;098;009;01;320;173;147
099;009;098;009;02;316;154;162
099;009;098;009;03;312;176;136
099;009;098;010;01;225;121;104
099;009;098;011;01;312;151;161
099;009;098;011;02;312;160;152
099;009;098;012;01;148;72;76
099;009;098;013;01;276;154;122
099;009;098;014;01;282;136;146
099;009;098;014;02;280;152;128
099;009;098;015;01;161;91;70
099;009;098;016;01;172;85;87
099;009;098;017;01;256;131;125
099;009;098;018;01;162;92;70
099;009;098;019;01;118;58;60
099;009;098;020;01;360;190;170
099;009;098;020;02;360;168;192
099;009;098;020;03;360;190;170
099;009;098;020;04;354;193;161
099;009;098;021;01;182;97;85
099;009;098;022;01;381;211;170
099;009;098;023;01;281;159;122
099;009;098;024;01;258;137;121
099;009;098;025;01;264;169;95
099;009;098;025;02;261;165;96
099;009;098;026;01;325;186;139
099;009;098;027;01;314;167;147
099;009;098;028;01;97;61;36
099;009;098;032;01;174;90;84
099;009;098;033;01;366;207;159
099;009;098;034;01;122;69;53
099;009;098;035;01;45;31;14
099;009;098;036;01;93;44;49
099;009;098;037;01;146;87;59
099;009;098;038;01;168;102;66
099;009;098;039;01;187;112;75
099;009;098;040;01;159;87;72
099;009;098;041;01;202;113;89
099;009;098;042;01;294;165;129
099;009;098;043;01;371;224;147
099;009;098;044;01;133;78;55
099;009;098;045;01;176;96;80
099;009;098;046;01;297;183;114
099;009;098;047;01;236;131;105
099;009;098;048;01;55;27;28
099;009;098;049;01;103;50;53
099;009;098;050;01;266;164;102
100;001;001;001;01;406;224;182
100;001;001;001;02;400;210;190
100;001;001;001;03;400;215;185
100;001;001;002;01;384;207;177
100;001;001;002;02;384;211;173
100;001;001;002;03;384;214;170
100;001;001;002;04;381;207;174
100;001;001;002;05;376;220;156
100;001;001;002;06;376;217;159
100;001;001;003;01;408;229;179
100;001;001;004;01;336;159;177
100;001;001;004;02;336;167;169
100;001;001;004;03;332;179;153
100;001;001;005;01;287;163;124
100;001;001;006;01;290;166;124
100;001;001;006;02;288;158;130
100;001;001;007;01;388;216;172
100;001;001;007;02;384;199;185
100;001;001;008;01;121;65;56
100;001;001;009;01;200;123;77
100;001;001;010;01;376;204;172
100;001;001;011;01;288;141;147
100;001;001;011;02;283;156;127
100;001;001;012;01;297;143;154
100;001;001;012;02;296;148;148
100;001;001;013;01;324;135;189
100;001;001;013;02;320;163;157
100;001;001;014;01;296;167;129
100;001;001;014;02;289;159;130
100;001;001;015;01;280;157;123
100;001;001;015;02;276;148;128
100;001;001;016;01;111;61;50
100;001;001;017;01;91;58;33
100;001;001;018;01;119;74;45
100;001;001;019;01;130;80;50
100;001;001;020;01;166;95;71
100;001;098;001;01;37;25;12
100;001;098;002;01;48;31;17
100;001;098;003;01;65;45;20
100;001;098;004;01;71;37;34
100;001;098;005;01;87;44;43
100;001;098;006;01;296;180;116
100;001;098;006;02;292;174;118
100;001;098;008;01;45;33;12
100;001;098;009;01;67;38;29
100;001;098;010;01;105;48;57
100;001;098;011;01;154;89;65
100;001;098;012;01;108;59;49
100;001;098;013;01;356;196;160
100;001;098;013;02;352;227;125
100;001;098;014;01;256;132;124
100;001;098;015;01;416;202;214
100;001;098;015;02;414;201;213
100;001;098;016;01;74;48;26
100;001;098;017;01;114;63;51
100;001;098;018;01;111;65;46
100;001;098;019;01;198;112;86
100;001;098;020;01;263;144;119
100;001;098;021;01;138;81;57
100;001;098;022;01;124;73;51
100;001;098;023;01;226;111;115
100;001;098;024;01;338;187;151
100;001;098;025;01;228;101;127
100;001;098;025;02;224;110;114
100;001;098;026;01;295;153;142
100;001;098;028;01;116;72;44
100;001;098;030;01;82;50;32
100;001;098;031;01;126;78;48
100;001;098;033;01;73;38;35
100;001;098;034;01;313;184;129
100;001;098;035;01;187;103;84
100;001;098;036;01;371;194;177
100;001;098;036;02;368;209;159
100;006;098;001;01;61;41;20
100;006;098;002;01;88;51;37
100;006;098;003;01;89;46;43
100;006;098;004;01;120;69;51
100;006;098;005;01;240;143;97
100;006;098;005;02;236;146;90
100;006;098;006;01;178;105;73
100;006;098;007;01;107;62;45
100;006;098;008;01;398;200;198
100;006;098;008;02;392;234;158
100;006;098;009;01;288;160;128
100;006;098;009;02;280;174;106
100;006;098;010;01;137;86;51
100;006;098;011;01;109;65;44
100;006;098;012;01;106;53;53
100;006;098;013;01;216;123;93
100;006;098;014;01;433;239;194
100;006;098;014;02;432;245;187
100;006;098;015;01;114;64;50
100;006;098;016;01;232;126;106
100;006;098;016;02;232;141;91
100;006;098;017;01;328;170;158
100;006;098;017;02;328;181;147
100;006;098;017;03;328;169;159
100;006;098;018;01;190;128;62
100;006;098;019;01;439;253;186
100;006;098;020;01;124;76;48
100;006;098;021;01;188;129;59
100;006;098;022;01;415;260;155
100;006;098;023;01;133;68;65
100;006;098;024;01;128;74;54
100;006;098;025;01;233;120;113
100;006;098;026;01;130;71;59
100;006;098;027;01;173;101;72
100;006;098;028;01;386;235;151
100;006;098;029;01;363;186;177
100;006;098;030;01;264;131;133
100;006;098;030;02;263;145;118
100;006;098;031;01;424;254;170
100;006;098;031;02;418;241;177
100;006;098;032;01;114;66;48
100;006;098;033;01;100;68;32
100;006;098;034;01;113;60;53
100;006;098;035;01;147;90;57
101;006;001;001;01;360;167;193
101;006;001;001;02;360;161;199
101;006;001;001;03;360;195;165
101;006;001;001;04;357;174;183
101;006;001;002;01;424;192;232
101;006;001;002;02;417;178;239
101;006;001;002;03;416;209;207
101;006;001;002;04;416;211;205
101;006;001;003;01;432;241;191
101;006;001;003;02;431;206;225
101;006;001;003;03;424;223;201
101;006;001;003;04;424;201;223
101;006;001;004;01;408;244;164
101;006;001;004;02;408;154;254
101;006;001;004;03;401;180;221
101;006;001;004;04;400;235;165
101;006;001;004;05;400;220;180
101;006;001;005;01;430;225;205
101;006;001;005;02;424;200;224
101;006;001;005;03;424;266;158
101;006;001;005;04;424;233;191
101;006;001;006;01;446;273;173
101;006;001;006;02;440;301;139
101;006;001;007;01;309;140;169
101;006;001;007;02;304;174;130
101;006;001;008;01;299;179;120
101;006;001;009;01;409;194;215
101;006;001;009;02;408;228;180
101;006;001;010;01;304;149;155
101;006;001;010;02;302;180;122
101;006;001;011;01;409;200;209
101;006;001;011;02;408;223;185
101;006;001;011;03;408;231;177
101;006;001;011;04;408;223;185
101;006;001;012;01;227;109;118
101;006;001;012;02;224;132;92
101;006;001;013;01;168;88;80
101;006;001;014;01;196;97;99
101;006;001;015;01;410;202;208
101;006;098;001;01;408;256;152
101;006;098;001;02;404;256;148
101;006;098;002;01;312;156;156
101;006;098;002;02;308;180;128
101;006;098;003;01;280;133;147
101;006;098;003;02;274;138;136
101;006;098;004;01;150;71;79
101;006;098;005;01;227;102;125
101;006;098;005;02;224;120;104
101;006;098;006;01;335;166;169
101;006;098;007;01;329;148;181
101;006;098;008;01;251;122;129
101;006;098;009;01;424;205;219
101;006;098;009;02;418;225;193
101;006;098;010;01;381;200;181
101;006;098;011;01;251;128;123
101;006;098;012;01;228;111;117
101;006;098;012;02;224;104;120
101;006;098;013;01;361;179;182
101;006;098;013;02;360;172;188
101;006;098;014;01;298;145;153
101;006;098;015;01;104;54;50
101;006;098;016;01;364;185;179
101;006;098;017;01;411;198;213
101;006;098;018;01;294;136;158
101;006;098;019;01;234;113;121
101;006;098;020;01;145;70;75
101;006;098;021;01;226;116;110
101;006;098;022;01;116;58;58
101;006;098;023;01;272;117;155
101;006;098;023;02;266;136;130
101;006;098;024;01;90;39;51
101;012;098;001;01;127;69;58
101;012;098;002;01;258;125;133
101;012;098;002;02;256;121;135
101;012;098;003;01;352;133;219
101;012;098;003;02;352;140;212
101;012;098;003;03;346;212;134
101;012;098;004;01;351;158;193
101;012;098;004;02;344;168;176
101;012;098;005;01;266;141;125
101;012;098;006;01;364;197;167
101;012;098;006;02;360;156;204
101;012;098;006;03;360;212;148
101;015;098;001;01;360;188;172
101;015;098;001;02;358;162;196
101;015;098;001;03;352;147;205
101;015;098;001;04;352;187;165
101;015;098;002;01;190;92;98
101;015;098;003;01;137;70;67
101;015;098;005;01;410;184;226
101;015;098;006;01;205;95;110
101;015;098;007;01;163;75;88
101;016;098;001;01;402;188;214
101;016;098;002;01;360;154;206
101;016;098;002;02;357;172;185
101;016;098;002;03;352;179;173
101;016;098;003;01;400;195;205
101;016;098;003;02;394;197;197
101;016;098;003;03;392;184;208
101;016;098;004;01;341;162;179
101;016;098;005;01;367;166;201
101;016;098;006;01;182;83;99
101;016;098;007;01;208;100;108
101;016;098;008;01;258;120;138
101;016;098;009;01;306;143;163
101;016;098;010;01;176;73;103
101;016;098;011;01;182;91;91
101;016;098;012;01;119;64;55
101;016;098;013;01;158;71;87
101;016;098;014;01;97;53;44
101;016;098;015;01;120;61;59
102;001;001;001;01;296;172;124
102;001;001;001;02;294;157;137
102;001;001;002;01;432;200;232
102;001;001;002;02;432;218;214
102;001;001;002;03;430;192;238
102;001;001;003;01;384;188;196
102;001;001;004;01;314;159;155
102;001;001;005;01;328;195;133
102;001;001;005;02;325;157;168
102;001;001;006;01;245;143;102
102;001;001;006;02;240;145;95
102;001;001;007;01;446;223;223
102;001;001;007;02;440;214;226
102;001;001;007;03;440;218;222
102;001;001;008;01;130;70;60
102;001;001;009;01;211;129;82
102;001;001;010;01;136;79;57
102;001;001;011;01;135;76;59
102;001;001;012;01;229;116;113
102;001;001;012;02;224;116;108
102;001;001;013;01;416;207;209
102;001;001;014;01;358;197;161
102;001;001;015;01;248;144;104
102;001;001;015;02;245;141;104
102;001;001;016;01;415;223;192
102;001;001;016;02;408;200;208
102;001;001;016;03;408;197;211
102;001;001;017;01;233;112;121
102;001;001;017;02;232;115;117
102;001;001;018;01;427;224;203
102;001;001;018;02;424;233;191
102;001;001;019;01;426;224;202
102;001;001;020;01;130;75;55
102;001;001;021;01;336;169;167
102;001;001;021;02;328;180;148
102;001;001;022;01;231;122;109
102;001;001;022;02;224;127;97
102;001;001;023;01;428;231;197
102;007;098;001;01;402;230;172
102;007;098;001;02;400;219;181
102;007;098;001;03;400;228;172
102;007;098;001;04;400;234;166
102;007;098;002;01;287;156;131
102;007;098;003;01;256;136;120
102;007;098;003;02;255;139;116
102;007;098;004;01;94;59;35
102;007;098;005;01;263;139;124
102;007;098;005;02;256;126;130
102;007;098;006;01;223;114;109
102;007;098;007;01;435;251;184
102;007;098;008;01;129;67;62
102;007;098;009;01;164;100;64
102;007;098;010;01;91;50;41
102;007;098;011;01;81;49;32
102;007;098;013;01;137;78;59
102;007;098;014;01;65;35;30
102;007;098;015;01;138;84;54
102;009;098;001;01;240;146;94
102;009;098;001;02;239;134;105
102;009;098;002;01;407;216;191
102;009;098;003;01;345;167;178
102;009;098;003;02;344;184;160
102;009;098;004;01;249;148;101
102;009;098;005;01;337;182;155
102;009;098;006;01;357;216;141
102;009;098;007;01;324;164;160
102;009;098;008;01;75;46;29
102;009;098;009;01;100;64;36
102;010;098;001;01;400;205;195
102;010;098;002;01;400;191;209
102;010;098;002;02;397;208;189
102;010;098;003;01;323;178;145
102;010;098;003;02;320;164;156
102;010;098;004;01;409;200;209
102;012;098;001;01;399;207;192
102;012;098;002;01;205;121;84
102;012;098;003;01;399;216;183
102;012;098;004;01;433;217;216
102;012;098;005;01;285;157;128
102;012;098;005;02;280;132;148
102;012;098;006;01;376;201;175
102;012;098;006;02;370;205;165
102;012;098;007;01;278;131;147
102;012;098;007;02;272;139;133
102;012;098;008;01;232;114;118
102;012;098;008;02;232;120;112
103;001;001;001;01;448;242;206
103;001;001;001;02;448;246;202
103;001;001;001;03;448;224;224
103;001;001;001;04;448;233;215
103;001;001;001;05;448;232;216
103;001;001;001;06;444;251;193
103;001;001;001;07;440;242;198
103;001;001;002;01;408;192;216
103;001;001;002;02;408;222;186
103;001;001;002;03;408;213;195
103;001;001;002;04;408;206;202
103;001;001;002;05;403;221;182
103;001;001;002;06;400;225;175
103;001;001;002;07;400;207;193
103;001;001;003;01;337;189;148
103;001;001;003;02;336;187;149
103;001;001;004;01;246;130;116
103;001;001;005;01;331;186;145
103;001;001;006;01;288;152;136
103;001;001;006;02;280;158;122
103;001;001;007;01;247;154;93
103;001;001;008;01;285;152;133
103;001;001;010;01;253;137;116
103;001;001;010;02;248;142;106
103;001;001;012;01;410;219;191
103;001;098;001;01;277;135;142
103;001;098;001;02;272;123;149
103;001;098;002;01;288;147;141
103;001;098;002;02;287;161;126
103;001;098;003;01;237;145;92
103;001;098;004;01;355;176;179
103;001;098;005;01;218;134;84
103;001;098;006;01;162;104;58
103;001;098;007;01;292;156;136
103;001;098;007;02;288;151;137
103;001;098;008;01;93;45;48
103;001;098;009;01;189;103;86
103;001;098;010;01;125;73;52
103;001;098;011;01;416;233;183
103;001;098;012;01;248;150;98
103;001;098;013;01;414;217;197
103;001;098;014;01;260;136;124
103;001;098;015;01;254;143;111
103;001;098;016;01;94;51;43
103;001;098;017;01;171;105;66
103;001;098;018;01;165;87;78
103;009;098;001;01;208;123;85
103;009;098;002;01;185;110;75
103;009;098;003;01;281;149;132
103;009;098;003;02;280;158;122
103;009;098;004;01;365;197;168
103;009;098;005;01;341;216;125
103;009;098;006;01;360;214;146
103;009;098;006;02;359;185;174
103;009;098;006;03;352;187;165
103;009;098;006;04;352;197;155
103;009;098;007;01;274;149;125
103;009;098;008;01;384;204;180
103;009;098;008;02;380;195;185
103;009;098;009;01;256;137;119
103;009;098;009;02;248;137;111
103;009;098;010;01;256;128;128
103;009;098;011;01;396;187;209
103;009;098;012;01;392;194;198
103;009;098;012;02;392;197;195
103;009;098;012;03;392;210;182
103;009;098;012;04;389;198;191
103;009;098;012;05;384;205;179
103;009;098;013;01;328;177;151
103;009;098;013;02;327;161;166
103;009;098;014;01;122;67;55
103;009;098;015;01;275;149;126
103;009;098;015;02;272;142;130
103;009;098;016;01;312;194;118
103;009;098;017;01;344;150;194
103;009;098;017;02;337;168;169
103;009;098;018;01;344;187;157
103;009;098;018;02;339;170;169
103;009;098;019;01;315;153;162
103;009;098;020;01;247;128;119
103;009;098;021;01;277;149;128
103;009;098;021;02;272;142;130
103;009;098;022;01;274;145;129
103;009;098;023;01;163;92;71
103;009;098;024;01;168;99;69
103;009;098;025;01;163;96;67
103;009;098;026;01;134;77;57
103;009;098;027;01;165;90;75
104;001;001;001;01;344;189;155
104;001;001;001;02;344;191;153
104;001;001;001;03;343;195;148
104;001;001;002;01;320;162;158
104;001;001;002;02;320;186;134
104;001;001;002;03;312;189;123
104;001;001;003;01;384;191;193
104;001;001;003;02;384;214;170
104;001;001;003;03;380;229;151
104;001;001;004;01;408;234;174
104;001;001;004;02;400;224;176
104;001;001;004;03;400;225;175
104;001;001;005;01;408;224;184
104;001;001;005;02;408;242;166
104;001;001;005;03;402;212;190
104;001;001;005;04;400;201;199
104;001;001;005;05;400;231;169
104;001;001;005;06;400;206;194
104;001;001;005;07;400;219;181
104;001;001;006;01;432;222;210
104;001;001;006;02;424;230;194
104;001;001;006;03;424;206;218
104;001;001;006;04;424;231;193
104;001;001;007;01;435;264;171
104;001;001;008;01;402;244;158
104;001;001;008;02;400;213;187
104;001;001;008;03;400;239;161
104;001;001;009;01;119;65;54
104;001;001;010;01;328;194;134
104;001;001;010;02;323;207;116
104;001;001;010;03;320;200;120
104;001;001;011;01;147;80;67
104;001;001;012;01;256;143;113
104;001;098;001;01;274;149;125
104;001;098;002;01;353;183;170
104;001;098;003;01;259;135;124
104;001;098;004;01;313;161;152
104;001;098;004;02;312;188;124
104;001;098;006;01;373;209;164
104;001;098;007;01;376;189;187
104;001;098;007;02;368;181;187
104;001;098;008;01;434;215;219
104;001;098;008;02;432;216;216
104;001;098;008;03;432;229;203
104;001;098;008;04;432;245;187
104;001;098;009;01;400;219;181
104;001;098;010;01;91;54;37
104;001;098;011;01;262;152;110
104;001;098;012;01;280;159;121
104;001;098;012;02;272;150;122
104;001;098;013;01;256;125;131
104;001;098;013;02;256;137;119
104;002;098;001;01;362;183;179
104;002;098;001;02;360;197;163
104;002;098;002;01;320;167;153
104;002;098;002;02;320;157;163
104;002;098;002;03;313;190;123
104;002;098;003;01;85;52;33
104;002;098;004;01;161;97;64
104;002;098;005;01;376;209;167
104;002;098;005;02;376;196;180
104;002;098;005;03;371;180;191
104;002;098;005;04;368;215;153
104;002;098;006;01;398;234;164
104;002;098;007;01;377;200;177
104;002;098;008;01;160;85;75
104;002;098;009;01;326;162;164
104;002;098;009;02;320;181;139
105;010;001;001;01;344;186;158
105;010;001;001;02;343;177;166
105;010;001;002;01;344;193;151
105;010;001;002;02;344;173;171
105;010;001;002;03;344;210;134
105;010;001;002;04;337;187;150
105;010;001;003;01;368;210;158
105;010;001;003;02;364;173;191
105;010;001;004;01;237;136;101
105;010;001;004;02;232;107;125
105;010;001;005;01;255;131;124
105;010;098;001;01;449;212;237
105;010;098;002;01;286;152;134
105;013;001;004;01;219;117;102
105;013;001;005;01;400;204;196
105;013;001;005;02;400;229;171
105;013;001;005;03;400;193;207
105;013;001;005;04;398;202;196
105;013;001;005;05;392;214;178
105;013;001;005;06;392;220;172
105;013;001;006;01;352;206;146
105;013;001;006;02;352;214;138
105;013;001;006;03;351;187;164
105;016;098;001;01;371;180;191
105;016;098;002;01;296;137;159
105;016;098;002;02;288;147;141
105;016;098;003;01;254;122;132
105;016;098;004;01;276;145;131
105;016;098;004;02;272;135;137
105;016;098;005;01;425;206;219
105;016;098;006;01;437;209;228
105;016;098;007;01;312;146;166
105;016;098;007;02;312;174;138
105;016;098;007;03;306;153;153
105;016;098;008;01;258;121;137
105;016;098;008;02;256;129;127
105;016;098;009;01;243;120;123
105;016;098;010;01;161;83;78
105;016;098;011;01;345;150;195
105;016;098;011;02;344;167;177
105;016;098;011;03;344;153;191
105;016;098;012;01;368;172;196
105;016;098;013;01;265;133;132
105;016;098;013;02;264;130;134
105;016;098;014;01;224;120;104
105;016;098;015;01;306;151;155
105;016;098;016;01;252;126;126
105;016;098;017;01;199;97;102
105;016;098;018;01;253;119;134
105;016;098;018;02;248;118;130
106;009;001;001;01;408;209;199
106;009;001;001;02;408;174;234
106;009;001;001;03;408;211;197
106;009;001;001;04;408;138;270
106;009;001;001;05;404;242;162
106;009;001;002;01;352;156;196
106;009;001;003;01;277;132;145
106;009;001;004;01;137;61;76
106;009;001;005;01;280;107;173
106;009;001;005;02;273;138;135
106;009;001;006;01;93;47;46
106;009;001;007;01;105;53;52
106;009;001;008;01;217;131;86
106;009;001;009;01;118;65;53
106;009;098;001;01;225;115;110
106;009;098;002;01;225;112;113
106;009;098;003;01;292;139;153
106;009;098;004;01;241;123;118
106;009;098;005;01;272;130;142
106;009;098;006;01;414;202;212
106;009;098;006;02;408;182;226
106;009;098;007;01;316;151;165
106;009;098;008;01;360;166;194
106;009;098;008;02;354;134;220
106;009;098;009;01;291;133;158
106;009;098;010;01;304;114;190
106;009;098;010;02;304;164;140
106;009;098;010;03;303;111;192
106;009;098;011;01;114;67;47
106;011;098;001;01;304;173;131
106;011;098;002;01;424;190;234
106;011;098;002;02;424;172;252
106;011;098;002;03;424;188;236
106;011;098;003;01;441;197;244
106;011;098;003;02;440;196;244
106;011;098;004;01;189;89;100
106;011;098;005;01;413;186;227
106;011;098;006;01;299;151;148
106;011;098;007;01;146;84;62
107;003;001;002;01;382;212;170
107;003;001;002;02;376;175;201
107;003;001;002;03;376;195;181
107;003;001;002;04;376;186;190
107;003;001;003;01;360;210;150
107;003;001;004;01;304;182;122
107;003;001;004;02;304;161;143
107;003;001;004;03;299;178;121
107;003;001;005;01;240;140;100
107;003;001;005;02;240;109;131
107;003;001;006;01;297;175;122
107;003;001;007;01;280;163;117
107;003;001;007;02;274;153;121
107;003;001;008;01;277;163;114
107;003;001;009;01;400;196;204
107;003;001;009;02;400;231;169
107;003;001;009;03;393;180;213
107;003;098;001;01;307;170;137
107;003;098;001;02;304;135;169
107;003;098;001;03;304;169;135
107;003;098;002;01;232;119;113
107;003;098;002;02;226;113;113
107;003;098;003;01;445;237;208
107;003;098;004;01;313;139;174
107;003;098;004;02;312;152;160
107;003;098;005;01;77;58;19
107;003;098;006;01;424;228;196
107;003;098;006;02;423;260;163
107;003;098;006;03;416;217;199
107;003;098;007;01;227;186;41
107;003;098;008;01;10;10;0
107;009;098;001;01;165;107;58
107;009;098;002;01;320;176;144
107;009;098;002;02;313;180;133
107;009;098;002;03;312;185;127
107;009;098;003;01;435;213;222
107;009;098;003;02;432;219;213
107;009;098;004;01;373;237;136
107;009;098;004;02;368;210;158
107;009;098;005;01;283;164;119
107;009;098;006;01;437;296;141
107;009;098;007;01;348;210;138
107;009;098;008;01;200;134;66
107;009;098;009;01;131;78;53
107;009;098;010;01;312;160;152
107;009;098;011;01;159;118;41
107;009;098;012;01;112;93;19
108;001;001;001;01;440;214;226
108;001;001;001;02;440;231;209
108;001;001;001;03;440;245;195
108;001;001;001;04;439;230;209
108;001;001;001;05;432;217;215
108;001;001;002;01;68;46;22
108;001;001;003;01;265;122;143
108;001;001;003;02;264;153;111
108;001;001;004;01;395;205;190
108;001;001;004;02;392;210;182
108;001;001;005;01;397;206;191
108;001;001;005;02;392;213;179
108;001;001;005;03;392;236;156
108;001;001;005;04;392;224;168
108;001;001;006;01;351;186;165
108;001;001;007;01;450;242;208
108;001;001;008;01;373;187;186
108;001;001;008;02;368;216;152
108;001;001;009;01;392;214;178
108;001;001;009;02;392;240;152
108;001;001;010;01;275;189;86
108;001;098;001;01;350;205;145
108;001;098;002;01;84;41;43
108;001;098;003;01;288;149;139
108;001;098;003;02;286;174;112
108;001;098;004;01;297;175;122
108;001;098;004;02;296;184;112
108;001;098;005;01;145;89;56
108;001;098;006;01;404;225;179
108;002;098;001;01;416;218;198
108;002;098;001;02;412;209;203
108;002;098;001;03;408;224;184
108;002;098;002;01;141;77;64
108;002;098;003;01;127;71;56
108;002;098;004;01;424;229;195
108;002;098;004;02;423;239;184
108;002;098;005;01;234;173;61
108;002;098;006;01;416;241;175
108;002;098;006;02;416;246;170
108;002;098;006;03;410;230;180
108;002;098;006;04;408;242;166
108;002;098;006;05;408;255;153
108;002;098;007;01;400;225;175
108;002;098;007;02;400;236;164
108;002;098;007;03;400;220;180
108;002;098;007;04;400;236;164
108;002;098;007;05;400;225;175
108;002;098;007;06;392;231;161
108;002;098;008;01;332;217;115
108;002;098;009;01;360;210;150
108;002;098;009;02;355;250;105
108;002;098;009;03;352;261;91
108;002;098;010;01;328;212;116
108;002;098;010;02;328;207;121
108;002;098;010;03;325;232;93
108;002;098;011;01;440;271;169
108;002;098;011;02;432;267;165
108;002;098;011;03;432;276;156
108;002;098;012;01;300;173;127
108;002;098;013;01;223;129;94
108;002;098;014;01;155;102;53
108;002;098;015;01;439;269;170
108;002;098;015;02;432;244;188
108;002;098;015;03;432;270;162
108;002;098;016;01;349;219;130
108;002;098;019;01;257;136;121
108;002;098;020;01;443;287;156
109;001;001;001;01;423;189;234
109;001;001;001;02;416;197;219
109;001;001;002;01;384;201;183
109;001;001;002;02;382;185;197
109;001;001;002;03;376;191;185
109;001;001;002;04;376;198;178
109;001;001;003;01;328;133;195
109;001;001;003;02;328;148;180
109;001;001;003;03;327;164;163
109;001;001;004;01;160;85;75
109;001;001;005;01;253;118;135
109;001;001;005;02;248;128;120
109;001;001;006;01;69;43;26
109;001;001;007;01;378;187;191
109;001;001;008;01;240;109;131
109;001;001;008;02;236;104;132
109;001;001;009;01;75;37;38
109;001;001;010;01;337;155;182
109;001;001;011;01;349;165;184
109;001;001;011;02;344;153;191
109;001;001;012;01;435;209;226
109;001;001;013;01;344;167;177
109;001;001;013;02;337;154;183
109;001;001;014;01;376;201;175
109;001;001;014;02;369;189;180
109;001;001;014;03;368;207;161
109;001;001;015;01;55;32;23
109;001;001;016;01;90;44;46
109;001;098;001;01;262;125;137
109;001;098;001;02;256;127;129
109;001;098;002;01;374;181;193
109;001;098;003;01;315;161;154
109;001;098;004;01;360;139;221
109;001;098;004;02;356;160;196
109;001;098;005;01;300;142;158
109;001;098;006;01;439;205;234
109;001;098;007;01;435;202;233
109;001;098;007;02;432;204;228
109;001;098;008;01;67;34;33
109;001;098;009;01;144;78;66
109;001;098;010;01;298;143;155
109;001;098;011;01;235;112;123
109;001;098;012;01;55;29;26
109;001;098;013;01;328;131;197
109;001;098;013;02;323;143;180
109;001;098;013;03;320;170;150
109;001;098;014;01;50;27;23
109;002;098;001;01;264;92;172
109;002;098;001;02;256;126;130
109;002;098;002;01;131;60;71
109;002;098;003;01;84;42;42
109;002;098;004;01;137;59;78
109;002;098;005;01;290;143;147
109;002;098;006;01;185;80;105
109;002;098;007;01;334;162;172
109;002;098;008;01;290;119;171
109;002;098;009;01;406;182;224
109;002;098;010;01;135;67;68
109;002;098;011;01;311;135;176
109;002;098;012;01;214;93;121
109;002;098;013;01;94;47;47
109;002;098;014;01;376;156;220
109;002;098;014;02;376;180;196
109;002;098;014;03;376;194;182
109;002;098;014;04;375;176;199
109;003;098;001;01;445;209;236
109;003;098;002;01;331;150;181
109;003;098;003;01;291;143;148
109;003;098;003;02;288;148;140
109;003;098;004;01;203;87;116
110;001;001;001;01;432;247;185
110;001;001;001;02;432;207;225
110;001;001;001;03;429;230;199
110;001;001;002;01;384;225;159
110;001;001;002;02;384;211;173
110;001;001;002;03;381;208;173
110;001;001;002;04;376;224;152
110;001;001;002;05;376;205;171
110;001;001;003;01;429;234;195
110;001;001;003;02;424;241;183
110;001;001;003;03;424;227;197
110;001;001;004;01;392;215;177
110;001;001;004;02;392;204;188
110;001;001;004;03;392;188;204
110;001;001;004;04;392;192;200
110;001;001;004;05;392;197;195
110;001;001;004;06;389;222;167
110;001;001;004;07;384;202;182
110;001;001;005;01;416;263;153
110;001;001;005;02;416;224;192
110;001;001;005;03;416;225;191
110;001;001;005;04;414;241;173
110;001;001;006;01;263;143;120
110;001;001;007;01;437;218;219
110;001;001;007;02;432;224;208
110;001;001;008;01;416;226;190
110;001;001;008;02;416;242;174
110;001;001;009;01;136;70;66
110;001;001;010;01;198;85;113
110;001;001;011;01;306;172;134
110;001;001;012;01;368;227;141
110;001;001;012;02;368;195;173
110;001;001;012;03;368;199;169
110;001;001;012;04;364;215;149
110;001;001;013;01;251;129;122
110;001;001;014;01;432;259;173
110;001;001;014;02;432;241;191
110;001;001;014;03;430;286;144
110;001;001;014;04;424;259;165
110;001;001;015;01;329;180;149
110;001;001;015;02;328;166;162
110;001;001;015;03;328;155;173
110;001;001;016;01;400;198;202
110;001;001;016;02;398;216;182
110;001;001;016;03;392;222;170
110;001;001;016;04;392;224;168
110;001;001;017;01;416;247;169
110;001;001;017;02;408;253;155
110;001;001;018;01;352;193;159
110;001;001;019;01;288;168;120
110;001;001;019;02;282;158;124
110;001;001;020;01;151;82;69
110;001;001;021;01;391;198;193
110;001;001;022;01;264;138;126
110;001;001;022;02;262;142;120
110;001;001;023;01;421;240;181
110;001;001;024;01;242;160;82
110;001;001;025;01;153;95;58
110;001;001;026;01;254;137;117
110;001;001;027;01;424;240;184
110;001;001;027;02;424;234;190
110;001;001;027;03;424;217;207
110;001;001;027;04;421;249;172
110;001;001;027;05;416;231;185
110;001;001;027;06;416;264;152
110;001;001;027;07;416;247;169
110;001;001;028;01;138;72;66
110;001;001;029;01;80;46;34
110;001;098;001;01;155;85;70
110;001;098;002;01;400;224;176
110;001;098;003;01;317;153;164
110;001;098;004;01;162;92;70
110;001;098;005;01;99;51;48
110;001;098;006;01;105;56;49
110;001;098;007;01;248;127;121
110;001;098;007;02;240;114;126
110;001;098;008;01;166;83;83
110;001;098;009;01;137;74;63
110;001;098;010;01;422;209;213
110;001;098;011;01;127;69;58
110;001;098;015;01;254;152;102
110;002;098;001;01;365;194;171
110;002;098;002;01;256;131;125
110;002;098;002;02;253;124;129
110;002;098;003;01;92;55;37
110;002;098;004;01;321;155;166
110;002;098;005;01;246;116;130
110;002;098;006;01;159;85;74
110;002;098;007;01;68;35;33
110;002;098;008;01;344;187;157
110;002;098;008;02;340;171;169
110;002;098;008;03;336;174;162
110;002;098;009;01;442;248;194
110;002;098;010;01;445;228;217
110;002;098;010;02;440;237;203
110;002;098;011;01;277;135;142
110;002;098;012;01;193;107;86
110;002;098;013;01;18;12;6
110;002;098;014;01;68;42;26
110;002;098;015;01;86;45;41
110;002;098;016;01;82;43;39
110;002;098;017;01;199;109;90
110;002;098;018;01;173;97;76
110;002;098;019;01;367;188;179
110;002;098;020;01;133;82;51
110;002;098;021;01;272;152;120
110;002;098;021;02;269;160;109
110;002;098;022;01;277;144;133
110;002;098;023;01;268;143;125
110;002;098;024;01;66;37;29
110;002;098;025;01;232;119;113
110;002;098;025;02;226;115;111
110;002;098;026;01;46;27;19
110;002;098;027;01;78;35;43
110;002;098;028;01;445;238;207
111;001;001;001;01;440;233;207
111;001;001;001;02;432;244;188
111;001;001;002;01;312;166;146
111;001;001;002;02;305;172;133
111;001;001;003;01;423;212;211
111;001;001;003;02;416;197;219
111;001;001;003;03;416;203;213
111;001;001;003;04;416;203;213
111;001;001;004;01;276;141;135
111;001;001;004;02;272;148;124
111;001;001;005;01;400;229;171
111;001;001;006;01;416;182;234
111;001;001;006;02;411;203;208
111;001;001;006;03;408;164;244
111;001;001;007;01;383;203;180
111;001;001;008;01;186;98;88
111;001;001;009;01;432;262;170
111;001;001;010;01;347;196;151
111;001;001;011;01;416;227;189
111;001;001;011;02;412;216;196
111;001;001;011;03;408;221;187
111;001;001;012;01;306;180;126
111;001;001;013;01;289;173;116
111;001;001;014;01;366;220;146
111;001;001;015;01;326;186;140
111;001;001;019;01;368;193;175
111;001;001;019;02;368;188;180
111;001;001;019;03;367;192;175
111;001;001;019;04;360;169;191
111;001;098;001;01;76;36;40
111;001;098;002;01;274;136;138
111;001;098;003;01;232;111;121
111;001;098;003;02;227;123;104
111;001;098;004;01;288;159;129
111;001;098;005;01;229;123;106
111;001;098;006;01;232;132;100
111;001;098;006;02;224;112;112
111;001;098;007;01;312;152;160
111;001;098;007;02;304;168;136
111;001;098;008;01;157;87;70
111;001;098;009;01;242;147;95
111;001;098;009;02;240;150;90
111;002;098;001;01;336;176;160
111;002;098;001;02;330;170;160
111;002;098;002;01;237;118;119
111;002;098;003;01;272;161;111
111;002;098;003;02;269;145;124
111;003;098;001;01;257;141;116
111;003;098;001;02;256;135;121
111;003;098;002;01;440;241;199
111;003;098;002;02;437;246;191
111;003;098;003;01;352;168;184
111;003;098;003;02;346;163;183
111;003;098;004;01;408;195;213
111;003;098;004;02;406;209;197
111;003;098;004;03;400;207;193
111;003;098;005;01;365;205;160
111;003;098;006;01;225;118;107
111;003;098;007;01;411;233;178
111;003;098;008;01;438;193;245
111;003;098;009;01;288;134;154
111;003;098;009;02;284;117;167
111;003;098;010;01;344;179;165
111;003;098;010;02;343;178;165
111;003;098;011;01;298;117;181
111;003;098;011;02;296;152;144
111;003;098;012;01;160;86;74
111;003;098;013;01;271;149;122
111;003;098;013;02;264;141;123
999;001;001;001;01;360;177;183
999;001;001;001;02;352;168;184
999;001;002;001;01;332;200;132
999;001;002;002;01;240;177;63
999;001;002;002;02;232;189;43
999;001;003;001;01;384;193;191
999;001;003;001;02;384;205;179
999;001;003;001;03;384;185;199
999;001;003;001;04;384;183;201
999;001;003;001;05;384;183;201
999;001;003;002;01;416;163;253
999;001;003;002;02;416;163;253
999;001;003;002;03;416;154;262
999;001;003;002;04;416;158;258
999;001;003;002;05;416;160;256
999;001;003;002;06;410;161;249
999;001;003;002;07;408;173;235
999;001;003;002;08;408;166;242
999;001;003;002;09;408;173;235
999;001;003;002;10;408;160;248
999;001;003;003;01;232;85;147
999;001;003;003;02;228;77;151
999;001;003;004;01;280;167;113
999;001;003;004;02;277;161;116
999;001;004;001;01;384;238;146
999;001;004;001;02;384;238;146
999;001;004;001;03;384;220;164
999;001;004;001;04;381;237;144
999;001;005;001;01;416;203;213
999;001;005;001;02;416;210;206
999;001;005;001;03;416;194;222
999;001;005;001;04;416;186;230
999;001;005;001;05;413;188;225
999;001;005;001;06;408;154;254
999;001;005;001;07;408;178;230
999;001;005;001;08;408;224;184
999;001;005;001;09;408;194;214
999;001;005;002;01;352;202;150
999;001;005;002;02;346;211;135
999;001;005;003;01;159;94;65
999;001;007;001;01;434;318;116
999;001;007;002;01;311;256;55
999;001;008;001;01;437;197;240
999;001;008;001;02;432;221;211
999;001;008;001;03;432;224;208
999;001;008;001;04;432;223;209
999;001;008;001;05;432;214;218
999;001;008;001;06;432;223;209
999;001;008;001;07;432;202;230
999;001;008;001;08;432;227;205
999;001;008;001;09;432;243;189
999;001;008;002;01;119;65;54
999;001;009;001;01;438;322;116
999;001;009;001;02;432;293;139
999;001;010;001;01;416;249;167
999;001;010;001;02;416;275;141
999;001;010;001;03;416;269;147
999;001;010;001;04;416;252;164
999;001;010;001;05;416;259;157
999;001;010;001;06;413;225;188
999;001;010;001;07;408;260;148
999;001;010;001;08;408;259;149
999;001;010;001;09;408;256;152
999;001;010;002;01;241;146;95
999;001;010;002;02;240;145;95
999;001;011;001;01;400;267;133
999;001;011;001;02;400;281;119
999;001;011;001;03;399;258;141
999;001;011;001;04;392;256;136
999;001;011;001;05;392;254;138
999;001;011;001;06;392;258;134
999;001;011;002;01;297;199;98
999;001;011;003;01;106;90;16
999;001;013;001;01;392;221;171
999;001;013;001;02;392;207;185
999;001;013;001;03;392;219;173
999;001;013;001;04;392;221;171
999;001;013;001;05;384;241;143
999;001;013;002;01;416;238;178
999;001;013;002;02;416;243;173
999;001;020;001;01;360;207;153
999;001;020;001;02;360;215;145
999;001;020;001;03;355;198;157
999;001;020;001;04;352;220;132
999;001;020;002;01;195;126;69
999;001;028;001;01;416;302;114
999;001;028;001;02;416;299;117
999;001;028;001;03;416;311;105
999;001;028;001;04;416;315;101
999;001;028;001;05;416;277;139
999;001;028;001;06;416;293;123
999;001;028;001;07;416;271;145
999;001;028;001;08;410;273;137
999;001;028;001;09;408;298;110
999;001;028;001;10;408;300;108
999;001;028;001;11;408;291;117
999;001;028;003;01;312;199;113
999;001;028;003;02;307;196;111
999;001;028;003;03;304;211;93
999;001;029;001;01;416;259;157
999;001;029;001;02;416;261;155
999;001;029;001;03;409;250;159
999;002;001;001;01;427;249;178
999;002;001;001;02;424;242;182
999;002;001;001;03;424;257;167
999;002;001;001;04;424;247;177
999;002;001;001;05;424;248;176
999;002;001;001;06;424;270;154
999;002;001;001;07;424;242;182
999;002;001;001;08;424;269;155
999;002;001;001;09;424;275;149
999;002;001;002;01;368;194;174
999;002;001;002;02;368;189;179
999;002;001;002;03;368;187;181
999;002;001;002;04;363;205;158
999;002;001;003;01;108;57;51
999;002;001;004;01;383;221;162
999;002;001;004;02;376;196;180
999;002;001;005;01;151;93;58
999;002;001;006;01;344;196;148
999;002;001;006;02;342;205;137
999;002;001;007;01;25;16;9
999;002;001;008;01;179;88;91
999;002;001;009;01;356;207;149
999;002;002;001;01;400;246;154
999;002;002;001;02;400;224;176
999;002;002;001;03;400;220;180
999;002;002;001;04;394;213;181
999;002;002;001;05;392;234;158
999;002;002;001;06;392;251;141
999;002;002;001;07;392;240;152
999;002;002;001;08;392;237;155
999;002;002;002;01;448;210;238
999;002;002;002;02;448;234;214
999;002;002;002;03;446;202;244
999;002;002;003;01;371;212;159
999;002;002;003;02;368;236;132
999;002;002;003;03;368;232;136
999;002;002;004;01;255;134;121
999;002;002;005;01;120;61;59
999;003;004;001;01;408;234;174
999;003;004;001;02;408;248;160
999;003;004;001;03;408;236;172
999;003;004;001;04;406;190;216
999;003;004;001;05;400;237;163
999;003;005;001;01;448;274;174
999;003;005;001;02;448;242;206
999;003;005;001;03;448;228;220
999;003;005;001;04;448;248;200
999;003;005;001;05;448;218;230
999;003;005;001;06;448;268;180
999;003;005;001;07;448;263;185
999;003;005;001;08;448;274;174
999;003;005;001;09;448;228;220
999;003;005;001;10;448;270;178
999;003;005;001;11;448;240;208
999;003;005;001;12;448;219;229
999;003;005;001;13;448;247;201
999;003;005;001;14;448;299;149
999;003;005;001;15;448;246;202
999;003;005;001;16;448;285;163
999;003;005;001;17;448;257;191
999;003;005;001;18;448;250;198
999;003;005;001;19;448;266;182
999;003;005;001;20;448;296;152
999;003;005;001;21;448;235;213
999;003;005;001;22;448;316;132
999;003;005;001;23;448;302;146
999;003;005;001;24;448;283;165
999;003;005;001;25;448;275;173
999;003;005;001;26;448;223;225
999;003;005;001;27;448;261;187
999;003;005;001;28;448;249;199
999;003;005;001;29;448;291;157
999;003;005;001;30;448;295;153
999;003;005;001;31;448;256;192
999;003;005;001;32;448;267;181
999;003;005;001;33;448;263;185
999;003;005;001;34;448;230;218
999;003;005;001;35;448;262;186
999;003;005;001;36;448;219;229
999;003;005;001;37;448;206;242
999;003;005;001;38;448;223;225
999;003;005;001;39;448;228;220
999;003;005;001;40;448;288;160
999;003;005;001;41;448;251;197
999;003;005;001;42;448;261;187
999;003;005;001;43;448;288;160
999;003;005;001;44;448;220;228
999;003;005;001;45;448;261;187
999;003;005;001;46;448;227;221
999;003;005;001;47;448;242;206
999;003;005;001;48;448;328;120
999;003;005;001;49;448;253;195
999;003;005;001;50;448;265;183
999;003;005;001;51;448;309;139
999;003;005;001;52;448;227;221
999;003;005;001;53;448;235;213
999;003;005;001;54;448;241;207
999;003;005;001;55;448;246;202
999;003;005;001;56;448;239;209
999;003;005;001;57;448;227;221
999;003;005;001;58;448;253;195
999;003;005;001;59;448;183;265
999;003;005;001;60;448;285;163
999;003;005;001;61;448;220;228
999;003;005;001;62;448;238;210
999;003;005;001;63;448;225;223
999;003;005;001;64;448;254;194
999;003;005;001;65;448;245;203
999;003;005;001;66;448;256;192
999;003;005;001;67;448;276;172
999;003;005;001;68;448;294;154
999;003;005;001;69;448;265;183
999;003;005;001;70;448;300;148
999;003;005;001;71;448;283;165
999;003;005;001;72;448;262;186
999;003;005;001;73;448;255;193
999;003;005;001;74;448;228;220
999;003;005;001;75;448;230;218
999;003;005;001;76;448;249;199
999;003;005;001;77;448;242;206
999;003;005;001;78;448;295;153
999;003;005;001;79;448;282;166
999;003;005;001;80;448;222;226
999;003;005;001;81;448;244;204
999;003;005;001;82;448;224;224
999;003;005;001;83;392;186;206
999;003;005;002;01;400;220;180
999;003;005;002;02;397;228;169
999;003;005;002;03;392;213;179
999;003;005;003;01;416;230;186
999;003;005;003;02;416;230;186
999;003;005;003;03;414;219;195
999;003;005;004;01;420;216;204
999;003;005;004;02;416;240;176
999;003;005;004;03;416;235;181
999;003;005;004;04;416;212;204
999;003;005;004;05;416;228;188
999;003;005;005;01;336;168;168
999;003;005;005;02;334;192;142
999;003;005;006;01;344;169;175
999;003;005;006;02;344;170;174
999;003;005;006;03;344;161;183
999;003;005;006;04;342;182;160
999;003;005;007;01;320;192;128
999;003;005;007;02;320;168;152
999;003;005;007;03;314;180;134
999;003;005;008;01;344;205;139
999;003;005;008;02;339;195;144
999;003;005;008;03;336;198;138
999;003;005;008;04;336;204;132
999;003;005;010;01;316;189;127
999;003;005;011;01;232;147;85
999;003;005;011;02;226;130;96
999;003;005;012;01;337;203;134
999;003;006;001;01;376;299;77
999;003;006;001;02;376;289;87
999;003;006;001;03;376;280;96
999;003;006;001;04;376;305;71
999;003;008;001;01;376;224;152
999;003;008;001;02;376;266;110
999;003;008;001;03;375;237;138
999;003;008;001;04;368;248;120
999;003;008;002;01;416;217;199
999;003;008;002;02;416;240;176
999;003;008;002;03;416;271;145
999;003;008;002;04;416;246;170
999;003;008;002;05;416;241;175
999;003;008;002;06;416;239;177
999;003;008;002;07;416;242;174
999;003;008;002;08;416;261;155
999;003;008;002;09;415;232;183
999;003;008;003;01;239;124;115
999;003;008;003;02;232;140;92
999;003;008;004;01;336;224;112
999;003;008;004;02;336;217;119
999;003;008;004;03;330;216;114
999;003;008;005;01;368;258;110
999;003;008;005;02;364;245;119
999;003;008;005;03;360;254;106
999;003;008;006;01;232;195;37
999;003;008;006;02;231;193;38
999;003;008;007;01;315;207;108
999;003;008;007;02;312;228;84
999;003;008;008;01;256;169;87
999;003;008;008;02;250;162;88
999;003;008;009;01;416;268;148
999;003;008;009;02;411;264;147
999;003;008;010;01;423;285;138
999;003;010;001;01;368;169;199
999;003;010;001;02;361;162;199
999;003;010;001;03;360;166;194
999;003;010;001;04;360;178;182
999;003;012;001;01;448;231;217
999;003;012;001;02;448;242;206
999;003;012;001;03;448;267;181
999;003;012;001;04;448;234;214
999;003;012;001;05;446;255;191
999;003;012;001;06;440;232;208
999;003;012;001;07;440;262;178
999;003;012;001;08;440;254;186
999;003;012;001;09;440;251;189
999;003;017;001;01;407;258;149
999;003;017;002;01;256;176;80
999;003;017;002;02;256;176;80
999;003;017;003;01;248;148;100
999;003;017;004;01;341;241;100
